SCHOOL YEAR,COUNTY NUMBER,COUNTY NAME,DISTRICT NUMBER,DISTRICT NAME,SCHOOL NUMBER,SCHOOL NAME,SCHOOL CODE,STATE SCHOOL ID,NCES ID,CO-OP,CO-OP CODE,GRADE,Total Female Students,Total Male Students,African American Male Count,African American Female Count,Total African American Students,American Indian/Alaska Native Male Count,American Indian/Alaska Native Female Count,Total American Indian/Alaska Native Students,Asian Male Count,Asian Female Count,Total Asian Students,Hispanic or Latino Male Count,Hispanic or Latino Female Count,Total Hispanic or Latino Students,Native Hawaiian/Pacific Islander Male Count,Native Hawaiian/Pacific Islander Female Count,Total Native Hawaiian/Pacific Islander Students,Two Or More Race Male Count,Two Or More Race Female Count,Total Two or More Race Students,White Male Count,White Female Count,Total White Students,Total Membership
20192020,001,ADAIR,001,Adair County,"",---District Total---,001,"","",GRREC,902,11,110,128,3,1,4,1,1,2,0,0,0,3,2,5,0,0,0,9,3,12,112,103,215,238
20192020,001,ADAIR,001,Adair County,"",---District Total---,001,"","",GRREC,902,12,94,94,7,3,10,0,0,0,1,0,1,3,2,5,0,0,0,2,3,5,81,86,167,188
20192020,001,ADAIR,001,Adair County,"",---District Total---,001,"","",GRREC,902,All Students,1216,1382,32,18,50,1,2,3,4,2,6,79,63,142,0,1,1,63,50,113,1203,1080,2283,2598
20192020,001,ADAIR,001,Adair County,"",---District Total---,001,"","",GRREC,902,PS,34,54,1,0,1,0,0,0,0,0,0,4,3,7,0,0,0,1,2,3,48,29,77,88
20192020,001,ADAIR,001,Adair County,"",---District Total---,001,"","",GRREC,902,KG,88,114,1,1,2,0,0,0,0,0,0,10,5,15,0,0,0,3,5,8,100,77,177,202
20192020,001,ADAIR,001,Adair County,"",---District Total---,001,"","",GRREC,902,01,81,106,3,1,4,0,1,1,1,0,1,2,6,8,0,0,0,5,4,9,95,69,164,187
20192020,001,ADAIR,001,Adair County,"",---District Total---,001,"","",GRREC,902,02,74,94,3,0,3,0,0,0,0,0,0,6,7,13,0,0,0,7,2,9,78,65,143,168
20192020,001,ADAIR,001,Adair County,"",---District Total---,001,"","",GRREC,902,03,87,93,0,0,0,0,0,0,0,0,0,6,4,10,0,0,0,3,6,9,84,77,161,180
20192020,001,ADAIR,001,Adair County,"",---District Total---,001,"","",GRREC,902,04,96,111,1,2,3,0,0,0,0,1,1,3,7,10,0,0,0,4,4,8,103,82,185,207
20192020,001,ADAIR,001,Adair County,"",---District Total---,001,"","",GRREC,902,05,105,106,3,1,4,0,0,0,0,0,0,7,4,11,0,0,0,6,6,12,90,94,184,211
20192020,001,ADAIR,001,Adair County,"",---District Total---,001,"","",GRREC,902,06,119,106,0,0,0,0,0,0,0,1,1,11,6,17,0,1,1,5,1,6,90,110,200,225
20192020,001,ADAIR,001,Adair County,"",---District Total---,001,"","",GRREC,902,07,113,102,1,3,4,0,0,0,1,0,1,6,8,14,0,0,0,7,9,16,87,93,180,215
20192020,001,ADAIR,001,Adair County,"",---District Total---,001,"","",GRREC,902,08,75,113,4,1,5,0,0,0,1,0,1,5,4,9,0,0,0,4,3,7,99,67,166,188
20192020,001,ADAIR,001,Adair County,"",---District Total---,001,"","",GRREC,902,09,88,116,1,4,5,0,0,0,0,0,0,11,2,13,0,0,0,5,3,8,99,79,178,204
20192020,001,ADAIR,001,Adair County,"",---District Total---,001,"","",GRREC,902,10,86,99,5,1,6,0,0,0,0,0,0,6,6,12,0,0,0,3,1,4,85,78,163,185
20192020,001,ADAIR,001,Adair County,010,Adair County High School,001010,001001010,210003000001,GRREC,902,10,86,92,1,1,2,0,0,0,0,0,0,6,6,12,0,0,0,3,1,4,82,78,160,178
20192020,001,ADAIR,001,Adair County,010,Adair County High School,001010,001001010,210003000001,GRREC,902,12,94,89,3,3,6,0,0,0,1,0,1,3,2,5,0,0,0,2,3,5,80,86,166,183
20192020,001,ADAIR,001,Adair County,010,Adair County High School,001010,001001010,210003000001,GRREC,902,All Students,378,420,7,9,16,1,1,2,1,0,1,22,12,34,0,0,0,19,10,29,370,346,716,798
20192020,001,ADAIR,001,Adair County,010,Adair County High School,001010,001001010,210003000001,GRREC,902,09,88,114,1,4,5,0,0,0,0,0,0,11,2,13,0,0,0,5,3,8,97,79,176,202
20192020,001,ADAIR,001,Adair County,010,Adair County High School,001010,001001010,210003000001,GRREC,902,11,110,125,2,1,3,1,1,2,0,0,0,2,2,4,0,0,0,9,3,12,111,103,214,235
20192020,001,ADAIR,001,Adair County,012,Adair Learning Academy,001012,001001012,210003001913,GRREC,902,10,0,7,4,0,4,0,0,0,0,0,0,0,0,0,0,0,0,0,0,0,3,0,3,7
20192020,001,ADAIR,001,Adair County,012,Adair Learning Academy,001012,001001012,210003001913,GRREC,902,12,0,5,4,0,4,0,0,0,0,0,0,0,0,0,0,0,0,0,0,0,1,0,1,5
20192020,001,ADAIR,001,Adair County,012,Adair Learning Academy,001012,001001012,210003001913,GRREC,902,All Students,0,17,9,0,9,0,0,0,0,0,0,1,0,1,0,0,0,0,0,0,7,0,7,17
20192020,001,ADAIR,001,Adair County,012,Adair Learning Academy,001012,001001012,210003001913,GRREC,902,09,0,2,0,0,0,0,0,0,0,0,0,0,0,0,0,0,0,0,0,0,2,0,2,2
20192020,001,ADAIR,001,Adair County,012,Adair Learning Academy,001012,001001012,210003001913,GRREC,902,11,0,3,1,0,1,0,0,0,0,0,0,1,0,1,0,0,0,0,0,0,1,0,1,3
20192020,001,ADAIR,001,Adair County,014,Adair County Middle School,001014,001001014,210003001919,GRREC,902,06,119,106,0,0,0,0,0,0,0,1,1,11,6,17,0,1,1,5,1,6,90,110,200,225
20192020,001,ADAIR,001,Adair County,014,Adair County Middle School,001014,001001014,210003001919,GRREC,902,08,75,113,4,1,5,0,0,0,1,0,1,5,4,9,0,0,0,4,3,7,99,67,166,188
20192020,001,ADAIR,001,Adair County,014,Adair County Middle School,001014,001001014,210003001919,GRREC,902,All Students,307,321,5,4,9,0,0,0,2,1,3,22,18,40,0,1,1,16,13,29,276,270,546,628
20192020,001,ADAIR,001,Adair County,014,Adair County Middle School,001014,001001014,210003001919,GRREC,902,07,113,102,1,3,4,0,0,0,1,0,1,6,8,14,0,0,0,7,9,16,87,93,180,215
20192020,001,ADAIR,001,Adair County,016,Adair County Elementary School,001016,001001016,210003002021,GRREC,902,03,87,93,0,0,0,0,0,0,0,0,0,6,4,10,0,0,0,3,6,9,84,77,161,180
20192020,001,ADAIR,001,Adair County,016,Adair County Elementary School,001016,001001016,210003002021,GRREC,902,05,105,106,3,1,4,0,0,0,0,0,0,7,4,11,0,0,0,6,6,12,90,94,184,211
20192020,001,ADAIR,001,Adair County,016,Adair County Elementary School,001016,001001016,210003002021,GRREC,902,All Students,288,310,4,3,7,0,0,0,0,1,1,16,15,31,0,0,0,13,16,29,277,253,530,598
20192020,001,ADAIR,001,Adair County,016,Adair County Elementary School,001016,001001016,210003002021,GRREC,902,04,96,111,1,2,3,0,0,0,0,1,1,3,7,10,0,0,0,4,4,8,103,82,185,207
20192020,001,ADAIR,001,Adair County,020,Adair County Primary Center,001020,001001020,210003002345,GRREC,902,02,74,94,3,0,3,0,0,0,0,0,0,6,7,13,0,0,0,7,2,9,78,65,143,168
20192020,001,ADAIR,001,Adair County,020,Adair County Primary Center,001020,001001020,210003002345,GRREC,902,All Students,243,314,7,2,9,0,1,1,1,0,1,18,18,36,0,0,0,15,11,26,273,211,484,557
20192020,001,ADAIR,001,Adair County,020,Adair County Primary Center,001020,001001020,210003002345,GRREC,902,PS,34,54,1,0,1,0,0,0,0,0,0,4,3,7,0,0,0,1,2,3,48,29,77,88
20192020,001,ADAIR,001,Adair County,020,Adair County Primary Center,001020,001001020,210003002345,GRREC,902,KG,88,114,1,1,2,0,0,0,0,0,0,10,5,15,0,0,0,3,5,8,100,77,177,202
20192020,001,ADAIR,001,Adair County,020,Adair County Primary Center,001020,001001020,210003002345,GRREC,902,01,81,106,3,1,4,0,1,1,1,0,1,2,6,8,0,0,0,5,4,9,95,69,164,187
20192020,002,ALLEN,005,Allen County,"",---District Total---,005,"","",GRREC,902,12,91,111,0,0,0,0,0,0,0,0,0,5,0,5,0,0,0,1,3,4,105,88,193,202
20192020,002,ALLEN,005,Allen County,"",---District Total---,005,"","",GRREC,902,14,1,1,0,0,0,0,0,0,0,0,0,0,0,0,0,0,0,0,0,0,1,1,2,2
20192020,002,ALLEN,005,Allen County,"",---District Total---,005,"","",GRREC,902,All Students,1440,1528,15,16,31,1,2,3,7,9,16,70,54,124,0,0,0,42,32,74,1393,1327,2720,2968
20192020,002,ALLEN,005,Allen County,"",---District Total---,005,"","",GRREC,902,PS,64,83,2,0,2,0,0,0,0,0,0,6,5,11,0,0,0,2,2,4,73,57,130,147
20192020,002,ALLEN,005,Allen County,"",---District Total---,005,"","",GRREC,902,KG,91,123,1,2,3,0,0,0,0,0,0,6,1,7,0,0,0,2,0,2,114,88,202,214
20192020,002,ALLEN,005,Allen County,"",---District Total---,005,"","",GRREC,902,01,115,119,1,0,1,0,0,0,0,0,0,5,4,9,0,0,0,3,2,5,110,109,219,234
20192020,002,ALLEN,005,Allen County,"",---District Total---,005,"","",GRREC,902,02,93,115,2,2,4,1,0,1,1,0,1,3,8,11,0,0,0,5,3,8,103,80,183,208
20192020,002,ALLEN,005,Allen County,"",---District Total---,005,"","",GRREC,902,03,132,117,2,1,3,0,1,1,2,1,3,1,4,5,0,0,0,5,3,8,107,122,229,249
20192020,002,ALLEN,005,Allen County,"",---District Total---,005,"","",GRREC,902,04,111,130,0,3,3,0,0,0,0,0,0,4,6,10,0,0,0,6,5,11,120,97,217,241
20192020,002,ALLEN,005,Allen County,"",---District Total---,005,"","",GRREC,902,05,118,113,1,1,2,0,0,0,0,2,2,8,6,14,0,0,0,6,2,8,98,107,205,231
20192020,002,ALLEN,005,Allen County,"",---District Total---,005,"","",GRREC,902,06,113,115,2,1,3,0,0,0,1,0,1,10,4,14,0,0,0,3,1,4,99,107,206,228
20192020,002,ALLEN,005,Allen County,"",---District Total---,005,"","",GRREC,902,07,131,128,0,0,0,0,1,1,0,1,1,8,6,14,0,0,0,2,0,2,118,123,241,259
20192020,002,ALLEN,005,Allen County,"",---District Total---,005,"","",GRREC,902,08,120,111,2,0,2,0,0,0,0,4,4,8,7,15,0,0,0,0,0,0,101,109,210,231
20192020,002,ALLEN,005,Allen County,"",---District Total---,005,"","",GRREC,902,09,114,133,2,3,5,0,0,0,1,0,1,4,2,6,0,0,0,6,6,12,120,103,223,247
20192020,002,ALLEN,005,Allen County,"",---District Total---,005,"","",GRREC,902,10,94,106,2,0,2,0,0,0,1,0,1,4,2,6,0,0,0,1,4,5,98,88,186,200
20192020,002,ALLEN,005,Allen County,"",---District Total---,005,"","",GRREC,902,11,116,106,0,3,3,0,0,0,1,1,2,4,4,8,0,0,0,2,3,5,99,105,204,222
20192020,002,ALLEN,005,Allen County,010,Allen County Primary Center,005010,002005010,210007000008,GRREC,902,02,93,115,2,2,4,1,0,1,1,0,1,3,8,11,0,0,0,5,3,8,103,80,183,208
20192020,002,ALLEN,005,Allen County,010,Allen County Primary Center,005010,002005010,210007000008,GRREC,902,01,115,119,1,0,1,0,0,0,0,0,0,5,4,9,0,0,0,3,2,5,110,109,219,234
20192020,002,ALLEN,005,Allen County,010,Allen County Primary Center,005010,002005010,210007000008,GRREC,902,All Students,431,474,6,5,11,1,1,2,3,1,4,15,17,32,0,0,0,15,8,23,434,399,833,905
20192020,002,ALLEN,005,Allen County,010,Allen County Primary Center,005010,002005010,210007000008,GRREC,902,PS,64,83,2,0,2,0,0,0,0,0,0,6,5,11,0,0,0,2,2,4,73,57,130,147
20192020,002,ALLEN,005,Allen County,010,Allen County Primary Center,005010,002005010,210007000008,GRREC,902,KG,91,123,1,2,3,0,0,0,0,0,0,6,1,7,0,0,0,2,0,2,114,88,202,214
20192020,002,ALLEN,005,Allen County,010,Allen County Primary Center,005010,002005010,210007000008,GRREC,902,03,132,117,2,1,3,0,1,1,2,1,3,1,4,5,0,0,0,5,3,8,107,122,229,249
20192020,002,ALLEN,005,Allen County,015,James E Bazzell Middle School,005015,002005015,210007000009,GRREC,902,07,131,128,0,0,0,0,1,1,0,1,1,8,6,14,0,0,0,2,0,2,118,123,241,259
20192020,002,ALLEN,005,Allen County,015,James E Bazzell Middle School,005015,002005015,210007000009,GRREC,902,All Students,251,239,2,0,2,0,1,1,0,5,5,16,13,29,0,0,0,2,0,2,219,232,451,490
20192020,002,ALLEN,005,Allen County,015,James E Bazzell Middle School,005015,002005015,210007000009,GRREC,902,08,120,111,2,0,2,0,0,0,0,4,4,8,7,15,0,0,0,0,0,0,101,109,210,231
20192020,002,ALLEN,005,Allen County,020,Allen County-Scottsville High School,005020,002005020,210007000010,GRREC,902,12,91,111,0,0,0,0,0,0,0,0,0,5,0,5,0,0,0,1,3,4,105,88,193,202
20192020,002,ALLEN,005,Allen County,020,Allen County-Scottsville High School,005020,002005020,210007000010,GRREC,902,All Students,416,457,4,6,10,0,0,0,3,1,4,17,8,25,0,0,0,10,16,26,423,385,808,873
20192020,002,ALLEN,005,Allen County,020,Allen County-Scottsville High School,005020,002005020,210007000010,GRREC,902,09,114,133,2,3,5,0,0,0,1,0,1,4,2,6,0,0,0,6,6,12,120,103,223,247
20192020,002,ALLEN,005,Allen County,020,Allen County-Scottsville High School,005020,002005020,210007000010,GRREC,902,10,94,106,2,0,2,0,0,0,1,0,1,4,2,6,0,0,0,1,4,5,98,88,186,200
20192020,002,ALLEN,005,Allen County,020,Allen County-Scottsville High School,005020,002005020,210007000010,GRREC,902,11,116,106,0,3,3,0,0,0,1,1,2,4,4,8,0,0,0,2,3,5,99,105,204,222
20192020,002,ALLEN,005,Allen County,020,Allen County-Scottsville High School,005020,002005020,210007000010,GRREC,902,14,1,1,0,0,0,0,0,0,0,0,0,0,0,0,0,0,0,0,0,0,1,1,2,2
20192020,002,ALLEN,005,Allen County,060,Allen County Intermediate Center,005060,002005060,210007000013,GRREC,902,05,118,113,1,1,2,0,0,0,0,2,2,8,6,14,0,0,0,6,2,8,98,107,205,231
20192020,002,ALLEN,005,Allen County,060,Allen County Intermediate Center,005060,002005060,210007000013,GRREC,902,All Students,342,358,3,5,8,0,0,0,1,2,3,22,16,38,0,0,0,15,8,23,317,311,628,700
20192020,002,ALLEN,005,Allen County,060,Allen County Intermediate Center,005060,002005060,210007000013,GRREC,902,04,111,130,0,3,3,0,0,0,0,0,0,4,6,10,0,0,0,6,5,11,120,97,217,241
20192020,002,ALLEN,005,Allen County,060,Allen County Intermediate Center,005060,002005060,210007000013,GRREC,902,06,113,115,2,1,3,0,0,0,1,0,1,10,4,14,0,0,0,3,1,4,99,107,206,228
20192020,002,ALLEN,005,Allen County,901,Allen County Career and Technical Center,005901,002005901,210007002061,GRREC,902,10,0,0,0,0,0,0,0,0,0,0,0,0,0,0,0,0,0,0,0,0,0,0,0,0
20192020,002,ALLEN,005,Allen County,901,Allen County Career and Technical Center,005901,002005901,210007002061,GRREC,902,12,0,0,0,0,0,0,0,0,0,0,0,0,0,0,0,0,0,0,0,0,0,0,0,0
20192020,002,ALLEN,005,Allen County,901,Allen County Career and Technical Center,005901,002005901,210007002061,GRREC,902,All Students,0,0,0,0,0,0,0,0,0,0,0,0,0,0,0,0,0,0,0,0,0,0,0,0
20192020,002,ALLEN,005,Allen County,901,Allen County Career and Technical Center,005901,002005901,210007002061,GRREC,902,09,0,0,0,0,0,0,0,0,0,0,0,0,0,0,0,0,0,0,0,0,0,0,0,0
20192020,002,ALLEN,005,Allen County,901,Allen County Career and Technical Center,005901,002005901,210007002061,GRREC,902,11,0,0,0,0,0,0,0,0,0,0,0,0,0,0,0,0,0,0,0,0,0,0,0,0
20192020,056,JEFFERSON,006,Anchorage Independent,"",---District Total---,006,"","",OVEC,906,08,18,26,0,0,0,0,0,0,0,0,0,1,1,2,0,0,0,1,1,2,24,16,40,44
20192020,056,JEFFERSON,006,Anchorage Independent,"",---District Total---,006,"","",OVEC,906,All Students,182,210,1,1,2,0,0,0,8,10,18,6,5,11,0,0,0,4,7,11,191,159,350,392
20192020,056,JEFFERSON,006,Anchorage Independent,"",---District Total---,006,"","",OVEC,906,PS,0,1,0,0,0,0,0,0,0,0,0,0,0,0,0,0,0,0,0,0,1,0,1,1
20192020,056,JEFFERSON,006,Anchorage Independent,"",---District Total---,006,"","",OVEC,906,KG,19,16,0,0,0,0,0,0,1,0,1,0,0,0,0,0,0,0,1,1,15,18,33,35
20192020,056,JEFFERSON,006,Anchorage Independent,"",---District Total---,006,"","",OVEC,906,01,18,20,0,0,0,0,0,0,1,2,3,0,2,2,0,0,0,0,1,1,19,13,32,38
20192020,056,JEFFERSON,006,Anchorage Independent,"",---District Total---,006,"","",OVEC,906,02,25,27,0,0,0,0,0,0,1,2,3,3,0,3,0,0,0,1,3,4,22,20,42,52
20192020,056,JEFFERSON,006,Anchorage Independent,"",---District Total---,006,"","",OVEC,906,03,18,22,0,0,0,0,0,0,0,0,0,0,0,0,0,0,0,0,0,0,22,18,40,40
20192020,056,JEFFERSON,006,Anchorage Independent,"",---District Total---,006,"","",OVEC,906,04,26,24,1,0,1,0,0,0,0,2,2,1,2,3,0,0,0,1,1,2,21,21,42,50
20192020,056,JEFFERSON,006,Anchorage Independent,"",---District Total---,006,"","",OVEC,906,05,20,26,0,0,0,0,0,0,2,1,3,0,0,0,0,0,0,0,0,0,24,19,43,46
20192020,056,JEFFERSON,006,Anchorage Independent,"",---District Total---,006,"","",OVEC,906,06,26,26,0,1,1,0,0,0,3,1,4,1,0,1,0,0,0,1,0,1,21,24,45,52
20192020,056,JEFFERSON,006,Anchorage Independent,"",---District Total---,006,"","",OVEC,906,07,12,23,0,0,0,0,0,0,0,2,2,0,0,0,0,0,0,0,0,0,23,10,33,35
20192020,056,JEFFERSON,006,Anchorage Independent,010,Anchorage Independent Public School,006010,056006010,210009000014,OVEC,906,02,25,27,0,0,0,0,0,0,1,2,3,3,0,3,0,0,0,1,3,4,22,20,42,52
20192020,056,JEFFERSON,006,Anchorage Independent,010,Anchorage Independent Public School,006010,056006010,210009000014,OVEC,906,03,18,22,0,0,0,0,0,0,0,0,0,0,0,0,0,0,0,0,0,0,22,18,40,40
20192020,056,JEFFERSON,006,Anchorage Independent,010,Anchorage Independent Public School,006010,056006010,210009000014,OVEC,906,04,26,24,1,0,1,0,0,0,0,2,2,1,2,3,0,0,0,1,1,2,21,21,42,50
20192020,056,JEFFERSON,006,Anchorage Independent,010,Anchorage Independent Public School,006010,056006010,210009000014,OVEC,906,05,20,26,0,0,0,0,0,0,2,1,3,0,0,0,0,0,0,0,0,0,24,19,43,46
20192020,056,JEFFERSON,006,Anchorage Independent,010,Anchorage Independent Public School,006010,056006010,210009000014,OVEC,906,06,26,26,0,1,1,0,0,0,3,1,4,1,0,1,0,0,0,1,0,1,21,24,45,52
20192020,056,JEFFERSON,006,Anchorage Independent,010,Anchorage Independent Public School,006010,056006010,210009000014,OVEC,906,07,12,23,0,0,0,0,0,0,0,2,2,0,0,0,0,0,0,0,0,0,23,10,33,35
20192020,056,JEFFERSON,006,Anchorage Independent,010,Anchorage Independent Public School,006010,056006010,210009000014,OVEC,906,08,18,26,0,0,0,0,0,0,0,0,0,1,1,2,0,0,0,1,1,2,24,16,40,44
20192020,056,JEFFERSON,006,Anchorage Independent,010,Anchorage Independent Public School,006010,056006010,210009000014,OVEC,906,All Students,182,210,1,1,2,0,0,0,8,10,18,6,5,11,0,0,0,4,7,11,191,159,350,392
20192020,056,JEFFERSON,006,Anchorage Independent,010,Anchorage Independent Public School,006010,056006010,210009000014,OVEC,906,PS,0,1,0,0,0,0,0,0,0,0,0,0,0,0,0,0,0,0,0,0,1,0,1,1
20192020,056,JEFFERSON,006,Anchorage Independent,010,Anchorage Independent Public School,006010,056006010,210009000014,OVEC,906,KG,19,16,0,0,0,0,0,0,1,0,1,0,0,0,0,0,0,0,1,1,15,18,33,35
20192020,056,JEFFERSON,006,Anchorage Independent,010,Anchorage Independent Public School,006010,056006010,210009000014,OVEC,906,01,18,20,0,0,0,0,0,0,1,2,3,0,2,2,0,0,0,0,1,1,19,13,32,38
20192020,003,ANDERSON,011,Anderson County,"",---District Total---,011,"","",CKEC,901,08,135,159,2,1,3,0,0,0,1,1,2,7,5,12,0,0,0,4,6,10,145,122,267,294
20192020,003,ANDERSON,011,Anderson County,"",---District Total---,011,"","",CKEC,901,09,148,141,3,3,6,1,0,1,0,1,1,8,4,12,0,1,1,3,5,8,126,134,260,289
20192020,003,ANDERSON,011,Anderson County,"",---District Total---,011,"","",CKEC,901,10,140,160,4,4,8,0,1,1,0,2,2,6,4,10,0,0,0,4,9,13,146,120,266,300
20192020,003,ANDERSON,011,Anderson County,"",---District Total---,011,"","",CKEC,901,11,137,147,1,2,3,0,0,0,0,5,5,3,2,5,0,0,0,6,5,11,137,123,260,284
20192020,003,ANDERSON,011,Anderson County,"",---District Total---,011,"","",CKEC,901,14,2,0,0,0,0,0,0,0,0,0,0,0,0,0,0,0,0,0,0,0,0,2,2,2
20192020,003,ANDERSON,011,Anderson County,"",---District Total---,011,"","",CKEC,901,12,120,130,1,1,2,1,0,1,1,2,3,2,4,6,0,0,0,4,6,10,121,107,228,250
20192020,003,ANDERSON,011,Anderson County,"",---District Total---,011,"","",CKEC,901,All Students,1706,1849,23,29,52,3,1,4,10,18,28,73,51,124,0,1,1,68,75,143,1672,1531,3203,3555
20192020,003,ANDERSON,011,Anderson County,"",---District Total---,011,"","",CKEC,901,PS,82,119,1,0,1,0,0,0,1,1,2,4,4,8,0,0,0,3,1,4,110,76,186,201
20192020,003,ANDERSON,011,Anderson County,"",---District Total---,011,"","",CKEC,901,KG,141,121,1,4,5,0,0,0,0,2,2,2,2,4,0,0,0,6,3,9,112,130,242,262
20192020,003,ANDERSON,011,Anderson County,"",---District Total---,011,"","",CKEC,901,01,148,132,0,3,3,1,0,1,2,0,2,4,3,7,0,0,0,5,5,10,120,137,257,280
20192020,003,ANDERSON,011,Anderson County,"",---District Total---,011,"","",CKEC,901,02,93,109,2,0,2,0,0,0,0,2,2,3,4,7,0,0,0,3,7,10,101,80,181,202
20192020,003,ANDERSON,011,Anderson County,"",---District Total---,011,"","",CKEC,901,03,121,141,2,1,3,0,0,0,0,1,1,8,2,10,0,0,0,5,7,12,126,110,236,262
20192020,003,ANDERSON,011,Anderson County,"",---District Total---,011,"","",CKEC,901,04,111,117,1,1,2,0,0,0,1,0,1,4,5,9,0,0,0,7,1,8,104,104,208,228
20192020,003,ANDERSON,011,Anderson County,"",---District Total---,011,"","",CKEC,901,05,126,161,3,4,7,0,0,0,1,0,1,9,7,16,0,0,0,5,10,15,143,105,248,287
20192020,003,ANDERSON,011,Anderson County,"",---District Total---,011,"","",CKEC,901,06,141,177,1,5,6,0,0,0,3,0,3,8,6,14,0,0,0,9,9,18,156,121,277,318
20192020,003,ANDERSON,011,Anderson County,"",---District Total---,011,"","",CKEC,901,07,143,154,2,0,2,0,0,0,1,2,3,9,3,12,0,0,0,7,2,9,135,136,271,297
20192020,003,ANDERSON,011,Anderson County,020,Anderson County High School,011020,003011020,210012000016,CKEC,901,12,117,127,1,1,2,1,0,1,1,2,3,1,4,5,0,0,0,4,6,10,119,104,223,244
20192020,003,ANDERSON,011,Anderson County,020,Anderson County High School,011020,003011020,210012000016,CKEC,901,All Students,504,529,9,9,18,2,1,3,1,10,11,15,13,28,0,1,1,17,23,40,485,447,932,1033
20192020,003,ANDERSON,011,Anderson County,020,Anderson County High School,011020,003011020,210012000016,CKEC,901,09,136,121,3,3,6,1,0,1,0,1,1,6,4,10,0,1,1,3,5,8,108,122,230,257
20192020,003,ANDERSON,011,Anderson County,020,Anderson County High School,011020,003011020,210012000016,CKEC,901,10,130,147,4,4,8,0,1,1,0,2,2,5,3,8,0,0,0,4,8,12,134,112,246,277
20192020,003,ANDERSON,011,Anderson County,020,Anderson County High School,011020,003011020,210012000016,CKEC,901,11,119,134,1,1,2,0,0,0,0,5,5,3,2,5,0,0,0,6,4,10,124,107,231,253
20192020,003,ANDERSON,011,Anderson County,020,Anderson County High School,011020,003011020,210012000016,CKEC,901,14,2,0,0,0,0,0,0,0,0,0,0,0,0,0,0,0,0,0,0,0,0,2,2,2
20192020,003,ANDERSON,011,Anderson County,022,Robert B. Turner Elementary School,011022,003011022,210012001955,CKEC,901,04,46,39,0,0,0,0,0,0,1,0,1,2,2,4,0,0,0,1,0,1,35,44,79,85
20192020,003,ANDERSON,011,Anderson County,022,Robert B. Turner Elementary School,011022,003011022,210012001955,CKEC,901,All Students,274,262,1,3,4,0,0,0,2,1,3,6,5,11,0,0,0,9,10,19,244,255,499,536
20192020,003,ANDERSON,011,Anderson County,022,Robert B. Turner Elementary School,011022,003011022,210012001955,CKEC,901,KG,50,42,1,1,2,0,0,0,0,1,1,0,0,0,0,0,0,1,0,1,40,48,88,92
20192020,003,ANDERSON,011,Anderson County,022,Robert B. Turner Elementary School,011022,003011022,210012001955,CKEC,901,01,52,38,0,1,1,0,0,0,1,0,1,1,0,1,0,0,0,1,1,2,35,50,85,90
20192020,003,ANDERSON,011,Anderson County,022,Robert B. Turner Elementary School,011022,003011022,210012001955,CKEC,901,02,35,34,0,0,0,0,0,0,0,0,0,0,2,2,0,0,0,0,2,2,34,31,65,69
20192020,003,ANDERSON,011,Anderson County,022,Robert B. Turner Elementary School,011022,003011022,210012001955,CKEC,901,03,48,50,0,0,0,0,0,0,0,0,0,2,0,2,0,0,0,4,3,7,44,45,89,98
20192020,003,ANDERSON,011,Anderson County,022,Robert B. Turner Elementary School,011022,003011022,210012001955,CKEC,901,05,43,59,0,1,1,0,0,0,0,0,0,1,1,2,0,0,0,2,4,6,56,37,93,102
20192020,003,ANDERSON,011,Anderson County,025,Anderson County Middle School,011025,003011025,210012000017,CKEC,901,08,130,156,2,1,3,0,0,0,1,1,2,7,5,12,0,0,0,4,6,10,142,117,259,286
20192020,003,ANDERSON,011,Anderson County,025,Anderson County Middle School,011025,003011025,210012000017,CKEC,901,All Students,411,484,5,6,11,0,0,0,5,3,8,23,14,37,0,0,0,20,17,37,431,371,802,895
20192020,003,ANDERSON,011,Anderson County,025,Anderson County Middle School,011025,003011025,210012000017,CKEC,901,05,0,2,0,0,0,0,0,0,0,0,0,0,0,0,0,0,0,0,0,0,2,0,2,2
20192020,003,ANDERSON,011,Anderson County,025,Anderson County Middle School,011025,003011025,210012000017,CKEC,901,06,141,172,1,5,6,0,0,0,3,0,3,7,6,13,0,0,0,9,9,18,152,121,273,313
20192020,003,ANDERSON,011,Anderson County,025,Anderson County Middle School,011025,003011025,210012000017,CKEC,901,07,140,154,2,0,2,0,0,0,1,2,3,9,3,12,0,0,0,7,2,9,135,133,268,294
20192020,003,ANDERSON,011,Anderson County,030,APEX Academy,011030,003011030,210012002371,CKEC,901,12,3,3,0,0,0,0,0,0,0,0,0,1,0,1,0,0,0,0,0,0,2,3,5,6
20192020,003,ANDERSON,011,Anderson County,030,APEX Academy,011030,003011030,210012002371,CKEC,901,All Students,51,57,0,1,1,0,0,0,0,0,0,5,1,6,0,0,0,0,2,2,52,47,99,108
20192020,003,ANDERSON,011,Anderson County,030,APEX Academy,011030,003011030,210012002371,CKEC,901,06,0,5,0,0,0,0,0,0,0,0,0,1,0,1,0,0,0,0,0,0,4,0,4,5
20192020,003,ANDERSON,011,Anderson County,030,APEX Academy,011030,003011030,210012002371,CKEC,901,07,3,0,0,0,0,0,0,0,0,0,0,0,0,0,0,0,0,0,0,0,0,3,3,3
20192020,003,ANDERSON,011,Anderson County,030,APEX Academy,011030,003011030,210012002371,CKEC,901,08,5,3,0,0,0,0,0,0,0,0,0,0,0,0,0,0,0,0,0,0,3,5,8,8
20192020,003,ANDERSON,011,Anderson County,030,APEX Academy,011030,003011030,210012002371,CKEC,901,09,12,20,0,0,0,0,0,0,0,0,0,2,0,2,0,0,0,0,0,0,18,12,30,32
20192020,003,ANDERSON,011,Anderson County,030,APEX Academy,011030,003011030,210012002371,CKEC,901,10,10,13,0,0,0,0,0,0,0,0,0,1,1,2,0,0,0,0,1,1,12,8,20,23
20192020,003,ANDERSON,011,Anderson County,030,APEX Academy,011030,003011030,210012002371,CKEC,901,11,18,13,0,1,1,0,0,0,0,0,0,0,0,0,0,0,0,0,1,1,13,16,29,31
20192020,003,ANDERSON,011,Anderson County,050,Saffell Street Elementary School,011050,003011050,210012000018,CKEC,901,04,28,36,1,1,2,0,0,0,0,0,0,2,2,4,0,0,0,3,1,4,30,24,54,64
20192020,003,ANDERSON,011,Anderson County,050,Saffell Street Elementary School,011050,003011050,210012000018,CKEC,901,All Students,186,208,6,5,11,1,0,1,1,1,2,17,10,27,0,0,0,11,12,23,172,158,330,394
20192020,003,ANDERSON,011,Anderson County,050,Saffell Street Elementary School,011050,003011050,210012000018,CKEC,901,01,48,38,0,1,1,1,0,1,1,0,1,1,1,2,0,0,0,1,3,4,34,43,77,86
20192020,003,ANDERSON,011,Anderson County,050,Saffell Street Elementary School,011050,003011050,210012000018,CKEC,901,02,26,39,1,0,1,0,0,0,0,1,1,3,2,5,0,0,0,3,3,6,32,20,52,65
20192020,003,ANDERSON,011,Anderson County,050,Saffell Street Elementary School,011050,003011050,210012000018,CKEC,901,03,35,42,1,0,1,0,0,0,0,0,0,6,1,7,0,0,0,1,2,3,34,32,66,77
20192020,003,ANDERSON,011,Anderson County,050,Saffell Street Elementary School,011050,003011050,210012000018,CKEC,901,05,49,53,3,3,6,0,0,0,0,0,0,5,4,9,0,0,0,3,3,6,42,39,81,102
20192020,003,ANDERSON,011,Anderson County,110,Emma B. Ward Elementary School,011110,003011110,210012000021,CKEC,901,04,37,42,0,0,0,0,0,0,0,0,0,0,1,1,0,0,0,3,0,3,39,36,75,79
20192020,003,ANDERSON,011,Anderson County,110,Emma B. Ward Elementary School,011110,003011110,210012000021,CKEC,901,All Students,189,230,2,2,4,0,0,0,1,2,3,5,6,11,0,0,0,6,8,14,216,171,387,419
20192020,003,ANDERSON,011,Anderson County,110,Emma B. Ward Elementary School,011110,003011110,210012000021,CKEC,901,01,48,56,0,1,1,0,0,0,0,0,0,2,2,4,0,0,0,3,1,4,51,44,95,104
20192020,003,ANDERSON,011,Anderson County,110,Emma B. Ward Elementary School,011110,003011110,210012000021,CKEC,901,02,32,36,1,0,1,0,0,0,0,1,1,0,0,0,0,0,0,0,2,2,35,29,64,68
20192020,003,ANDERSON,011,Anderson County,110,Emma B. Ward Elementary School,011110,003011110,210012000021,CKEC,901,03,38,49,1,1,2,0,0,0,0,1,1,0,1,1,0,0,0,0,2,2,48,33,81,87
20192020,003,ANDERSON,011,Anderson County,110,Emma B. Ward Elementary School,011110,003011110,210012000021,CKEC,901,05,34,47,0,0,0,0,0,0,1,0,1,3,2,5,0,0,0,0,3,3,43,29,72,81
20192020,003,ANDERSON,011,Anderson County,120,Ezra Sparrow Early Childhood Center,011120,003011120,210012001298,CKEC,901,PS,82,119,1,0,1,0,0,0,1,1,2,4,4,8,0,0,0,3,1,4,110,76,186,201
20192020,003,ANDERSON,011,Anderson County,120,Ezra Sparrow Early Childhood Center,011120,003011120,210012001298,CKEC,901,All Students,91,79,0,3,3,0,0,0,0,1,1,2,2,4,0,0,0,5,3,8,72,82,154,170
20192020,003,ANDERSON,011,Anderson County,120,Ezra Sparrow Early Childhood Center,011120,003011120,210012001298,CKEC,901,KG,91,79,0,3,3,0,0,0,0,1,1,2,2,4,0,0,0,5,3,8,72,82,154,170
20192020,010,BOYD,012,Ashland Independent,"",---District Total---,012,"","",KEDC,903,14,0,2,0,0,0,0,0,0,0,0,0,0,0,0,0,0,0,0,0,0,2,0,2,2
20192020,010,BOYD,012,Ashland Independent,"",---District Total---,012,"","",KEDC,903,All Students,1548,1570,66,62,128,2,1,3,9,10,19,53,60,113,2,1,3,104,110,214,1334,1304,2638,3118
20192020,010,BOYD,012,Ashland Independent,"",---District Total---,012,"","",KEDC,903,PS,0,0,0,0,0,0,0,0,0,0,0,0,0,0,0,0,0,0,0,0,0,0,0,0
20192020,010,BOYD,012,Ashland Independent,"",---District Total---,012,"","",KEDC,903,KG,138,126,4,5,9,0,0,0,1,0,1,2,8,10,0,0,0,14,7,21,105,118,223,264
20192020,010,BOYD,012,Ashland Independent,"",---District Total---,012,"","",KEDC,903,01,127,141,8,4,12,0,0,0,0,0,0,3,2,5,0,0,0,9,10,19,121,111,232,268
20192020,010,BOYD,012,Ashland Independent,"",---District Total---,012,"","",KEDC,903,02,118,135,7,2,9,0,0,0,2,0,2,3,5,8,0,0,0,9,7,16,114,104,218,253
20192020,010,BOYD,012,Ashland Independent,"",---District Total---,012,"","",KEDC,903,03,118,110,2,7,9,0,0,0,2,2,4,5,9,14,0,0,0,6,8,14,95,92,187,228
20192020,010,BOYD,012,Ashland Independent,"",---District Total---,012,"","",KEDC,903,04,114,120,9,7,16,0,0,0,1,0,1,5,4,9,0,0,0,10,7,17,95,96,191,234
20192020,010,BOYD,012,Ashland Independent,"",---District Total---,012,"","",KEDC,903,05,111,108,3,6,9,0,0,0,0,0,0,4,5,9,0,0,0,5,9,14,96,91,187,219
20192020,010,BOYD,012,Ashland Independent,"",---District Total---,012,"","",KEDC,903,06,135,125,5,6,11,0,0,0,0,1,1,5,2,7,0,0,0,7,18,25,108,108,216,260
20192020,010,BOYD,012,Ashland Independent,"",---District Total---,012,"","",KEDC,903,07,116,111,1,3,4,0,0,0,0,2,2,2,6,8,1,0,1,8,8,16,99,97,196,227
20192020,010,BOYD,012,Ashland Independent,"",---District Total---,012,"","",KEDC,903,08,129,143,7,5,12,1,0,1,0,0,0,7,8,15,0,0,0,6,11,17,122,105,227,272
20192020,010,BOYD,012,Ashland Independent,"",---District Total---,012,"","",KEDC,903,09,110,111,8,3,11,0,0,0,2,2,4,5,4,9,0,0,0,13,9,22,83,92,175,221
20192020,010,BOYD,012,Ashland Independent,"",---District Total---,012,"","",KEDC,903,10,114,127,6,5,11,0,1,1,0,2,2,5,0,5,1,0,1,9,4,13,106,102,208,241
20192020,010,BOYD,012,Ashland Independent,"",---District Total---,012,"","",KEDC,903,11,106,119,5,6,11,1,0,1,1,1,2,4,2,6,0,0,0,4,7,11,104,90,194,225
20192020,010,BOYD,012,Ashland Independent,"",---District Total---,012,"","",KEDC,903,12,112,92,1,3,4,0,0,0,0,0,0,3,5,8,0,1,1,4,5,9,84,98,182,204
20192020,010,BOYD,012,Ashland Independent,005,Ashland Alternative School,012005,010012005,210015002487,KEDC,903,12,1,1,0,1,1,0,0,0,0,0,0,0,0,0,0,0,0,0,0,0,1,0,1,2
20192020,010,BOYD,012,Ashland Independent,005,Ashland Alternative School,012005,010012005,210015002487,KEDC,903,All Students,4,10,1,1,2,0,0,0,0,0,0,0,0,0,0,0,0,1,0,1,8,3,11,14
20192020,010,BOYD,012,Ashland Independent,005,Ashland Alternative School,012005,010012005,210015002487,KEDC,903,07,0,2,0,0,0,0,0,0,0,0,0,0,0,0,0,0,0,0,0,0,2,0,2,2
20192020,010,BOYD,012,Ashland Independent,005,Ashland Alternative School,012005,010012005,210015002487,KEDC,903,08,2,4,0,0,0,0,0,0,0,0,0,0,0,0,0,0,0,1,0,1,3,2,5,6
20192020,010,BOYD,012,Ashland Independent,005,Ashland Alternative School,012005,010012005,210015002487,KEDC,903,09,0,2,1,0,1,0,0,0,0,0,0,0,0,0,0,0,0,0,0,0,1,0,1,2
20192020,010,BOYD,012,Ashland Independent,005,Ashland Alternative School,012005,010012005,210015002487,KEDC,903,11,1,1,0,0,0,0,0,0,0,0,0,0,0,0,0,0,0,0,0,0,1,1,2,2
20192020,010,BOYD,012,Ashland Independent,010,Paul G. Blazer High School,012010,010012010,210015000022,KEDC,903,11,105,118,5,6,11,1,0,1,1,1,2,4,2,6,0,0,0,4,7,11,103,89,192,223
20192020,010,BOYD,012,Ashland Independent,010,Paul G. Blazer High School,012010,010012010,210015000022,KEDC,903,All Students,440,447,19,16,35,1,1,2,3,5,8,17,11,28,1,1,2,30,25,55,376,381,757,887
20192020,010,BOYD,012,Ashland Independent,010,Paul G. Blazer High School,012010,010012010,210015000022,KEDC,903,09,110,109,7,3,10,0,0,0,2,2,4,5,4,9,0,0,0,13,9,22,82,92,174,219
20192020,010,BOYD,012,Ashland Independent,010,Paul G. Blazer High School,012010,010012010,210015000022,KEDC,903,10,114,127,6,5,11,0,1,1,0,2,2,5,0,5,1,0,1,9,4,13,106,102,208,241
20192020,010,BOYD,012,Ashland Independent,010,Paul G. Blazer High School,012010,010012010,210015000022,KEDC,903,12,111,91,1,2,3,0,0,0,0,0,0,3,5,8,0,1,1,4,5,9,83,98,181,202
20192020,010,BOYD,012,Ashland Independent,010,Paul G. Blazer High School,012010,010012010,210015000022,KEDC,903,14,0,2,0,0,0,0,0,0,0,0,0,0,0,0,0,0,0,0,0,0,2,0,2,2
20192020,010,BOYD,012,Ashland Independent,012,Ashland Head Start,012012,010012012,210015002023,KEDC,903,All Students,0,0,0,0,0,0,0,0,0,0,0,0,0,0,0,0,0,0,0,0,0,0,0,0
20192020,010,BOYD,012,Ashland Independent,012,Ashland Head Start,012012,010012012,210015002023,KEDC,903,PS,0,0,0,0,0,0,0,0,0,0,0,0,0,0,0,0,0,0,0,0,0,0,0,0
20192020,010,BOYD,012,Ashland Independent,050,Ashland Middle School,012050,010012050,210015000023,KEDC,903,All Students,378,373,13,14,27,1,0,1,0,3,3,14,16,30,1,0,1,20,37,57,324,308,632,751
20192020,010,BOYD,012,Ashland Independent,050,Ashland Middle School,012050,010012050,210015000023,KEDC,903,06,135,125,5,6,11,0,0,0,0,1,1,5,2,7,0,0,0,7,18,25,108,108,216,260
20192020,010,BOYD,012,Ashland Independent,050,Ashland Middle School,012050,010012050,210015000023,KEDC,903,07,116,109,1,3,4,0,0,0,0,2,2,2,6,8,1,0,1,8,8,16,97,97,194,225
20192020,010,BOYD,012,Ashland Independent,050,Ashland Middle School,012050,010012050,210015000023,KEDC,903,08,127,139,7,5,12,1,0,1,0,0,0,7,8,15,0,0,0,5,11,16,119,103,222,266
20192020,010,BOYD,012,Ashland Independent,070,Crabbe Elementary School,012070,010012070,210015000025,KEDC,903,05,19,13,1,2,3,0,0,0,0,0,0,2,2,4,0,0,0,1,1,2,9,14,23,32
20192020,010,BOYD,012,Ashland Independent,070,Crabbe Elementary School,012070,010012070,210015000025,KEDC,903,04,20,15,2,2,4,0,0,0,0,0,0,1,4,5,0,0,0,4,1,5,8,13,21,35
20192020,010,BOYD,012,Ashland Independent,070,Crabbe Elementary School,012070,010012070,210015000025,KEDC,903,All Students,135,144,8,9,17,0,0,0,0,0,0,6,14,20,0,0,0,12,9,21,118,103,221,279
20192020,010,BOYD,012,Ashland Independent,070,Crabbe Elementary School,012070,010012070,210015000025,KEDC,903,KG,33,31,0,0,0,0,0,0,0,0,0,1,4,5,0,0,0,4,3,7,26,26,52,64
20192020,010,BOYD,012,Ashland Independent,070,Crabbe Elementary School,012070,010012070,210015000025,KEDC,903,01,27,32,1,3,4,0,0,0,0,0,0,0,1,1,0,0,0,1,2,3,30,21,51,59
20192020,010,BOYD,012,Ashland Independent,070,Crabbe Elementary School,012070,010012070,210015000025,KEDC,903,02,21,31,4,1,5,0,0,0,0,0,0,1,3,4,0,0,0,2,1,3,24,16,40,52
20192020,010,BOYD,012,Ashland Independent,070,Crabbe Elementary School,012070,010012070,210015000025,KEDC,903,03,15,22,0,1,1,0,0,0,0,0,0,1,0,1,0,0,0,0,1,1,21,13,34,37
20192020,010,BOYD,012,Ashland Independent,080,Hager Elementary School,012080,010012080,210015000026,KEDC,903,KG,42,29,1,2,3,0,0,0,1,0,1,1,1,2,0,0,0,2,0,2,24,39,63,71
20192020,010,BOYD,012,Ashland Independent,080,Hager Elementary School,012080,010012080,210015000026,KEDC,903,All Students,197,186,5,4,9,0,0,0,4,1,5,4,6,10,0,0,0,9,7,16,164,179,343,383
20192020,010,BOYD,012,Ashland Independent,080,Hager Elementary School,012080,010012080,210015000026,KEDC,903,01,30,30,2,0,2,0,0,0,0,0,0,0,0,0,0,0,0,1,2,3,27,28,55,60
20192020,010,BOYD,012,Ashland Independent,080,Hager Elementary School,012080,010012080,210015000026,KEDC,903,02,41,39,0,0,0,0,0,0,2,0,2,0,0,0,0,0,0,2,1,3,35,40,75,80
20192020,010,BOYD,012,Ashland Independent,080,Hager Elementary School,012080,010012080,210015000026,KEDC,903,03,30,25,0,1,1,0,0,0,1,1,2,0,4,4,0,0,0,1,2,3,23,22,45,55
20192020,010,BOYD,012,Ashland Independent,080,Hager Elementary School,012080,010012080,210015000026,KEDC,903,04,29,31,1,1,2,0,0,0,0,0,0,1,0,1,0,0,0,2,1,3,27,27,54,60
20192020,010,BOYD,012,Ashland Independent,080,Hager Elementary School,012080,010012080,210015000026,KEDC,903,05,25,32,1,0,1,0,0,0,0,0,0,2,1,3,0,0,0,1,1,2,28,23,51,57
20192020,010,BOYD,012,Ashland Independent,100,Oakview Elementary School,012100,010012100,210015000028,KEDC,903,05,22,35,1,1,2,0,0,0,0,0,0,0,0,0,0,0,0,1,3,4,33,18,51,57
20192020,010,BOYD,012,Ashland Independent,100,Oakview Elementary School,012100,010012100,210015000028,KEDC,903,All Students,153,170,5,4,9,0,0,0,0,0,0,4,2,6,0,0,0,13,13,26,148,134,282,323
20192020,010,BOYD,012,Ashland Independent,100,Oakview Elementary School,012100,010012100,210015000028,KEDC,903,KG,24,21,0,1,1,0,0,0,0,0,0,0,0,0,0,0,0,4,1,5,17,22,39,45
20192020,010,BOYD,012,Ashland Independent,100,Oakview Elementary School,012100,010012100,210015000028,KEDC,903,01,29,36,1,0,1,0,0,0,0,0,0,2,0,2,0,0,0,3,1,4,30,28,58,65
20192020,010,BOYD,012,Ashland Independent,100,Oakview Elementary School,012100,010012100,210015000028,KEDC,903,02,23,24,1,0,1,0,0,0,0,0,0,0,2,2,0,0,0,3,2,5,20,19,39,47
20192020,010,BOYD,012,Ashland Independent,100,Oakview Elementary School,012100,010012100,210015000028,KEDC,903,03,30,25,0,0,0,0,0,0,0,0,0,1,0,1,0,0,0,1,3,4,23,27,50,55
20192020,010,BOYD,012,Ashland Independent,100,Oakview Elementary School,012100,010012100,210015000028,KEDC,903,04,25,29,2,2,4,0,0,0,0,0,0,1,0,1,0,0,0,1,3,4,25,20,45,54
20192020,010,BOYD,012,Ashland Independent,110,Poage Elementary School,012110,010012110,210015000029,KEDC,903,04,21,23,2,1,3,0,0,0,1,0,1,0,0,0,0,0,0,3,0,3,17,20,37,44
20192020,010,BOYD,012,Ashland Independent,110,Poage Elementary School,012110,010012110,210015000029,KEDC,903,All Students,127,134,11,7,18,0,0,0,1,1,2,3,4,7,0,0,0,13,9,22,106,106,212,261
20192020,010,BOYD,012,Ashland Independent,110,Poage Elementary School,012110,010012110,210015000029,KEDC,903,KG,23,25,2,1,3,0,0,0,0,0,0,0,1,1,0,0,0,3,1,4,20,20,40,48
20192020,010,BOYD,012,Ashland Independent,110,Poage Elementary School,012110,010012110,210015000029,KEDC,903,01,24,29,4,0,4,0,0,0,0,0,0,1,1,2,0,0,0,2,4,6,22,19,41,53
20192020,010,BOYD,012,Ashland Independent,110,Poage Elementary School,012110,010012110,210015000029,KEDC,903,02,16,22,2,0,2,0,0,0,0,0,0,0,0,0,0,0,0,2,2,4,18,14,32,38
20192020,010,BOYD,012,Ashland Independent,110,Poage Elementary School,012110,010012110,210015000029,KEDC,903,03,23,18,1,4,5,0,0,0,0,1,1,2,1,3,0,0,0,1,1,2,14,16,30,41
20192020,010,BOYD,012,Ashland Independent,110,Poage Elementary School,012110,010012110,210015000029,KEDC,903,05,20,17,0,1,1,0,0,0,0,0,0,0,1,1,0,0,0,2,1,3,15,17,32,37
20192020,010,BOYD,012,Ashland Independent,130,Charles Russell Elementary School,012130,010012130,210015000031,KEDC,903,03,20,20,1,1,2,0,0,0,1,0,1,1,4,5,0,0,0,3,1,4,14,14,28,40
20192020,010,BOYD,012,Ashland Independent,130,Charles Russell Elementary School,012130,010012130,210015000031,KEDC,903,All Students,114,106,4,7,11,0,0,0,1,0,1,5,7,12,0,0,0,6,10,16,90,90,180,220
20192020,010,BOYD,012,Ashland Independent,130,Charles Russell Elementary School,012130,010012130,210015000031,KEDC,903,05,25,11,0,2,2,0,0,0,0,0,0,0,1,1,0,0,0,0,3,3,11,19,30,36
20192020,010,BOYD,012,Ashland Independent,130,Charles Russell Elementary School,012130,010012130,210015000031,KEDC,903,KG,16,20,1,1,2,0,0,0,0,0,0,0,2,2,0,0,0,1,2,3,18,11,29,36
20192020,010,BOYD,012,Ashland Independent,130,Charles Russell Elementary School,012130,010012130,210015000031,KEDC,903,01,17,14,0,1,1,0,0,0,0,0,0,0,0,0,0,0,0,2,1,3,12,15,27,31
20192020,010,BOYD,012,Ashland Independent,130,Charles Russell Elementary School,012130,010012130,210015000031,KEDC,903,02,17,19,0,1,1,0,0,0,0,0,0,2,0,2,0,0,0,0,1,1,17,15,32,36
20192020,010,BOYD,012,Ashland Independent,130,Charles Russell Elementary School,012130,010012130,210015000031,KEDC,903,04,19,22,2,1,3,0,0,0,0,0,0,2,0,2,0,0,0,0,2,2,18,16,34,41
20192020,012,BRACKEN,013,Augusta Independent,"",---District Total---,013,"","",KEDC,903,09,14,12,0,0,0,0,0,0,0,0,0,0,0,0,0,0,0,0,1,1,12,13,25,26
20192020,012,BRACKEN,013,Augusta Independent,"",---District Total---,013,"","",KEDC,903,All Students,132,149,1,1,2,1,0,1,0,0,0,5,1,6,0,0,0,1,2,3,141,128,269,281
20192020,012,BRACKEN,013,Augusta Independent,"",---District Total---,013,"","",KEDC,903,PS,7,9,0,0,0,0,0,0,0,0,0,0,0,0,0,0,0,1,0,1,8,7,15,16
20192020,012,BRACKEN,013,Augusta Independent,"",---District Total---,013,"","",KEDC,903,KG,7,13,0,0,0,0,0,0,0,0,0,1,1,2,0,0,0,0,0,0,12,6,18,20
20192020,012,BRACKEN,013,Augusta Independent,"",---District Total---,013,"","",KEDC,903,01,15,7,0,0,0,0,0,0,0,0,0,1,0,1,0,0,0,0,0,0,6,15,21,22
20192020,012,BRACKEN,013,Augusta Independent,"",---District Total---,013,"","",KEDC,903,02,8,13,0,0,0,0,0,0,0,0,0,0,0,0,0,0,0,1,1,2,12,7,19,21
20192020,012,BRACKEN,013,Augusta Independent,"",---District Total---,013,"","",KEDC,903,03,9,12,1,0,1,0,0,0,0,0,0,1,0,1,0,0,0,0,0,0,10,9,19,21
20192020,012,BRACKEN,013,Augusta Independent,"",---District Total---,013,"","",KEDC,903,04,6,7,0,0,0,0,0,0,0,0,0,1,0,1,0,0,0,0,0,0,6,6,12,13
20192020,012,BRACKEN,013,Augusta Independent,"",---District Total---,013,"","",KEDC,903,05,9,13,0,0,0,0,0,0,0,0,0,0,0,0,0,0,0,0,0,0,13,9,22,22
20192020,012,BRACKEN,013,Augusta Independent,"",---District Total---,013,"","",KEDC,903,06,9,10,0,0,0,0,0,0,0,0,0,1,0,1,0,0,0,0,0,0,9,9,18,19
20192020,012,BRACKEN,013,Augusta Independent,"",---District Total---,013,"","",KEDC,903,07,14,18,0,0,0,1,0,1,0,0,0,0,0,0,0,0,0,0,0,0,17,14,31,32
20192020,012,BRACKEN,013,Augusta Independent,"",---District Total---,013,"","",KEDC,903,08,9,15,0,1,1,0,0,0,0,0,0,0,0,0,0,0,0,0,0,0,15,8,23,24
20192020,012,BRACKEN,013,Augusta Independent,"",---District Total---,013,"","",KEDC,903,10,10,14,0,0,0,0,0,0,0,0,0,0,0,0,0,0,0,0,0,0,14,10,24,24
20192020,012,BRACKEN,013,Augusta Independent,"",---District Total---,013,"","",KEDC,903,11,8,7,0,0,0,0,0,0,0,0,0,0,0,0,0,0,0,0,0,0,7,8,15,15
20192020,012,BRACKEN,013,Augusta Independent,"",---District Total---,013,"","",KEDC,903,12,14,8,0,0,0,0,0,0,0,0,0,0,0,0,0,0,0,0,0,0,8,14,22,22
20192020,012,BRACKEN,013,Augusta Independent,011,Augusta Independent School,013011,012013011,210018001968,KEDC,903,12,14,8,0,0,0,0,0,0,0,0,0,0,0,0,0,0,0,0,0,0,8,14,22,22
20192020,012,BRACKEN,013,Augusta Independent,011,Augusta Independent School,013011,012013011,210018001968,KEDC,903,All Students,132,149,1,1,2,1,0,1,0,0,0,5,1,6,0,0,0,1,2,3,141,128,269,281
20192020,012,BRACKEN,013,Augusta Independent,011,Augusta Independent School,013011,012013011,210018001968,KEDC,903,PS,7,9,0,0,0,0,0,0,0,0,0,0,0,0,0,0,0,1,0,1,8,7,15,16
20192020,012,BRACKEN,013,Augusta Independent,011,Augusta Independent School,013011,012013011,210018001968,KEDC,903,KG,7,13,0,0,0,0,0,0,0,0,0,1,1,2,0,0,0,0,0,0,12,6,18,20
20192020,012,BRACKEN,013,Augusta Independent,011,Augusta Independent School,013011,012013011,210018001968,KEDC,903,01,15,7,0,0,0,0,0,0,0,0,0,1,0,1,0,0,0,0,0,0,6,15,21,22
20192020,012,BRACKEN,013,Augusta Independent,011,Augusta Independent School,013011,012013011,210018001968,KEDC,903,02,8,13,0,0,0,0,0,0,0,0,0,0,0,0,0,0,0,1,1,2,12,7,19,21
20192020,012,BRACKEN,013,Augusta Independent,011,Augusta Independent School,013011,012013011,210018001968,KEDC,903,03,9,12,1,0,1,0,0,0,0,0,0,1,0,1,0,0,0,0,0,0,10,9,19,21
20192020,012,BRACKEN,013,Augusta Independent,011,Augusta Independent School,013011,012013011,210018001968,KEDC,903,04,6,7,0,0,0,0,0,0,0,0,0,1,0,1,0,0,0,0,0,0,6,6,12,13
20192020,012,BRACKEN,013,Augusta Independent,011,Augusta Independent School,013011,012013011,210018001968,KEDC,903,05,9,13,0,0,0,0,0,0,0,0,0,0,0,0,0,0,0,0,0,0,13,9,22,22
20192020,012,BRACKEN,013,Augusta Independent,011,Augusta Independent School,013011,012013011,210018001968,KEDC,903,06,9,10,0,0,0,0,0,0,0,0,0,1,0,1,0,0,0,0,0,0,9,9,18,19
20192020,012,BRACKEN,013,Augusta Independent,011,Augusta Independent School,013011,012013011,210018001968,KEDC,903,07,14,18,0,0,0,1,0,1,0,0,0,0,0,0,0,0,0,0,0,0,17,14,31,32
20192020,012,BRACKEN,013,Augusta Independent,011,Augusta Independent School,013011,012013011,210018001968,KEDC,903,08,9,15,0,1,1,0,0,0,0,0,0,0,0,0,0,0,0,0,0,0,15,8,23,24
20192020,012,BRACKEN,013,Augusta Independent,011,Augusta Independent School,013011,012013011,210018001968,KEDC,903,09,14,12,0,0,0,0,0,0,0,0,0,0,0,0,0,0,0,0,1,1,12,13,25,26
20192020,012,BRACKEN,013,Augusta Independent,011,Augusta Independent School,013011,012013011,210018001968,KEDC,903,10,10,14,0,0,0,0,0,0,0,0,0,0,0,0,0,0,0,0,0,0,14,10,24,24
20192020,012,BRACKEN,013,Augusta Independent,011,Augusta Independent School,013011,012013011,210018001968,KEDC,903,11,8,7,0,0,0,0,0,0,0,0,0,0,0,0,0,0,0,0,0,0,7,8,15,15
20192020,004,BALLARD,015,Ballard County,"",---District Total---,015,"","",WKEC,908,10,40,43,5,1,6,1,1,2,0,1,1,0,0,0,0,0,0,0,0,0,37,37,74,83
20192020,004,BALLARD,015,Ballard County,"",---District Total---,015,"","",WKEC,908,All Students,485,551,16,13,29,1,3,4,2,2,4,6,7,13,0,0,0,29,22,51,497,438,935,1036
20192020,004,BALLARD,015,Ballard County,"",---District Total---,015,"","",WKEC,908,PS,59,66,1,1,2,0,0,0,0,0,0,1,3,4,0,0,0,4,3,7,60,52,112,125
20192020,004,BALLARD,015,Ballard County,"",---District Total---,015,"","",WKEC,908,KG,37,42,0,1,1,0,1,1,0,0,0,1,1,2,0,0,0,1,3,4,40,31,71,79
20192020,004,BALLARD,015,Ballard County,"",---District Total---,015,"","",WKEC,908,01,33,42,1,2,3,0,0,0,0,0,0,0,0,0,0,0,0,1,3,4,40,28,68,75
20192020,004,BALLARD,015,Ballard County,"",---District Total---,015,"","",WKEC,908,02,38,45,2,0,2,0,0,0,0,1,1,0,0,0,0,0,0,3,0,3,40,37,77,83
20192020,004,BALLARD,015,Ballard County,"",---District Total---,015,"","",WKEC,908,03,37,43,0,1,1,0,0,0,0,0,0,1,2,3,0,0,0,2,3,5,40,31,71,80
20192020,004,BALLARD,015,Ballard County,"",---District Total---,015,"","",WKEC,908,04,41,50,0,1,1,0,0,0,0,0,0,0,0,0,0,0,0,2,1,3,48,39,87,91
20192020,004,BALLARD,015,Ballard County,"",---District Total---,015,"","",WKEC,908,05,47,38,1,0,1,0,0,0,0,0,0,2,1,3,0,0,0,3,4,7,32,42,74,85
20192020,004,BALLARD,015,Ballard County,"",---District Total---,015,"","",WKEC,908,06,43,53,0,2,2,0,0,0,0,0,0,0,1,1,0,0,0,5,3,8,48,37,85,96
20192020,004,BALLARD,015,Ballard County,"",---District Total---,015,"","",WKEC,908,07,32,27,0,1,1,0,0,0,0,0,0,1,0,1,0,0,0,2,1,3,24,30,54,59
20192020,004,BALLARD,015,Ballard County,"",---District Total---,015,"","",WKEC,908,08,38,47,3,1,4,0,1,1,1,0,1,0,0,0,0,0,0,3,2,5,40,34,74,85
20192020,004,BALLARD,015,Ballard County,"",---District Total---,015,"","",WKEC,908,12,28,41,1,1,2,0,0,0,0,0,0,1,1,2,0,0,0,0,0,0,39,26,65,69
20192020,004,BALLARD,015,Ballard County,"",---District Total---,015,"","",WKEC,908,09,33,32,3,0,3,0,0,0,0,0,0,0,0,0,0,0,0,3,1,4,26,32,58,65
20192020,004,BALLARD,015,Ballard County,"",---District Total---,015,"","",WKEC,908,11,38,48,0,2,2,0,0,0,1,0,1,0,1,1,0,0,0,4,1,5,43,34,77,86
20192020,004,BALLARD,015,Ballard County,005,Ballard County Middle School,015005,004015005,210021000035,WKEC,908,08,38,47,3,1,4,0,1,1,1,0,1,0,0,0,0,0,0,3,2,5,40,34,74,85
20192020,004,BALLARD,015,Ballard County,005,Ballard County Middle School,015005,004015005,210021000035,WKEC,908,All Students,113,127,3,4,7,0,1,1,1,0,1,1,1,2,0,0,0,10,6,16,112,101,213,240
20192020,004,BALLARD,015,Ballard County,005,Ballard County Middle School,015005,004015005,210021000035,WKEC,908,06,43,53,0,2,2,0,0,0,0,0,0,0,1,1,0,0,0,5,3,8,48,37,85,96
20192020,004,BALLARD,015,Ballard County,005,Ballard County Middle School,015005,004015005,210021000035,WKEC,908,07,32,27,0,1,1,0,0,0,0,0,0,1,0,1,0,0,0,2,1,3,24,30,54,59
20192020,004,BALLARD,015,Ballard County,010,Ballard Memorial High School,015010,004015010,210021000036,WKEC,908,09,33,32,3,0,3,0,0,0,0,0,0,0,0,0,0,0,0,3,1,4,26,32,58,65
20192020,004,BALLARD,015,Ballard County,010,Ballard Memorial High School,015010,004015010,210021000036,WKEC,908,10,40,43,5,1,6,1,1,2,0,1,1,0,0,0,0,0,0,0,0,0,37,37,74,83
20192020,004,BALLARD,015,Ballard County,010,Ballard Memorial High School,015010,004015010,210021000036,WKEC,908,11,38,48,0,2,2,0,0,0,1,0,1,0,1,1,0,0,0,4,1,5,43,34,77,86
20192020,004,BALLARD,015,Ballard County,010,Ballard Memorial High School,015010,004015010,210021000036,WKEC,908,12,28,41,1,1,2,0,0,0,0,0,0,1,1,2,0,0,0,0,0,0,39,26,65,69
20192020,004,BALLARD,015,Ballard County,010,Ballard Memorial High School,015010,004015010,210021000036,WKEC,908,All Students,139,164,9,4,13,1,1,2,1,1,2,1,2,3,0,0,0,7,2,9,145,129,274,303
20192020,004,BALLARD,015,Ballard County,050,Ballard County Elementary School,015050,004015050,210021000356,WKEC,908,03,37,43,0,1,1,0,0,0,0,0,0,1,2,3,0,0,0,2,3,5,40,31,71,80
20192020,004,BALLARD,015,Ballard County,050,Ballard County Elementary School,015050,004015050,210021000356,WKEC,908,05,47,38,1,0,1,0,0,0,0,0,0,2,1,3,0,0,0,3,4,7,32,42,74,85
20192020,004,BALLARD,015,Ballard County,050,Ballard County Elementary School,015050,004015050,210021000356,WKEC,908,04,41,50,0,1,1,0,0,0,0,0,0,0,0,0,0,0,0,2,1,3,48,39,87,91
20192020,004,BALLARD,015,Ballard County,050,Ballard County Elementary School,015050,004015050,210021000356,WKEC,908,All Students,233,260,4,5,9,0,1,1,0,1,1,4,4,8,0,0,0,12,14,26,240,208,448,493
20192020,004,BALLARD,015,Ballard County,050,Ballard County Elementary School,015050,004015050,210021000356,WKEC,908,KG,37,42,0,1,1,0,1,1,0,0,0,1,1,2,0,0,0,1,3,4,40,31,71,79
20192020,004,BALLARD,015,Ballard County,050,Ballard County Elementary School,015050,004015050,210021000356,WKEC,908,01,33,42,1,2,3,0,0,0,0,0,0,0,0,0,0,0,0,1,3,4,40,28,68,75
20192020,004,BALLARD,015,Ballard County,050,Ballard County Elementary School,015050,004015050,210021000356,WKEC,908,02,38,45,2,0,2,0,0,0,0,1,1,0,0,0,0,0,0,3,0,3,40,37,77,83
20192020,004,BALLARD,015,Ballard County,070,Ballard Co. Preschool/Headstart Center,015070,004015070,210021000040,WKEC,908,All Students,0,0,0,0,0,0,0,0,0,0,0,0,0,0,0,0,0,0,0,0,0,0,0,0
20192020,004,BALLARD,015,Ballard County,070,Ballard Co. Preschool/Headstart Center,015070,004015070,210021000040,WKEC,908,PS,59,66,1,1,2,0,0,0,0,0,0,1,3,4,0,0,0,4,3,7,60,52,112,125
20192020,004,BALLARD,015,Ballard County,905,Ballard County Career and Technology Ctr,015905,004015905,210021002404,WKEC,908,11,0,0,0,0,0,0,0,0,0,0,0,0,0,0,0,0,0,0,0,0,0,0,0,0
20192020,004,BALLARD,015,Ballard County,905,Ballard County Career and Technology Ctr,015905,004015905,210021002404,WKEC,908,All Students,0,0,0,0,0,0,0,0,0,0,0,0,0,0,0,0,0,0,0,0,0,0,0,0
20192020,004,BALLARD,015,Ballard County,905,Ballard County Career and Technology Ctr,015905,004015905,210021002404,WKEC,908,09,0,0,0,0,0,0,0,0,0,0,0,0,0,0,0,0,0,0,0,0,0,0,0,0
20192020,004,BALLARD,015,Ballard County,905,Ballard County Career and Technology Ctr,015905,004015905,210021002404,WKEC,908,10,0,0,0,0,0,0,0,0,0,0,0,0,0,0,0,0,0,0,0,0,0,0,0,0
20192020,004,BALLARD,015,Ballard County,905,Ballard County Career and Technology Ctr,015905,004015905,210021002404,WKEC,908,12,0,0,0,0,0,0,0,0,0,0,0,0,0,0,0,0,0,0,0,0,0,0,0,0
20192020,061,KNOX,016,Barbourville Independent,"",---District Total---,016,"","",SESC,907,11,32,20,0,0,0,0,0,0,0,1,1,0,1,1,0,0,0,0,1,1,20,29,49,52
20192020,061,KNOX,016,Barbourville Independent,"",---District Total---,016,"","",SESC,907,All Students,342,310,1,11,12,0,0,0,1,2,3,2,4,6,0,0,0,4,7,11,302,318,620,652
20192020,061,KNOX,016,Barbourville Independent,"",---District Total---,016,"","",SESC,907,PS,24,12,0,1,1,0,0,0,0,0,0,0,0,0,0,0,0,0,0,0,12,23,35,36
20192020,061,KNOX,016,Barbourville Independent,"",---District Total---,016,"","",SESC,907,KG,28,23,0,0,0,0,0,0,0,0,0,0,0,0,0,0,0,0,1,1,23,27,50,51
20192020,061,KNOX,016,Barbourville Independent,"",---District Total---,016,"","",SESC,907,01,23,26,0,3,3,0,0,0,0,0,0,1,1,2,0,0,0,0,1,1,25,18,43,49
20192020,061,KNOX,016,Barbourville Independent,"",---District Total---,016,"","",SESC,907,02,25,24,0,0,0,0,0,0,0,0,0,0,0,0,0,0,0,0,2,2,24,23,47,49
20192020,061,KNOX,016,Barbourville Independent,"",---District Total---,016,"","",SESC,907,03,17,21,1,0,1,0,0,0,0,0,0,0,0,0,0,0,0,1,0,1,19,17,36,38
20192020,061,KNOX,016,Barbourville Independent,"",---District Total---,016,"","",SESC,907,04,26,23,0,0,0,0,0,0,0,0,0,1,0,1,0,0,0,0,0,0,22,26,48,49
20192020,061,KNOX,016,Barbourville Independent,"",---District Total---,016,"","",SESC,907,05,31,24,0,3,3,0,0,0,0,0,0,0,2,2,0,0,0,1,0,1,23,26,49,55
20192020,061,KNOX,016,Barbourville Independent,"",---District Total---,016,"","",SESC,907,06,28,25,0,1,1,0,0,0,0,0,0,0,0,0,0,0,0,0,0,0,25,27,52,53
20192020,061,KNOX,016,Barbourville Independent,"",---District Total---,016,"","",SESC,907,07,39,23,0,1,1,0,0,0,1,0,1,0,0,0,0,0,0,1,1,2,21,37,58,62
20192020,061,KNOX,016,Barbourville Independent,"",---District Total---,016,"","",SESC,907,08,25,19,0,2,2,0,0,0,0,0,0,0,0,0,0,0,0,1,1,2,18,22,40,44
20192020,061,KNOX,016,Barbourville Independent,"",---District Total---,016,"","",SESC,907,09,15,25,0,1,1,0,0,0,0,0,0,0,0,0,0,0,0,0,0,0,25,14,39,40
20192020,061,KNOX,016,Barbourville Independent,"",---District Total---,016,"","",SESC,907,10,27,20,0,0,0,0,0,0,0,1,1,0,0,0,0,0,0,0,0,0,20,26,46,47
20192020,061,KNOX,016,Barbourville Independent,"",---District Total---,016,"","",SESC,907,12,26,37,0,0,0,0,0,0,0,0,0,0,0,0,0,0,0,0,0,0,37,26,63,63
20192020,061,KNOX,016,Barbourville Independent,011,Barbourville City School,016011,061016011,210024001969,SESC,907,08,25,19,0,2,2,0,0,0,0,0,0,0,0,0,0,0,0,1,1,2,18,22,40,44
20192020,061,KNOX,016,Barbourville Independent,011,Barbourville City School,016011,061016011,210024001969,SESC,907,All Students,342,310,1,11,12,0,0,0,1,2,3,2,4,6,0,0,0,4,7,11,302,318,620,652
20192020,061,KNOX,016,Barbourville Independent,011,Barbourville City School,016011,061016011,210024001969,SESC,907,PS,24,12,0,1,1,0,0,0,0,0,0,0,0,0,0,0,0,0,0,0,12,23,35,36
20192020,061,KNOX,016,Barbourville Independent,011,Barbourville City School,016011,061016011,210024001969,SESC,907,KG,28,23,0,0,0,0,0,0,0,0,0,0,0,0,0,0,0,0,1,1,23,27,50,51
20192020,061,KNOX,016,Barbourville Independent,011,Barbourville City School,016011,061016011,210024001969,SESC,907,01,23,26,0,3,3,0,0,0,0,0,0,1,1,2,0,0,0,0,1,1,25,18,43,49
20192020,061,KNOX,016,Barbourville Independent,011,Barbourville City School,016011,061016011,210024001969,SESC,907,02,25,24,0,0,0,0,0,0,0,0,0,0,0,0,0,0,0,0,2,2,24,23,47,49
20192020,061,KNOX,016,Barbourville Independent,011,Barbourville City School,016011,061016011,210024001969,SESC,907,03,17,21,1,0,1,0,0,0,0,0,0,0,0,0,0,0,0,1,0,1,19,17,36,38
20192020,061,KNOX,016,Barbourville Independent,011,Barbourville City School,016011,061016011,210024001969,SESC,907,04,26,23,0,0,0,0,0,0,0,0,0,1,0,1,0,0,0,0,0,0,22,26,48,49
20192020,061,KNOX,016,Barbourville Independent,011,Barbourville City School,016011,061016011,210024001969,SESC,907,05,31,24,0,3,3,0,0,0,0,0,0,0,2,2,0,0,0,1,0,1,23,26,49,55
20192020,061,KNOX,016,Barbourville Independent,011,Barbourville City School,016011,061016011,210024001969,SESC,907,06,28,25,0,1,1,0,0,0,0,0,0,0,0,0,0,0,0,0,0,0,25,27,52,53
20192020,061,KNOX,016,Barbourville Independent,011,Barbourville City School,016011,061016011,210024001969,SESC,907,07,39,23,0,1,1,0,0,0,1,0,1,0,0,0,0,0,0,1,1,2,21,37,58,62
20192020,061,KNOX,016,Barbourville Independent,011,Barbourville City School,016011,061016011,210024001969,SESC,907,09,15,25,0,1,1,0,0,0,0,0,0,0,0,0,0,0,0,0,0,0,25,14,39,40
20192020,061,KNOX,016,Barbourville Independent,011,Barbourville City School,016011,061016011,210024001969,SESC,907,10,27,20,0,0,0,0,0,0,0,1,1,0,0,0,0,0,0,0,0,0,20,26,46,47
20192020,061,KNOX,016,Barbourville Independent,011,Barbourville City School,016011,061016011,210024001969,SESC,907,11,32,20,0,0,0,0,0,0,0,1,1,0,1,1,0,0,0,0,1,1,20,29,49,52
20192020,061,KNOX,016,Barbourville Independent,011,Barbourville City School,016011,061016011,210024001969,SESC,907,12,26,37,0,0,0,0,0,0,0,0,0,0,0,0,0,0,0,0,0,0,37,26,63,63
20192020,090,NELSON,017,Bardstown Independent,"",---District Total---,017,"","",CKEC,901,14,2,1,0,0,0,0,0,0,0,0,0,0,0,0,0,0,0,0,0,0,1,2,3,3
20192020,090,NELSON,017,Bardstown Independent,"",---District Total---,017,"","",CKEC,901,All Students,1204,1229,153,157,310,2,1,3,21,17,38,91,90,181,0,0,0,131,138,269,831,801,1632,2433
20192020,090,NELSON,017,Bardstown Independent,"",---District Total---,017,"","",CKEC,901,PS,135,161,13,22,35,0,0,0,2,0,2,11,7,18,0,0,0,14,18,32,121,88,209,296
20192020,090,NELSON,017,Bardstown Independent,"",---District Total---,017,"","",CKEC,901,KG,114,97,9,10,19,0,0,0,2,1,3,5,7,12,0,0,0,12,16,28,69,80,149,211
20192020,090,NELSON,017,Bardstown Independent,"",---District Total---,017,"","",CKEC,901,01,114,109,16,17,33,0,0,0,1,0,1,11,6,17,0,0,0,16,17,33,65,74,139,223
20192020,090,NELSON,017,Bardstown Independent,"",---District Total---,017,"","",CKEC,901,02,89,92,4,6,10,0,0,0,1,0,1,6,7,13,0,0,0,11,17,28,70,59,129,181
20192020,090,NELSON,017,Bardstown Independent,"",---District Total---,017,"","",CKEC,901,03,105,89,11,16,27,0,0,0,1,1,2,14,6,20,0,0,0,9,10,19,54,72,126,194
20192020,090,NELSON,017,Bardstown Independent,"",---District Total---,017,"","",CKEC,901,04,94,98,14,8,22,0,1,1,2,2,4,6,7,13,0,0,0,8,11,19,68,65,133,192
20192020,090,NELSON,017,Bardstown Independent,"",---District Total---,017,"","",CKEC,901,05,86,101,6,12,18,0,0,0,2,0,2,12,1,13,0,0,0,14,8,22,67,65,132,187
20192020,090,NELSON,017,Bardstown Independent,"",---District Total---,017,"","",CKEC,901,06,96,110,12,11,23,0,0,0,3,3,6,5,6,11,0,0,0,14,12,26,76,64,140,206
20192020,090,NELSON,017,Bardstown Independent,"",---District Total---,017,"","",CKEC,901,07,104,93,10,15,25,1,0,1,4,3,7,7,12,19,0,0,0,6,12,18,65,62,127,197
20192020,090,NELSON,017,Bardstown Independent,"",---District Total---,017,"","",CKEC,901,08,99,100,12,9,21,0,0,0,2,3,5,3,11,14,0,0,0,10,8,18,73,68,141,199
20192020,090,NELSON,017,Bardstown Independent,"",---District Total---,017,"","",CKEC,901,09,78,88,14,11,25,0,0,0,1,0,1,8,7,15,0,0,0,5,10,15,60,50,110,166
20192020,090,NELSON,017,Bardstown Independent,"",---District Total---,017,"","",CKEC,901,10,92,95,15,19,34,1,0,1,1,2,3,7,8,15,0,0,0,9,4,13,62,59,121,187
20192020,090,NELSON,017,Bardstown Independent,"",---District Total---,017,"","",CKEC,901,11,75,69,8,14,22,0,0,0,1,1,2,4,7,11,0,0,0,11,8,19,45,45,90,144
20192020,090,NELSON,017,Bardstown Independent,"",---District Total---,017,"","",CKEC,901,12,56,87,22,9,31,0,0,0,0,1,1,3,5,8,0,0,0,6,5,11,56,36,92,143
20192020,090,NELSON,017,Bardstown Independent,005,Bardstown Alternative School,017005,090017005,210027002359,CKEC,901,11,4,3,0,0,0,0,0,0,1,0,1,0,0,0,0,0,0,0,0,0,2,4,6,7
20192020,090,NELSON,017,Bardstown Independent,005,Bardstown Alternative School,017005,090017005,210027002359,CKEC,901,All Students,16,29,4,2,6,0,0,0,1,0,1,1,0,1,0,0,0,5,1,6,18,13,31,45
20192020,090,NELSON,017,Bardstown Independent,005,Bardstown Alternative School,017005,090017005,210027002359,CKEC,901,08,0,1,0,0,0,0,0,0,0,0,0,0,0,0,0,0,0,1,0,1,0,0,0,1
20192020,090,NELSON,017,Bardstown Independent,005,Bardstown Alternative School,017005,090017005,210027002359,CKEC,901,09,2,8,0,0,0,0,0,0,0,0,0,1,0,1,0,0,0,0,0,0,7,2,9,10
20192020,090,NELSON,017,Bardstown Independent,005,Bardstown Alternative School,017005,090017005,210027002359,CKEC,901,10,2,8,2,1,3,0,0,0,0,0,0,0,0,0,0,0,0,2,0,2,4,1,5,10
20192020,090,NELSON,017,Bardstown Independent,005,Bardstown Alternative School,017005,090017005,210027002359,CKEC,901,12,8,9,2,1,3,0,0,0,0,0,0,0,0,0,0,0,0,2,1,3,5,6,11,17
20192020,090,NELSON,017,Bardstown Independent,009,Bardstown Early Childhood Center,017009,090017009,210027002222,CKEC,901,All Students,0,0,0,0,0,0,0,0,0,0,0,0,0,0,0,0,0,0,0,0,0,0,0,0
20192020,090,NELSON,017,Bardstown Independent,009,Bardstown Early Childhood Center,017009,090017009,210027002222,CKEC,901,PS,135,161,13,22,35,0,0,0,2,0,2,11,7,18,0,0,0,14,18,32,121,88,209,296
20192020,090,NELSON,017,Bardstown Independent,010,Bardstown Elementary School,017010,090017010,210027000044,CKEC,901,05,86,101,6,12,18,0,0,0,2,0,2,12,1,13,0,0,0,14,8,22,67,65,132,187
20192020,090,NELSON,017,Bardstown Independent,010,Bardstown Elementary School,017010,090017010,210027000044,CKEC,901,All Students,285,288,31,36,67,0,1,1,5,3,8,32,14,46,0,0,0,31,29,60,189,202,391,573
20192020,090,NELSON,017,Bardstown Independent,010,Bardstown Elementary School,017010,090017010,210027000044,CKEC,901,03,105,89,11,16,27,0,0,0,1,1,2,14,6,20,0,0,0,9,10,19,54,72,126,194
20192020,090,NELSON,017,Bardstown Independent,010,Bardstown Elementary School,017010,090017010,210027000044,CKEC,901,04,94,98,14,8,22,0,1,1,2,2,4,6,7,13,0,0,0,8,11,19,68,65,133,192
20192020,090,NELSON,017,Bardstown Independent,012,Bardstown Primary School,017012,090017012,210027002050,CKEC,901,KG,114,97,9,10,19,0,0,0,2,1,3,5,7,12,0,0,0,12,16,28,69,80,149,211
20192020,090,NELSON,017,Bardstown Independent,012,Bardstown Primary School,017012,090017012,210027002050,CKEC,901,All Students,317,298,29,33,62,0,0,0,4,1,5,22,20,42,0,0,0,39,50,89,204,213,417,615
20192020,090,NELSON,017,Bardstown Independent,012,Bardstown Primary School,017012,090017012,210027002050,CKEC,901,01,114,109,16,17,33,0,0,0,1,0,1,11,6,17,0,0,0,16,17,33,65,74,139,223
20192020,090,NELSON,017,Bardstown Independent,012,Bardstown Primary School,017012,090017012,210027002050,CKEC,901,02,89,92,4,6,10,0,0,0,1,0,1,6,7,13,0,0,0,11,17,28,70,59,129,181
20192020,090,NELSON,017,Bardstown Independent,020,Bardstown High School,017020,090017020,210027000045,CKEC,901,11,71,66,8,14,22,0,0,0,0,1,1,4,7,11,0,0,0,11,8,19,43,41,84,137
20192020,090,NELSON,017,Bardstown Independent,020,Bardstown High School,017020,090017020,210027000045,CKEC,901,12,48,78,20,8,28,0,0,0,0,1,1,3,5,8,0,0,0,4,4,8,51,30,81,126
20192020,090,NELSON,017,Bardstown Independent,020,Bardstown High School,017020,090017020,210027000045,CKEC,901,All Students,287,312,55,51,106,1,0,1,2,4,6,21,27,48,0,0,0,27,26,53,206,179,385,599
20192020,090,NELSON,017,Bardstown Independent,020,Bardstown High School,017020,090017020,210027000045,CKEC,901,09,76,80,14,11,25,0,0,0,1,0,1,7,7,14,0,0,0,5,10,15,53,48,101,156
20192020,090,NELSON,017,Bardstown Independent,020,Bardstown High School,017020,090017020,210027000045,CKEC,901,14,2,1,0,0,0,0,0,0,0,0,0,0,0,0,0,0,0,0,0,0,1,2,3,3
20192020,090,NELSON,017,Bardstown Independent,020,Bardstown High School,017020,090017020,210027000045,CKEC,901,10,90,87,13,18,31,1,0,1,1,2,3,7,8,15,0,0,0,7,4,11,58,58,116,177
20192020,090,NELSON,017,Bardstown Independent,030,Bardstown Middle School,017030,090017030,210027000046,CKEC,901,All Students,299,302,34,35,69,1,0,1,9,9,18,15,29,44,0,0,0,29,32,61,214,194,408,601
20192020,090,NELSON,017,Bardstown Independent,030,Bardstown Middle School,017030,090017030,210027000046,CKEC,901,08,99,99,12,9,21,0,0,0,2,3,5,3,11,14,0,0,0,9,8,17,73,68,141,198
20192020,090,NELSON,017,Bardstown Independent,030,Bardstown Middle School,017030,090017030,210027000046,CKEC,901,06,96,110,12,11,23,0,0,0,3,3,6,5,6,11,0,0,0,14,12,26,76,64,140,206
20192020,090,NELSON,017,Bardstown Independent,030,Bardstown Middle School,017030,090017030,210027000046,CKEC,901,07,104,93,10,15,25,1,0,1,4,3,7,7,12,19,0,0,0,6,12,18,65,62,127,197
20192020,005,BARREN,021,Barren County,"",---District Total---,021,"","",GRREC,902,06,214,193,3,1,4,0,0,0,0,2,2,8,15,23,0,0,0,5,5,10,177,191,368,407
20192020,005,BARREN,021,Barren County,"",---District Total---,021,"","",GRREC,902,All Students,2485,2428,31,30,61,1,2,3,10,13,23,109,107,216,3,1,4,65,92,157,2209,2240,4449,4913
20192020,005,BARREN,021,Barren County,"",---District Total---,021,"","",GRREC,902,PS,188,220,4,3,7,0,0,0,2,0,2,10,11,21,0,0,0,5,13,18,199,161,360,408
20192020,005,BARREN,021,Barren County,"",---District Total---,021,"","",GRREC,902,KG,187,202,1,3,4,0,0,0,0,1,1,7,9,16,0,0,0,8,6,14,186,168,354,389
20192020,005,BARREN,021,Barren County,"",---District Total---,021,"","",GRREC,902,01,196,188,0,2,2,0,0,0,0,0,0,7,11,18,0,0,0,11,8,19,170,175,345,384
20192020,005,BARREN,021,Barren County,"",---District Total---,021,"","",GRREC,902,02,164,168,0,1,1,0,0,0,1,2,3,11,6,17,0,0,0,6,6,12,150,149,299,332
20192020,005,BARREN,021,Barren County,"",---District Total---,021,"","",GRREC,902,03,172,192,3,2,5,0,0,0,2,0,2,15,8,23,0,0,0,7,11,18,165,151,316,364
20192020,005,BARREN,021,Barren County,"",---District Total---,021,"","",GRREC,902,04,161,164,4,2,6,0,0,0,1,1,2,7,9,16,0,0,0,5,11,16,147,138,285,325
20192020,005,BARREN,021,Barren County,"",---District Total---,021,"","",GRREC,902,05,174,181,0,4,4,0,0,0,0,0,0,8,8,16,1,0,1,7,8,15,165,154,319,355
20192020,005,BARREN,021,Barren County,"",---District Total---,021,"","",GRREC,902,07,197,199,3,2,5,0,0,0,1,0,1,10,11,21,0,0,0,6,5,11,179,179,358,396
20192020,005,BARREN,021,Barren County,"",---District Total---,021,"","",GRREC,902,08,217,216,0,3,3,0,1,1,1,0,1,10,9,19,0,0,0,0,5,5,205,199,404,433
20192020,005,BARREN,021,Barren County,"",---District Total---,021,"","",GRREC,902,09,224,216,4,3,7,0,0,0,3,3,6,8,7,15,1,0,1,2,9,11,198,202,400,440
20192020,005,BARREN,021,Barren County,"",---District Total---,021,"","",GRREC,902,10,219,193,4,2,6,0,0,0,0,3,3,7,5,12,0,0,0,2,8,10,180,201,381,412
20192020,005,BARREN,021,Barren County,"",---District Total---,021,"","",GRREC,902,11,190,157,6,2,8,1,1,2,1,1,2,6,4,10,1,0,1,4,6,10,138,176,314,347
20192020,005,BARREN,021,Barren County,"",---District Total---,021,"","",GRREC,902,12,170,159,3,3,6,0,0,0,0,0,0,5,5,10,0,1,1,2,4,6,149,157,306,329
20192020,005,BARREN,021,Barren County,010,Austin Tracy Elementary School,021010,005021010,210030000047,GRREC,902,05,13,23,0,1,1,0,0,0,0,0,0,1,0,1,0,0,0,2,2,4,20,10,30,36
20192020,005,BARREN,021,Barren County,010,Austin Tracy Elementary School,021010,005021010,210030000047,GRREC,902,06,22,16,0,0,0,0,0,0,0,0,0,1,2,3,0,0,0,0,0,0,15,20,35,38
20192020,005,BARREN,021,Barren County,010,Austin Tracy Elementary School,021010,005021010,210030000047,GRREC,902,All Students,117,126,0,1,1,0,0,0,0,0,0,3,5,8,0,0,0,3,8,11,120,103,223,243
20192020,005,BARREN,021,Barren County,010,Austin Tracy Elementary School,021010,005021010,210030000047,GRREC,902,PS,25,22,0,0,0,0,0,0,0,0,0,0,1,1,0,0,0,0,1,1,22,23,45,47
20192020,005,BARREN,021,Barren County,010,Austin Tracy Elementary School,021010,005021010,210030000047,GRREC,902,KG,19,20,0,0,0,0,0,0,0,0,0,0,1,1,0,0,0,0,0,0,20,18,38,39
20192020,005,BARREN,021,Barren County,010,Austin Tracy Elementary School,021010,005021010,210030000047,GRREC,902,01,18,24,0,0,0,0,0,0,0,0,0,1,0,1,0,0,0,1,0,1,22,18,40,42
20192020,005,BARREN,021,Barren County,010,Austin Tracy Elementary School,021010,005021010,210030000047,GRREC,902,02,18,16,0,0,0,0,0,0,0,0,0,0,0,0,0,0,0,0,3,3,16,15,31,34
20192020,005,BARREN,021,Barren County,010,Austin Tracy Elementary School,021010,005021010,210030000047,GRREC,902,03,12,16,0,0,0,0,0,0,0,0,0,0,1,1,0,0,0,0,1,1,16,10,26,28
20192020,005,BARREN,021,Barren County,010,Austin Tracy Elementary School,021010,005021010,210030000047,GRREC,902,04,15,11,0,0,0,0,0,0,0,0,0,0,1,1,0,0,0,0,2,2,11,12,23,26
20192020,005,BARREN,021,Barren County,011,College Street Campus,021011,005021011,210030001303,GRREC,902,10,5,12,0,0,0,0,0,0,0,0,0,0,0,0,0,0,0,0,0,0,12,5,17,17
20192020,005,BARREN,021,Barren County,011,College Street Campus,021011,005021011,210030001303,GRREC,902,12,3,2,0,0,0,0,0,0,0,0,0,0,0,0,0,0,0,0,0,0,2,3,5,5
20192020,005,BARREN,021,Barren County,011,College Street Campus,021011,005021011,210030001303,GRREC,902,All Students,26,23,0,1,1,0,0,0,1,0,1,0,0,0,0,0,0,0,1,1,22,24,46,49
20192020,005,BARREN,021,Barren County,011,College Street Campus,021011,005021011,210030001303,GRREC,902,07,2,2,0,0,0,0,0,0,0,0,0,0,0,0,0,0,0,0,0,0,2,2,4,4
20192020,005,BARREN,021,Barren County,011,College Street Campus,021011,005021011,210030001303,GRREC,902,08,8,2,0,0,0,0,0,0,0,0,0,0,0,0,0,0,0,0,0,0,2,8,10,10
20192020,005,BARREN,021,Barren County,011,College Street Campus,021011,005021011,210030001303,GRREC,902,09,4,4,0,0,0,0,0,0,1,0,1,0,0,0,0,0,0,0,0,0,3,4,7,8
20192020,005,BARREN,021,Barren County,011,College Street Campus,021011,005021011,210030001303,GRREC,902,11,4,1,0,1,1,0,0,0,0,0,0,0,0,0,0,0,0,0,1,1,1,2,3,5
20192020,005,BARREN,021,Barren County,012,BAVEL,021012,005021012,210030001970,GRREC,902,10,35,14,0,0,0,0,0,0,0,1,1,0,1,1,0,0,0,1,2,3,13,31,44,49
20192020,005,BARREN,021,Barren County,012,BAVEL,021012,005021012,210030001970,GRREC,902,12,32,16,1,2,3,0,0,0,0,0,0,0,2,2,0,0,0,0,1,1,15,27,42,48
20192020,005,BARREN,021,Barren County,012,BAVEL,021012,005021012,210030001970,GRREC,902,All Students,173,80,1,5,6,0,0,0,0,5,5,3,8,11,0,0,0,1,8,9,75,147,222,253
20192020,005,BARREN,021,Barren County,012,BAVEL,021012,005021012,210030001970,GRREC,902,06,11,5,0,0,0,0,0,0,0,2,2,0,1,1,0,0,0,0,0,0,5,8,13,16
20192020,005,BARREN,021,Barren County,012,BAVEL,021012,005021012,210030001970,GRREC,902,07,15,8,0,0,0,0,0,0,0,0,0,1,2,3,0,0,0,0,0,0,7,13,20,23
20192020,005,BARREN,021,Barren County,012,BAVEL,021012,005021012,210030001970,GRREC,902,08,24,10,0,1,1,0,0,0,0,0,0,1,2,3,0,0,0,0,1,1,9,20,29,34
20192020,005,BARREN,021,Barren County,012,BAVEL,021012,005021012,210030001970,GRREC,902,09,29,14,0,2,2,0,0,0,0,1,1,1,0,1,0,0,0,0,2,2,13,24,37,43
20192020,005,BARREN,021,Barren County,012,BAVEL,021012,005021012,210030001970,GRREC,902,11,27,13,0,0,0,0,0,0,0,1,1,0,0,0,0,0,0,0,2,2,13,24,37,40
20192020,005,BARREN,021,Barren County,014,North Jackson Elementary,021014,005021014,210030002232,GRREC,902,04,37,28,1,1,2,0,0,0,0,0,0,1,0,1,0,0,0,1,1,2,25,35,60,65
20192020,005,BARREN,021,Barren County,014,North Jackson Elementary,021014,005021014,210030002232,GRREC,902,06,44,38,0,0,0,0,0,0,0,0,0,1,1,2,0,0,0,2,1,3,35,42,77,82
20192020,005,BARREN,021,Barren County,014,North Jackson Elementary,021014,005021014,210030002232,GRREC,902,All Students,262,243,1,4,5,0,0,0,2,1,3,8,7,15,0,0,0,4,10,14,228,240,468,505
20192020,005,BARREN,021,Barren County,014,North Jackson Elementary,021014,005021014,210030002232,GRREC,902,PS,27,33,0,0,0,0,0,0,0,0,0,0,3,3,0,0,0,0,1,1,33,23,56,60
20192020,005,BARREN,021,Barren County,014,North Jackson Elementary,021014,005021014,210030002232,GRREC,902,KG,39,32,0,1,1,0,0,0,0,1,1,0,1,1,0,0,0,0,2,2,32,34,66,71
20192020,005,BARREN,021,Barren County,014,North Jackson Elementary,021014,005021014,210030002232,GRREC,902,01,34,35,0,0,0,0,0,0,0,0,0,0,0,0,0,0,0,0,0,0,35,34,69,69
20192020,005,BARREN,021,Barren County,014,North Jackson Elementary,021014,005021014,210030002232,GRREC,902,02,33,43,0,0,0,0,0,0,1,0,1,3,1,4,0,0,0,1,0,1,38,32,70,76
20192020,005,BARREN,021,Barren County,014,North Jackson Elementary,021014,005021014,210030002232,GRREC,902,03,38,37,0,0,0,0,0,0,1,0,1,2,3,5,0,0,0,0,5,5,34,30,64,75
20192020,005,BARREN,021,Barren County,014,North Jackson Elementary,021014,005021014,210030002232,GRREC,902,05,37,30,0,2,2,0,0,0,0,0,0,1,1,2,0,0,0,0,1,1,29,33,62,67
20192020,005,BARREN,021,Barren County,027,Barren County High School,021027,005021027,210030000048,GRREC,902,11,159,143,6,1,7,1,1,2,1,0,1,6,4,10,1,0,1,4,3,7,124,150,274,302
20192020,005,BARREN,021,Barren County,027,Barren County High School,021027,005021027,210030000048,GRREC,902,All Students,664,649,16,5,21,1,1,2,3,4,7,25,18,43,2,1,3,9,19,28,593,616,1209,1313
20192020,005,BARREN,021,Barren County,027,Barren County High School,021027,005021027,210030000048,GRREC,902,09,191,198,4,1,5,0,0,0,2,2,4,7,7,14,1,0,1,2,7,9,182,174,356,389
20192020,005,BARREN,021,Barren County,027,Barren County High School,021027,005021027,210030000048,GRREC,902,10,179,167,4,2,6,0,0,0,0,2,2,7,4,11,0,0,0,1,6,7,155,165,320,346
20192020,005,BARREN,021,Barren County,027,Barren County High School,021027,005021027,210030000048,GRREC,902,12,135,141,2,1,3,0,0,0,0,0,0,5,3,8,0,1,1,2,3,5,132,127,259,276
20192020,005,BARREN,021,Barren County,035,Eastern Elementary School,021035,005021035,210030000049,GRREC,902,05,20,23,0,0,0,0,0,0,0,0,0,2,0,2,1,0,1,0,0,0,20,20,40,43
20192020,005,BARREN,021,Barren County,035,Eastern Elementary School,021035,005021035,210030000049,GRREC,902,06,28,19,0,0,0,0,0,0,0,0,0,1,0,1,0,0,0,1,0,1,17,28,45,47
20192020,005,BARREN,021,Barren County,035,Eastern Elementary School,021035,005021035,210030000049,GRREC,902,All Students,167,164,2,2,4,0,0,0,1,0,1,8,4,12,1,0,1,1,1,2,151,160,311,331
20192020,005,BARREN,021,Barren County,035,Eastern Elementary School,021035,005021035,210030000049,GRREC,902,PS,27,22,0,0,0,0,0,0,0,0,0,0,1,1,0,0,0,0,0,0,22,26,48,49
20192020,005,BARREN,021,Barren County,035,Eastern Elementary School,021035,005021035,210030000049,GRREC,902,KG,21,22,0,1,1,0,0,0,0,0,0,0,2,2,0,0,0,0,0,0,22,18,40,43
20192020,005,BARREN,021,Barren County,035,Eastern Elementary School,021035,005021035,210030000049,GRREC,902,01,33,21,0,0,0,0,0,0,0,0,0,1,0,1,0,0,0,0,0,0,20,33,53,54
20192020,005,BARREN,021,Barren County,035,Eastern Elementary School,021035,005021035,210030000049,GRREC,902,02,21,18,0,0,0,0,0,0,0,0,0,2,2,4,0,0,0,0,1,1,16,18,34,39
20192020,005,BARREN,021,Barren County,035,Eastern Elementary School,021035,005021035,210030000049,GRREC,902,03,23,38,2,0,2,0,0,0,0,0,0,1,0,1,0,0,0,0,0,0,35,23,58,61
20192020,005,BARREN,021,Barren County,035,Eastern Elementary School,021035,005021035,210030000049,GRREC,902,04,21,23,0,1,1,0,0,0,1,0,1,1,0,1,0,0,0,0,0,0,21,20,41,44
20192020,005,BARREN,021,Barren County,050,Barren County Middle School,021050,005021050,210030000607,GRREC,902,All Students,365,393,3,4,7,0,1,1,2,0,2,18,16,34,0,0,0,6,9,15,364,335,699,758
20192020,005,BARREN,021,Barren County,050,Barren County Middle School,021050,005021050,210030000607,GRREC,902,08,185,204,0,2,2,0,1,1,1,0,1,9,7,16,0,0,0,0,4,4,194,171,365,389
20192020,005,BARREN,021,Barren County,050,Barren County Middle School,021050,005021050,210030000607,GRREC,902,07,180,189,3,2,5,0,0,0,1,0,1,9,9,18,0,0,0,6,5,11,170,164,334,369
20192020,005,BARREN,021,Barren County,080,Hiseville Elementary School,021080,005021080,210030000050,GRREC,902,04,21,16,1,0,1,0,0,0,0,0,0,0,1,1,0,0,0,0,2,2,15,18,33,37
20192020,005,BARREN,021,Barren County,080,Hiseville Elementary School,021080,005021080,210030000050,GRREC,902,06,17,16,0,0,0,0,0,0,0,0,0,0,0,0,0,0,0,2,1,3,14,16,30,33
20192020,005,BARREN,021,Barren County,080,Hiseville Elementary School,021080,005021080,210030000050,GRREC,902,All Students,123,118,1,1,2,0,0,0,0,0,0,4,4,8,0,0,0,4,5,9,109,113,222,241
20192020,005,BARREN,021,Barren County,080,Hiseville Elementary School,021080,005021080,210030000050,GRREC,902,PS,19,21,0,1,1,0,0,0,0,0,0,2,0,2,0,0,0,0,0,0,19,18,37,40
20192020,005,BARREN,021,Barren County,080,Hiseville Elementary School,021080,005021080,210030000050,GRREC,902,KG,20,22,0,0,0,0,0,0,0,0,0,0,1,1,0,0,0,1,0,1,21,19,40,42
20192020,005,BARREN,021,Barren County,080,Hiseville Elementary School,021080,005021080,210030000050,GRREC,902,01,21,17,0,0,0,0,0,0,0,0,0,1,2,3,0,0,0,1,1,2,15,18,33,38
20192020,005,BARREN,021,Barren County,080,Hiseville Elementary School,021080,005021080,210030000050,GRREC,902,02,17,16,0,0,0,0,0,0,0,0,0,1,0,1,0,0,0,0,0,0,15,17,32,33
20192020,005,BARREN,021,Barren County,080,Hiseville Elementary School,021080,005021080,210030000050,GRREC,902,03,13,13,0,1,1,0,0,0,0,0,0,2,0,2,0,0,0,0,1,1,11,11,22,26
20192020,005,BARREN,021,Barren County,080,Hiseville Elementary School,021080,005021080,210030000050,GRREC,902,05,14,18,0,0,0,0,0,0,0,0,0,0,0,0,0,0,0,0,0,0,18,14,32,32
20192020,005,BARREN,021,Barren County,130,Park City Elementary School,021130,005021130,210030000051,GRREC,902,04,18,30,1,0,1,0,0,0,0,0,0,1,0,1,0,0,0,2,2,4,26,16,42,48
20192020,005,BARREN,021,Barren County,130,Park City Elementary School,021130,005021130,210030000051,GRREC,902,06,38,30,2,0,2,0,0,0,0,0,0,2,4,6,0,0,0,0,0,0,26,34,60,68
20192020,005,BARREN,021,Barren County,130,Park City Elementary School,021130,005021130,210030000051,GRREC,902,All Students,178,192,3,5,8,0,0,0,1,0,1,13,12,25,0,0,0,16,11,27,159,150,309,370
20192020,005,BARREN,021,Barren County,130,Park City Elementary School,021130,005021130,210030000051,GRREC,902,PS,26,31,0,1,1,0,0,0,0,0,0,1,2,3,0,0,0,1,4,5,29,19,48,57
20192020,005,BARREN,021,Barren County,130,Park City Elementary School,021130,005021130,210030000051,GRREC,902,KG,24,28,0,1,1,0,0,0,0,0,0,2,1,3,0,0,0,4,3,7,22,19,41,52
20192020,005,BARREN,021,Barren County,130,Park City Elementary School,021130,005021130,210030000051,GRREC,902,01,22,27,0,1,1,0,0,0,0,0,0,2,1,3,0,0,0,5,2,7,20,18,38,49
20192020,005,BARREN,021,Barren County,130,Park City Elementary School,021130,005021130,210030000051,GRREC,902,02,24,16,0,1,1,0,0,0,0,0,0,1,1,2,0,0,0,1,0,1,14,22,36,40
20192020,005,BARREN,021,Barren County,130,Park City Elementary School,021130,005021130,210030000051,GRREC,902,03,30,26,0,1,1,0,0,0,1,0,1,2,1,3,0,0,0,0,3,3,23,25,48,56
20192020,005,BARREN,021,Barren County,130,Park City Elementary School,021130,005021130,210030000051,GRREC,902,05,22,35,0,1,1,0,0,0,0,0,0,3,4,7,0,0,0,4,1,5,28,16,44,57
20192020,005,BARREN,021,Barren County,150,Red Cross Elementary School,021150,005021150,210030000052,GRREC,902,03,38,44,1,0,1,0,0,0,0,0,0,4,1,5,0,0,0,6,1,7,33,36,69,82
20192020,005,BARREN,021,Barren County,150,Red Cross Elementary School,021150,005021150,210030000052,GRREC,902,04,35,35,1,0,1,0,0,0,0,1,1,1,4,5,0,0,0,2,3,5,31,27,58,70
20192020,005,BARREN,021,Barren County,150,Red Cross Elementary School,021150,005021150,210030000052,GRREC,902,All Students,282,297,3,2,5,0,0,0,0,3,3,13,21,34,0,0,0,19,16,35,262,240,502,579
20192020,005,BARREN,021,Barren County,150,Red Cross Elementary School,021150,005021150,210030000052,GRREC,902,PS,48,63,3,1,4,0,0,0,2,0,2,2,3,5,0,0,0,4,6,10,52,38,90,111
20192020,005,BARREN,021,Barren County,150,Red Cross Elementary School,021150,005021150,210030000052,GRREC,902,KG,42,54,1,0,1,0,0,0,0,0,0,3,1,4,0,0,0,2,1,3,48,40,88,96
20192020,005,BARREN,021,Barren County,150,Red Cross Elementary School,021150,005021150,210030000052,GRREC,902,06,37,50,0,1,1,0,0,0,0,0,0,2,5,7,0,0,0,0,2,2,48,29,77,87
20192020,005,BARREN,021,Barren County,150,Red Cross Elementary School,021150,005021150,210030000052,GRREC,902,01,49,40,0,1,1,0,0,0,0,0,0,1,6,7,0,0,0,4,5,9,35,37,72,89
20192020,005,BARREN,021,Barren County,150,Red Cross Elementary School,021150,005021150,210030000052,GRREC,902,02,31,43,0,0,0,0,0,0,0,2,2,2,1,3,0,0,0,4,1,5,37,27,64,74
20192020,005,BARREN,021,Barren County,150,Red Cross Elementary School,021150,005021150,210030000052,GRREC,902,05,50,31,0,0,0,0,0,0,0,0,0,0,3,3,0,0,0,1,3,4,30,44,74,81
20192020,005,BARREN,021,Barren County,180,Temple Hill Elementary School,021180,005021180,210030000053,GRREC,902,06,17,19,1,0,1,0,0,0,0,0,0,1,2,3,0,0,0,0,1,1,17,14,31,36
20192020,005,BARREN,021,Barren County,180,Temple Hill Elementary School,021180,005021180,210030000053,GRREC,902,All Students,128,143,1,0,1,0,0,0,0,0,0,14,12,26,0,0,0,2,4,6,126,112,238,271
20192020,005,BARREN,021,Barren County,180,Temple Hill Elementary School,021180,005021180,210030000053,GRREC,902,PS,16,28,1,0,1,0,0,0,0,0,0,5,1,6,0,0,0,0,1,1,22,14,36,44
20192020,005,BARREN,021,Barren County,180,Temple Hill Elementary School,021180,005021180,210030000053,GRREC,902,KG,22,24,0,0,0,0,0,0,0,0,0,2,2,4,0,0,0,1,0,1,21,20,41,46
20192020,005,BARREN,021,Barren County,180,Temple Hill Elementary School,021180,005021180,210030000053,GRREC,902,01,19,24,0,0,0,0,0,0,0,0,0,1,2,3,0,0,0,0,0,0,23,17,40,43
20192020,005,BARREN,021,Barren County,180,Temple Hill Elementary School,021180,005021180,210030000053,GRREC,902,02,20,16,0,0,0,0,0,0,0,0,0,2,1,3,0,0,0,0,1,1,14,18,32,36
20192020,005,BARREN,021,Barren County,180,Temple Hill Elementary School,021180,005021180,210030000053,GRREC,902,03,18,18,0,0,0,0,0,0,0,0,0,4,2,6,0,0,0,1,0,1,13,16,29,36
20192020,005,BARREN,021,Barren County,180,Temple Hill Elementary School,021180,005021180,210030000053,GRREC,902,04,14,21,0,0,0,0,0,0,0,0,0,3,3,6,0,0,0,0,1,1,18,10,28,35
20192020,005,BARREN,021,Barren County,180,Temple Hill Elementary School,021180,005021180,210030000053,GRREC,902,05,18,21,0,0,0,0,0,0,0,0,0,1,0,1,0,0,0,0,1,1,20,17,37,39
20192020,006,BATH,025,Bath County,"",---District Total---,025,"","",KEDC,903,14,1,0,0,0,0,0,0,0,0,0,0,0,0,0,0,0,0,0,0,0,0,1,1,1
20192020,006,BATH,025,Bath County,"",---District Total---,025,"","",KEDC,903,03,59,73,0,0,0,0,0,0,0,0,0,2,0,2,0,0,0,0,2,2,71,57,128,132
20192020,006,BATH,025,Bath County,"",---District Total---,025,"","",KEDC,903,All Students,916,1039,6,4,10,0,0,0,1,2,3,29,26,55,0,1,1,11,30,41,992,853,1845,1955
20192020,006,BATH,025,Bath County,"",---District Total---,025,"","",KEDC,903,PS,25,43,0,0,0,0,0,0,0,0,0,1,0,1,0,0,0,2,0,2,40,25,65,68
20192020,006,BATH,025,Bath County,"",---District Total---,025,"","",KEDC,903,KG,81,98,0,1,1,0,0,0,0,0,0,1,1,2,0,0,0,0,3,3,97,76,173,179
20192020,006,BATH,025,Bath County,"",---District Total---,025,"","",KEDC,903,01,75,73,0,0,0,0,0,0,0,0,0,2,1,3,0,0,0,0,2,2,71,72,143,148
20192020,006,BATH,025,Bath County,"",---District Total---,025,"","",KEDC,903,02,63,72,0,1,1,0,0,0,0,0,0,1,1,2,0,1,1,1,3,4,70,57,127,135
20192020,006,BATH,025,Bath County,"",---District Total---,025,"","",KEDC,903,04,71,80,0,0,0,0,0,0,0,0,0,2,2,4,0,0,0,2,4,6,76,65,141,151
20192020,006,BATH,025,Bath County,"",---District Total---,025,"","",KEDC,903,05,66,89,1,0,1,0,0,0,0,0,0,4,1,5,0,0,0,3,2,5,81,63,144,155
20192020,006,BATH,025,Bath County,"",---District Total---,025,"","",KEDC,903,06,79,103,1,0,1,0,0,0,0,0,0,3,2,5,0,0,0,1,2,3,98,75,173,182
20192020,006,BATH,025,Bath County,"",---District Total---,025,"","",KEDC,903,07,84,77,1,0,1,0,0,0,0,1,1,3,1,4,0,0,0,1,5,6,72,77,149,161
20192020,006,BATH,025,Bath County,"",---District Total---,025,"","",KEDC,903,08,70,84,2,1,3,0,0,0,0,0,0,2,4,6,0,0,0,2,2,4,78,63,141,154
20192020,006,BATH,025,Bath County,"",---District Total---,025,"","",KEDC,903,09,76,80,0,0,0,0,0,0,0,1,1,5,9,14,0,0,0,1,0,1,74,66,140,156
20192020,006,BATH,025,Bath County,"",---District Total---,025,"","",KEDC,903,10,87,70,0,1,1,0,0,0,0,0,0,0,2,2,0,0,0,0,3,3,70,81,151,157
20192020,006,BATH,025,Bath County,"",---District Total---,025,"","",KEDC,903,11,51,72,0,0,0,0,0,0,1,0,1,3,0,3,0,0,0,0,1,1,68,50,118,123
20192020,006,BATH,025,Bath County,"",---District Total---,025,"","",KEDC,903,12,53,68,1,0,1,0,0,0,0,0,0,1,2,3,0,0,0,0,1,1,66,50,116,121
20192020,006,BATH,025,Bath County,012,Second Chance Academy,025012,006025012,210033002335,KEDC,903,10,0,2,0,0,0,0,0,0,0,0,0,0,0,0,0,0,0,0,0,0,2,0,2,2
20192020,006,BATH,025,Bath County,012,Second Chance Academy,025012,006025012,210033002335,KEDC,903,All Students,4,9,0,0,0,0,0,0,0,0,0,1,0,1,0,0,0,0,0,0,8,4,12,13
20192020,006,BATH,025,Bath County,012,Second Chance Academy,025012,006025012,210033002335,KEDC,903,07,1,2,0,0,0,0,0,0,0,0,0,1,0,1,0,0,0,0,0,0,1,1,2,3
20192020,006,BATH,025,Bath County,012,Second Chance Academy,025012,006025012,210033002335,KEDC,903,08,2,2,0,0,0,0,0,0,0,0,0,0,0,0,0,0,0,0,0,0,2,2,4,4
20192020,006,BATH,025,Bath County,012,Second Chance Academy,025012,006025012,210033002335,KEDC,903,09,1,1,0,0,0,0,0,0,0,0,0,0,0,0,0,0,0,0,0,0,1,1,2,2
20192020,006,BATH,025,Bath County,012,Second Chance Academy,025012,006025012,210033002335,KEDC,903,11,0,1,0,0,0,0,0,0,0,0,0,0,0,0,0,0,0,0,0,0,1,0,1,1
20192020,006,BATH,025,Bath County,012,Second Chance Academy,025012,006025012,210033002335,KEDC,903,12,0,1,0,0,0,0,0,0,0,0,0,0,0,0,0,0,0,0,0,0,1,0,1,1
20192020,006,BATH,025,Bath County,014,Crossroads Elementary School,025014,006025014,210033002223,KEDC,903,05,26,43,0,0,0,0,0,0,0,0,0,2,1,3,0,0,0,0,0,0,41,25,66,69
20192020,006,BATH,025,Bath County,014,Crossroads Elementary School,025014,006025014,210033002223,KEDC,903,All Students,172,216,0,1,1,0,0,0,0,0,0,6,5,11,0,0,0,1,2,3,209,164,373,388
20192020,006,BATH,025,Bath County,014,Crossroads Elementary School,025014,006025014,210033002223,KEDC,903,PS,12,17,0,0,0,0,0,0,0,0,0,1,0,1,0,0,0,1,0,1,15,12,27,29
20192020,006,BATH,025,Bath County,014,Crossroads Elementary School,025014,006025014,210033002223,KEDC,903,KG,24,40,0,0,0,0,0,0,0,0,0,1,1,2,0,0,0,0,0,0,39,23,62,64
20192020,006,BATH,025,Bath County,014,Crossroads Elementary School,025014,006025014,210033002223,KEDC,903,01,39,33,0,0,0,0,0,0,0,0,0,0,1,1,0,0,0,0,1,1,33,37,70,72
20192020,006,BATH,025,Bath County,014,Crossroads Elementary School,025014,006025014,210033002223,KEDC,903,02,32,33,0,1,1,0,0,0,0,0,0,1,1,2,0,0,0,0,0,0,32,30,62,65
20192020,006,BATH,025,Bath County,014,Crossroads Elementary School,025014,006025014,210033002223,KEDC,903,03,25,37,0,0,0,0,0,0,0,0,0,1,0,1,0,0,0,0,0,0,36,25,61,62
20192020,006,BATH,025,Bath County,014,Crossroads Elementary School,025014,006025014,210033002223,KEDC,903,04,26,30,0,0,0,0,0,0,0,0,0,1,1,2,0,0,0,1,1,2,28,24,52,56
20192020,006,BATH,025,Bath County,020,Bath County Middle School,025020,006025020,210033001606,KEDC,903,07,83,75,1,0,1,0,0,0,0,1,1,2,1,3,0,0,0,1,5,6,71,76,147,158
20192020,006,BATH,025,Bath County,020,Bath County Middle School,025020,006025020,210033001606,KEDC,903,All Students,230,260,4,1,5,0,0,0,0,1,1,7,7,14,0,0,0,4,9,13,245,212,457,490
20192020,006,BATH,025,Bath County,020,Bath County Middle School,025020,006025020,210033001606,KEDC,903,06,79,103,1,0,1,0,0,0,0,0,0,3,2,5,0,0,0,1,2,3,98,75,173,182
20192020,006,BATH,025,Bath County,020,Bath County Middle School,025020,006025020,210033001606,KEDC,903,08,68,82,2,1,3,0,0,0,0,0,0,2,4,6,0,0,0,2,2,4,76,61,137,150
20192020,006,BATH,025,Bath County,030,Owingsville Elementary School,025030,006025030,210033000056,KEDC,903,03,34,36,0,0,0,0,0,0,0,0,0,1,0,1,0,0,0,0,2,2,35,32,67,70
20192020,006,BATH,025,Bath County,030,Owingsville Elementary School,025030,006025030,210033000056,KEDC,903,All Students,243,269,1,1,2,0,0,0,0,0,0,6,1,7,0,1,1,5,14,19,257,226,483,512
20192020,006,BATH,025,Bath County,030,Owingsville Elementary School,025030,006025030,210033000056,KEDC,903,PS,13,26,0,0,0,0,0,0,0,0,0,0,0,0,0,0,0,1,0,1,25,13,38,39
20192020,006,BATH,025,Bath County,030,Owingsville Elementary School,025030,006025030,210033000056,KEDC,903,KG,57,58,0,1,1,0,0,0,0,0,0,0,0,0,0,0,0,0,3,3,58,53,111,115
20192020,006,BATH,025,Bath County,030,Owingsville Elementary School,025030,006025030,210033000056,KEDC,903,01,36,40,0,0,0,0,0,0,0,0,0,2,0,2,0,0,0,0,1,1,38,35,73,76
20192020,006,BATH,025,Bath County,030,Owingsville Elementary School,025030,006025030,210033000056,KEDC,903,02,31,39,0,0,0,0,0,0,0,0,0,0,0,0,0,1,1,1,3,4,38,27,65,70
20192020,006,BATH,025,Bath County,030,Owingsville Elementary School,025030,006025030,210033000056,KEDC,903,05,40,46,1,0,1,0,0,0,0,0,0,2,0,2,0,0,0,3,2,5,40,38,78,86
20192020,006,BATH,025,Bath County,030,Owingsville Elementary School,025030,006025030,210033000056,KEDC,903,04,45,50,0,0,0,0,0,0,0,0,0,1,1,2,0,0,0,1,3,4,48,41,89,95
20192020,006,BATH,025,Bath County,040,Bath County High School,025040,006025040,210033000057,KEDC,903,All Students,267,285,1,1,2,0,0,0,1,1,2,9,13,22,0,0,0,1,5,6,273,247,520,552
20192020,006,BATH,025,Bath County,040,Bath County High School,025040,006025040,210033000057,KEDC,903,09,75,79,0,0,0,0,0,0,0,1,1,5,9,14,0,0,0,1,0,1,73,65,138,154
20192020,006,BATH,025,Bath County,040,Bath County High School,025040,006025040,210033000057,KEDC,903,10,87,68,0,1,1,0,0,0,0,0,0,0,2,2,0,0,0,0,3,3,68,81,149,155
20192020,006,BATH,025,Bath County,040,Bath County High School,025040,006025040,210033000057,KEDC,903,11,51,71,0,0,0,0,0,0,1,0,1,3,0,3,0,0,0,0,1,1,67,50,117,122
20192020,006,BATH,025,Bath County,040,Bath County High School,025040,006025040,210033000057,KEDC,903,12,53,67,1,0,1,0,0,0,0,0,0,1,2,3,0,0,0,0,1,1,65,50,115,120
20192020,006,BATH,025,Bath County,040,Bath County High School,025040,006025040,210033000057,KEDC,903,14,1,0,0,0,0,0,0,0,0,0,0,0,0,0,0,0,0,0,0,0,0,1,1,1
20192020,059,KENTON,026,Beechwood Independent,"",---District Total---,026,"","",NKCES,905,All Students,676,772,6,7,13,2,1,3,18,14,32,52,50,102,0,1,1,23,17,40,671,586,1257,1448
20192020,059,KENTON,026,Beechwood Independent,"",---District Total---,026,"","",NKCES,905,PS,20,22,1,1,2,0,0,0,0,0,0,4,3,7,0,0,0,0,3,3,17,13,30,42
20192020,059,KENTON,026,Beechwood Independent,"",---District Total---,026,"","",NKCES,905,KG,48,45,0,2,2,0,0,0,1,0,1,5,3,8,0,0,0,1,0,1,38,43,81,93
20192020,059,KENTON,026,Beechwood Independent,"",---District Total---,026,"","",NKCES,905,01,48,50,1,1,2,0,0,0,1,0,1,4,2,6,0,0,0,1,3,4,43,42,85,98
20192020,059,KENTON,026,Beechwood Independent,"",---District Total---,026,"","",NKCES,905,02,36,49,2,1,3,0,0,0,1,0,1,6,1,7,0,1,1,0,0,0,40,33,73,85
20192020,059,KENTON,026,Beechwood Independent,"",---District Total---,026,"","",NKCES,905,03,47,48,0,1,1,0,0,0,1,1,2,2,4,6,0,0,0,1,0,1,44,41,85,95
20192020,059,KENTON,026,Beechwood Independent,"",---District Total---,026,"","",NKCES,905,04,55,54,0,0,0,0,0,0,1,1,2,1,3,4,0,0,0,6,2,8,46,49,95,109
20192020,059,KENTON,026,Beechwood Independent,"",---District Total---,026,"","",NKCES,905,05,48,61,0,0,0,0,0,0,2,2,4,4,3,7,0,0,0,2,1,3,53,42,95,109
20192020,059,KENTON,026,Beechwood Independent,"",---District Total---,026,"","",NKCES,905,06,66,67,0,1,1,0,0,0,2,1,3,4,9,13,0,0,0,3,1,4,58,54,112,133
20192020,059,KENTON,026,Beechwood Independent,"",---District Total---,026,"","",NKCES,905,07,71,66,2,1,3,0,0,0,0,2,2,8,7,15,0,0,0,2,2,4,54,59,113,137
20192020,059,KENTON,026,Beechwood Independent,"",---District Total---,026,"","",NKCES,905,08,61,59,0,0,0,0,1,1,0,1,1,7,8,15,0,0,0,2,2,4,50,49,99,120
20192020,059,KENTON,026,Beechwood Independent,"",---District Total---,026,"","",NKCES,905,09,52,69,0,0,0,1,0,1,2,1,3,3,4,7,0,0,0,1,1,2,62,46,108,121
20192020,059,KENTON,026,Beechwood Independent,"",---District Total---,026,"","",NKCES,905,10,49,75,0,0,0,0,0,0,1,2,3,4,4,8,0,0,0,2,2,4,68,41,109,124
20192020,059,KENTON,026,Beechwood Independent,"",---District Total---,026,"","",NKCES,905,11,48,60,1,0,1,1,0,1,3,1,4,4,1,5,0,0,0,0,1,1,51,45,96,108
20192020,059,KENTON,026,Beechwood Independent,"",---District Total---,026,"","",NKCES,905,12,47,69,0,0,0,0,0,0,3,2,5,0,1,1,0,0,0,2,2,4,64,42,106,116
20192020,059,KENTON,026,Beechwood Independent,010,Beechwood Elementary School,026010,059026010,210036000059,NKCES,905,05,47,55,0,0,0,0,0,0,2,2,4,4,3,7,0,0,0,1,1,2,48,41,89,102
20192020,059,KENTON,026,Beechwood Independent,010,Beechwood Elementary School,026010,059026010,210036000059,NKCES,905,06,60,62,0,1,1,0,0,0,2,1,3,3,8,11,0,0,0,2,1,3,55,49,104,122
20192020,059,KENTON,026,Beechwood Independent,010,Beechwood Elementary School,026010,059026010,210036000059,NKCES,905,All Students,341,360,3,6,9,0,0,0,9,5,14,25,24,49,0,1,1,11,7,18,312,298,610,701
20192020,059,KENTON,026,Beechwood Independent,010,Beechwood Elementary School,026010,059026010,210036000059,NKCES,905,PS,20,22,1,1,2,0,0,0,0,0,0,4,3,7,0,0,0,0,3,3,17,13,30,42
20192020,059,KENTON,026,Beechwood Independent,010,Beechwood Elementary School,026010,059026010,210036000059,NKCES,905,KG,48,45,0,2,2,0,0,0,1,0,1,5,3,8,0,0,0,1,0,1,38,43,81,93
20192020,059,KENTON,026,Beechwood Independent,010,Beechwood Elementary School,026010,059026010,210036000059,NKCES,905,01,48,50,1,1,2,0,0,0,1,0,1,4,2,6,0,0,0,1,3,4,43,42,85,98
20192020,059,KENTON,026,Beechwood Independent,010,Beechwood Elementary School,026010,059026010,210036000059,NKCES,905,02,36,48,2,1,3,0,0,0,1,0,1,6,1,7,0,1,1,0,0,0,39,33,72,84
20192020,059,KENTON,026,Beechwood Independent,010,Beechwood Elementary School,026010,059026010,210036000059,NKCES,905,03,47,47,0,1,1,0,0,0,1,1,2,2,4,6,0,0,0,1,0,1,43,41,84,94
20192020,059,KENTON,026,Beechwood Independent,010,Beechwood Elementary School,026010,059026010,210036000059,NKCES,905,04,55,53,0,0,0,0,0,0,1,1,2,1,3,4,0,0,0,5,2,7,46,49,95,108
20192020,059,KENTON,026,Beechwood Independent,020,Beechwood High School,026020,059026020,210036000060,NKCES,905,10,49,75,0,0,0,0,0,0,1,2,3,4,4,8,0,0,0,2,2,4,68,41,109,124
20192020,059,KENTON,026,Beechwood Independent,020,Beechwood High School,026020,059026020,210036000060,NKCES,905,12,47,69,0,0,0,0,0,0,3,2,5,0,1,1,0,0,0,2,2,4,64,42,106,116
20192020,059,KENTON,026,Beechwood Independent,020,Beechwood High School,026020,059026020,210036000060,NKCES,905,All Students,324,388,3,1,4,2,1,3,9,9,18,26,25,51,0,0,0,8,9,17,340,279,619,712
20192020,059,KENTON,026,Beechwood Independent,020,Beechwood High School,026020,059026020,210036000060,NKCES,905,07,68,61,2,1,3,0,0,0,0,2,2,8,7,15,0,0,0,1,1,2,50,57,107,129
20192020,059,KENTON,026,Beechwood Independent,020,Beechwood High School,026020,059026020,210036000060,NKCES,905,08,60,54,0,0,0,0,1,1,0,1,1,7,8,15,0,0,0,2,2,4,45,48,93,114
20192020,059,KENTON,026,Beechwood Independent,020,Beechwood High School,026020,059026020,210036000060,NKCES,905,09,52,69,0,0,0,1,0,1,2,1,3,3,4,7,0,0,0,1,1,2,62,46,108,121
20192020,059,KENTON,026,Beechwood Independent,020,Beechwood High School,026020,059026020,210036000060,NKCES,905,11,48,60,1,0,1,1,0,1,3,1,4,4,1,5,0,0,0,0,1,1,51,45,96,108
20192020,059,KENTON,026,Beechwood Independent,420,Guardian Angel,026420,059026420,210036002409,NKCES,905,05,1,6,0,0,0,0,0,0,0,0,0,0,0,0,0,0,0,1,0,1,5,1,6,7
20192020,059,KENTON,026,Beechwood Independent,420,Guardian Angel,026420,059026420,210036002409,NKCES,905,08,1,5,0,0,0,0,0,0,0,0,0,0,0,0,0,0,0,0,0,0,5,1,6,6
20192020,059,KENTON,026,Beechwood Independent,420,Guardian Angel,026420,059026420,210036002409,NKCES,905,All Students,11,24,0,0,0,0,0,0,0,0,0,1,1,2,0,0,0,4,1,5,19,9,28,35
20192020,059,KENTON,026,Beechwood Independent,420,Guardian Angel,026420,059026420,210036002409,NKCES,905,07,3,5,0,0,0,0,0,0,0,0,0,0,0,0,0,0,0,1,1,2,4,2,6,8
20192020,059,KENTON,026,Beechwood Independent,420,Guardian Angel,026420,059026420,210036002409,NKCES,905,02,0,1,0,0,0,0,0,0,0,0,0,0,0,0,0,0,0,0,0,0,1,0,1,1
20192020,059,KENTON,026,Beechwood Independent,420,Guardian Angel,026420,059026420,210036002409,NKCES,905,03,0,1,0,0,0,0,0,0,0,0,0,0,0,0,0,0,0,0,0,0,1,0,1,1
20192020,059,KENTON,026,Beechwood Independent,420,Guardian Angel,026420,059026420,210036002409,NKCES,905,04,0,1,0,0,0,0,0,0,0,0,0,0,0,0,0,0,0,1,0,1,0,0,0,1
20192020,059,KENTON,026,Beechwood Independent,420,Guardian Angel,026420,059026420,210036002409,NKCES,905,06,6,5,0,0,0,0,0,0,0,0,0,1,1,2,0,0,0,1,0,1,3,5,8,11
20192020,007,BELL,031,Bell County,"",---District Total---,031,"","",SESC,907,08,97,99,1,1,2,0,0,0,0,0,0,1,0,1,0,0,0,1,1,2,96,95,191,196
20192020,007,BELL,031,Bell County,"",---District Total---,031,"","",SESC,907,All Students,1192,1243,8,4,12,1,0,1,1,2,3,9,6,15,2,0,2,9,10,19,1213,1170,2383,2435
20192020,007,BELL,031,Bell County,"",---District Total---,031,"","",SESC,907,PS,96,87,0,2,2,0,0,0,0,2,2,0,0,0,0,0,0,2,2,4,85,90,175,183
20192020,007,BELL,031,Bell County,"",---District Total---,031,"","",SESC,907,KG,95,93,0,1,1,0,0,0,0,1,1,1,0,1,0,0,0,0,1,1,92,92,184,188
20192020,007,BELL,031,Bell County,"",---District Total---,031,"","",SESC,907,01,109,107,0,1,1,0,0,0,0,0,0,2,1,3,0,0,0,2,0,2,103,107,210,216
20192020,007,BELL,031,Bell County,"",---District Total---,031,"","",SESC,907,02,80,89,1,0,1,0,0,0,0,0,0,1,2,3,1,0,1,2,1,3,84,77,161,169
20192020,007,BELL,031,Bell County,"",---District Total---,031,"","",SESC,907,03,93,91,1,0,1,0,0,0,0,0,0,0,0,0,0,0,0,2,1,3,88,92,180,184
20192020,007,BELL,031,Bell County,"",---District Total---,031,"","",SESC,907,04,101,94,0,0,0,0,0,0,0,0,0,0,0,0,0,0,0,0,1,1,94,100,194,195
20192020,007,BELL,031,Bell County,"",---District Total---,031,"","",SESC,907,05,96,93,0,0,0,1,0,1,0,0,0,1,0,1,0,0,0,0,2,2,91,94,185,189
20192020,007,BELL,031,Bell County,"",---District Total---,031,"","",SESC,907,06,87,113,0,1,1,0,0,0,0,1,1,0,1,1,0,0,0,0,1,1,113,83,196,200
20192020,007,BELL,031,Bell County,"",---District Total---,031,"","",SESC,907,07,105,90,1,0,1,0,0,0,0,0,0,0,0,0,0,0,0,1,0,1,88,105,193,195
20192020,007,BELL,031,Bell County,"",---District Total---,031,"","",SESC,907,09,96,93,1,0,1,0,0,0,0,0,0,1,1,2,0,0,0,1,0,1,90,95,185,189
20192020,007,BELL,031,Bell County,"",---District Total---,031,"","",SESC,907,10,98,91,1,0,1,0,0,0,0,0,0,1,1,2,0,0,0,0,0,0,89,97,186,189
20192020,007,BELL,031,Bell County,"",---District Total---,031,"","",SESC,907,11,76,99,1,0,1,0,0,0,1,0,1,1,0,1,0,0,0,0,1,1,96,75,171,175
20192020,007,BELL,031,Bell County,"",---District Total---,031,"","",SESC,907,12,59,91,1,0,1,0,0,0,0,0,0,0,0,0,1,0,1,0,1,1,89,58,147,150
20192020,007,BELL,031,Bell County,012,Bell Central School Center,031012,007031012,210039001881,SESC,907,08,22,23,0,0,0,0,0,0,0,0,0,0,0,0,0,0,0,0,0,0,23,22,45,45
20192020,007,BELL,031,Bell County,012,Bell Central School Center,031012,007031012,210039001881,SESC,907,All Students,214,224,0,1,1,0,0,0,0,0,0,2,0,2,0,0,0,4,2,6,218,211,429,438
20192020,007,BELL,031,Bell County,012,Bell Central School Center,031012,007031012,210039001881,SESC,907,PS,26,17,0,0,0,0,0,0,0,0,0,0,0,0,0,0,0,1,0,1,16,26,42,43
20192020,007,BELL,031,Bell County,012,Bell Central School Center,031012,007031012,210039001881,SESC,907,KG,20,20,0,0,0,0,0,0,0,0,0,1,0,1,0,0,0,0,0,0,19,20,39,40
20192020,007,BELL,031,Bell County,012,Bell Central School Center,031012,007031012,210039001881,SESC,907,01,33,26,0,1,1,0,0,0,0,0,0,0,0,0,0,0,0,1,0,1,25,32,57,59
20192020,007,BELL,031,Bell County,012,Bell Central School Center,031012,007031012,210039001881,SESC,907,02,20,18,0,0,0,0,0,0,0,0,0,0,0,0,0,0,0,1,0,1,17,20,37,38
20192020,007,BELL,031,Bell County,012,Bell Central School Center,031012,007031012,210039001881,SESC,907,03,20,31,0,0,0,0,0,0,0,0,0,0,0,0,0,0,0,1,0,1,30,20,50,51
20192020,007,BELL,031,Bell County,012,Bell Central School Center,031012,007031012,210039001881,SESC,907,04,28,24,0,0,0,0,0,0,0,0,0,0,0,0,0,0,0,0,1,1,24,27,51,52
20192020,007,BELL,031,Bell County,012,Bell Central School Center,031012,007031012,210039001881,SESC,907,05,15,26,0,0,0,0,0,0,0,0,0,1,0,1,0,0,0,0,1,1,25,14,39,41
20192020,007,BELL,031,Bell County,012,Bell Central School Center,031012,007031012,210039001881,SESC,907,06,29,35,0,0,0,0,0,0,0,0,0,0,0,0,0,0,0,0,0,0,35,29,64,64
20192020,007,BELL,031,Bell County,012,Bell Central School Center,031012,007031012,210039001881,SESC,907,07,27,21,0,0,0,0,0,0,0,0,0,0,0,0,0,0,0,1,0,1,20,27,47,48
20192020,007,BELL,031,Bell County,013,Page School Center,031013,007031013,210039001882,SESC,907,07,19,21,0,0,0,0,0,0,0,0,0,0,0,0,0,0,0,0,0,0,21,19,40,40
20192020,007,BELL,031,Bell County,013,Page School Center,031013,007031013,210039001882,SESC,907,All Students,144,150,1,0,1,0,0,0,0,0,0,1,1,2,0,0,0,0,2,2,148,141,289,294
20192020,007,BELL,031,Bell County,013,Page School Center,031013,007031013,210039001882,SESC,907,PS,16,18,0,0,0,0,0,0,0,0,0,0,0,0,0,0,0,0,2,2,18,14,32,34
20192020,007,BELL,031,Bell County,013,Page School Center,031013,007031013,210039001882,SESC,907,KG,17,16,0,0,0,0,0,0,0,0,0,0,0,0,0,0,0,0,0,0,16,17,33,33
20192020,007,BELL,031,Bell County,013,Page School Center,031013,007031013,210039001882,SESC,907,01,11,11,0,0,0,0,0,0,0,0,0,0,0,0,0,0,0,0,0,0,11,11,22,22
20192020,007,BELL,031,Bell County,013,Page School Center,031013,007031013,210039001882,SESC,907,02,10,20,0,0,0,0,0,0,0,0,0,0,0,0,0,0,0,0,0,0,20,10,30,30
20192020,007,BELL,031,Bell County,013,Page School Center,031013,007031013,210039001882,SESC,907,03,18,14,1,0,1,0,0,0,0,0,0,0,0,0,0,0,0,0,0,0,13,18,31,32
20192020,007,BELL,031,Bell County,013,Page School Center,031013,007031013,210039001882,SESC,907,04,17,12,0,0,0,0,0,0,0,0,0,0,0,0,0,0,0,0,0,0,12,17,29,29
20192020,007,BELL,031,Bell County,013,Page School Center,031013,007031013,210039001882,SESC,907,05,16,19,0,0,0,0,0,0,0,0,0,0,0,0,0,0,0,0,1,1,19,15,34,35
20192020,007,BELL,031,Bell County,013,Page School Center,031013,007031013,210039001882,SESC,907,06,15,24,0,0,0,0,0,0,0,0,0,0,1,1,0,0,0,0,0,0,24,14,38,39
20192020,007,BELL,031,Bell County,013,Page School Center,031013,007031013,210039001882,SESC,907,08,21,13,0,0,0,0,0,0,0,0,0,1,0,1,0,0,0,0,1,1,12,20,32,34
20192020,007,BELL,031,Bell County,040,Bell County High School,031040,007031040,210039000062,SESC,907,11,73,95,1,0,1,0,0,0,1,0,1,1,0,1,0,0,0,0,1,1,92,72,164,168
20192020,007,BELL,031,Bell County,040,Bell County High School,031040,007031040,210039000062,SESC,907,All Students,309,357,4,0,4,0,0,0,1,0,1,3,2,5,1,0,1,1,2,3,347,305,652,666
20192020,007,BELL,031,Bell County,040,Bell County High School,031040,007031040,210039000062,SESC,907,09,90,92,1,0,1,0,0,0,0,0,0,1,1,2,0,0,0,1,0,1,89,89,178,182
20192020,007,BELL,031,Bell County,040,Bell County High School,031040,007031040,210039000062,SESC,907,10,93,86,1,0,1,0,0,0,0,0,0,1,1,2,0,0,0,0,0,0,84,92,176,179
20192020,007,BELL,031,Bell County,040,Bell County High School,031040,007031040,210039000062,SESC,907,12,53,84,1,0,1,0,0,0,0,0,0,0,0,0,1,0,1,0,1,1,82,52,134,137
20192020,007,BELL,031,Bell County,180,Frakes School Center,031180,007031180,210039000067,SESC,907,07,5,7,0,0,0,0,0,0,0,0,0,0,0,0,0,0,0,0,0,0,7,5,12,12
20192020,007,BELL,031,Bell County,180,Frakes School Center,031180,007031180,210039000067,SESC,907,All Students,45,61,1,1,2,0,0,0,0,0,0,0,0,0,0,0,0,0,0,0,60,44,104,106
20192020,007,BELL,031,Bell County,180,Frakes School Center,031180,007031180,210039000067,SESC,907,PS,9,2,0,0,0,0,0,0,0,0,0,0,0,0,0,0,0,0,0,0,2,9,11,11
20192020,007,BELL,031,Bell County,180,Frakes School Center,031180,007031180,210039000067,SESC,907,KG,6,10,0,0,0,0,0,0,0,0,0,0,0,0,0,0,0,0,0,0,10,6,16,16
20192020,007,BELL,031,Bell County,180,Frakes School Center,031180,007031180,210039000067,SESC,907,01,5,5,0,0,0,0,0,0,0,0,0,0,0,0,0,0,0,0,0,0,5,5,10,10
20192020,007,BELL,031,Bell County,180,Frakes School Center,031180,007031180,210039000067,SESC,907,02,3,7,1,0,1,0,0,0,0,0,0,0,0,0,0,0,0,0,0,0,6,3,9,10
20192020,007,BELL,031,Bell County,180,Frakes School Center,031180,007031180,210039000067,SESC,907,03,4,5,0,0,0,0,0,0,0,0,0,0,0,0,0,0,0,0,0,0,5,4,9,9
20192020,007,BELL,031,Bell County,180,Frakes School Center,031180,007031180,210039000067,SESC,907,04,5,6,0,0,0,0,0,0,0,0,0,0,0,0,0,0,0,0,0,0,6,5,11,11
20192020,007,BELL,031,Bell County,180,Frakes School Center,031180,007031180,210039000067,SESC,907,05,5,7,0,0,0,0,0,0,0,0,0,0,0,0,0,0,0,0,0,0,7,5,12,12
20192020,007,BELL,031,Bell County,180,Frakes School Center,031180,007031180,210039000067,SESC,907,06,5,6,0,0,0,0,0,0,0,0,0,0,0,0,0,0,0,0,0,0,6,5,11,11
20192020,007,BELL,031,Bell County,180,Frakes School Center,031180,007031180,210039000067,SESC,907,08,7,8,0,1,1,0,0,0,0,0,0,0,0,0,0,0,0,0,0,0,8,6,14,15
20192020,007,BELL,031,Bell County,250,Lone Jack School Center,031250,007031250,210039000068,SESC,907,07,15,3,0,0,0,0,0,0,0,0,0,0,0,0,0,0,0,0,0,0,3,15,18,18
20192020,007,BELL,031,Bell County,250,Lone Jack School Center,031250,007031250,210039000068,SESC,907,All Students,69,68,0,0,0,0,0,0,0,0,0,0,1,1,0,0,0,1,1,2,67,67,134,137
20192020,007,BELL,031,Bell County,250,Lone Jack School Center,031250,007031250,210039000068,SESC,907,PS,7,12,0,1,1,0,0,0,0,0,0,0,0,0,0,0,0,0,0,0,12,6,18,19
20192020,007,BELL,031,Bell County,250,Lone Jack School Center,031250,007031250,210039000068,SESC,907,KG,8,10,0,0,0,0,0,0,0,0,0,0,0,0,0,0,0,0,0,0,10,8,18,18
20192020,007,BELL,031,Bell County,250,Lone Jack School Center,031250,007031250,210039000068,SESC,907,01,5,10,0,0,0,0,0,0,0,0,0,0,0,0,0,0,0,0,0,0,10,5,15,15
20192020,007,BELL,031,Bell County,250,Lone Jack School Center,031250,007031250,210039000068,SESC,907,02,5,8,0,0,0,0,0,0,0,0,0,0,1,1,0,0,0,0,1,1,8,3,11,13
20192020,007,BELL,031,Bell County,250,Lone Jack School Center,031250,007031250,210039000068,SESC,907,03,7,4,0,0,0,0,0,0,0,0,0,0,0,0,0,0,0,0,0,0,4,7,11,11
20192020,007,BELL,031,Bell County,250,Lone Jack School Center,031250,007031250,210039000068,SESC,907,04,9,9,0,0,0,0,0,0,0,0,0,0,0,0,0,0,0,0,0,0,9,9,18,18
20192020,007,BELL,031,Bell County,250,Lone Jack School Center,031250,007031250,210039000068,SESC,907,05,10,10,0,0,0,0,0,0,0,0,0,0,0,0,0,0,0,0,0,0,10,10,20,20
20192020,007,BELL,031,Bell County,250,Lone Jack School Center,031250,007031250,210039000068,SESC,907,06,2,4,0,0,0,0,0,0,0,0,0,0,0,0,0,0,0,0,0,0,4,2,6,6
20192020,007,BELL,031,Bell County,250,Lone Jack School Center,031250,007031250,210039000068,SESC,907,08,8,10,0,0,0,0,0,0,0,0,0,0,0,0,0,0,0,1,0,1,9,8,17,18
20192020,007,BELL,031,Bell County,340,Bell County Alternative School,031340,007031340,210039000002,SESC,907,07,0,2,0,0,0,0,0,0,0,0,0,0,0,0,0,0,0,0,0,0,2,0,2,2
20192020,007,BELL,031,Bell County,340,Bell County Alternative School,031340,007031340,210039000002,SESC,907,08,1,3,0,0,0,0,0,0,0,0,0,0,0,0,0,0,0,0,0,0,3,1,4,4
20192020,007,BELL,031,Bell County,340,Bell County Alternative School,031340,007031340,210039000002,SESC,907,09,6,1,0,0,0,0,0,0,0,0,0,0,0,0,0,0,0,0,0,0,1,6,7,7
20192020,007,BELL,031,Bell County,340,Bell County Alternative School,031340,007031340,210039000002,SESC,907,10,5,5,0,0,0,0,0,0,0,0,0,0,0,0,0,0,0,0,0,0,5,5,10,10
20192020,007,BELL,031,Bell County,340,Bell County Alternative School,031340,007031340,210039000002,SESC,907,11,3,4,0,0,0,0,0,0,0,0,0,0,0,0,0,0,0,0,0,0,4,3,7,7
20192020,007,BELL,031,Bell County,340,Bell County Alternative School,031340,007031340,210039000002,SESC,907,12,6,7,0,0,0,0,0,0,0,0,0,0,0,0,0,0,0,0,0,0,7,6,13,13
20192020,007,BELL,031,Bell County,340,Bell County Alternative School,031340,007031340,210039000002,SESC,907,All Students,21,23,0,0,0,0,0,0,0,0,0,0,0,0,0,0,0,0,0,0,23,21,44,44
20192020,007,BELL,031,Bell County,340,Bell County Alternative School,031340,007031340,210039000002,SESC,907,06,0,1,0,0,0,0,0,0,0,0,0,0,0,0,0,0,0,0,0,0,1,0,1,1
20192020,007,BELL,031,Bell County,345,Right Fork School Center,031345,007031345,210039000072,SESC,907,05,11,5,0,0,0,0,0,0,0,0,0,0,0,0,0,0,0,0,0,0,5,11,16,16
20192020,007,BELL,031,Bell County,345,Right Fork School Center,031345,007031345,210039000072,SESC,907,06,7,13,0,1,1,0,0,0,0,0,0,0,0,0,0,0,0,0,0,0,13,6,19,20
20192020,007,BELL,031,Bell County,345,Right Fork School Center,031345,007031345,210039000072,SESC,907,08,16,12,1,0,1,0,0,0,0,0,0,0,0,0,0,0,0,0,0,0,11,16,27,28
20192020,007,BELL,031,Bell County,345,Right Fork School Center,031345,007031345,210039000072,SESC,907,07,9,12,0,0,0,0,0,0,0,0,0,0,0,0,0,0,0,0,0,0,12,9,21,21
20192020,007,BELL,031,Bell County,345,Right Fork School Center,031345,007031345,210039000072,SESC,907,All Students,86,79,1,1,2,0,0,0,0,0,0,0,0,0,0,0,0,0,0,0,78,85,163,165
20192020,007,BELL,031,Bell County,345,Right Fork School Center,031345,007031345,210039000072,SESC,907,PS,16,9,0,0,0,0,0,0,0,0,0,0,0,0,0,0,0,0,0,0,9,16,25,25
20192020,007,BELL,031,Bell County,345,Right Fork School Center,031345,007031345,210039000072,SESC,907,KG,10,7,0,0,0,0,0,0,0,0,0,0,0,0,0,0,0,0,0,0,7,10,17,17
20192020,007,BELL,031,Bell County,345,Right Fork School Center,031345,007031345,210039000072,SESC,907,01,8,11,0,0,0,0,0,0,0,0,0,0,0,0,0,0,0,0,0,0,11,8,19,19
20192020,007,BELL,031,Bell County,345,Right Fork School Center,031345,007031345,210039000072,SESC,907,02,5,3,0,0,0,0,0,0,0,0,0,0,0,0,0,0,0,0,0,0,3,5,8,8
20192020,007,BELL,031,Bell County,345,Right Fork School Center,031345,007031345,210039000072,SESC,907,03,11,6,0,0,0,0,0,0,0,0,0,0,0,0,0,0,0,0,0,0,6,11,17,17
20192020,007,BELL,031,Bell County,345,Right Fork School Center,031345,007031345,210039000072,SESC,907,04,9,10,0,0,0,0,0,0,0,0,0,0,0,0,0,0,0,0,0,0,10,9,19,19
20192020,007,BELL,031,Bell County,390,Yellow Creek School Center,031390,007031390,210039000074,SESC,907,08,22,30,0,0,0,0,0,0,0,0,0,0,0,0,0,0,0,0,0,0,30,22,52,52
20192020,007,BELL,031,Bell County,390,Yellow Creek School Center,031390,007031390,210039000074,SESC,907,All Students,304,281,1,1,2,1,0,1,0,2,2,3,2,5,1,0,1,3,3,6,272,296,568,585
20192020,007,BELL,031,Bell County,390,Yellow Creek School Center,031390,007031390,210039000074,SESC,907,PS,22,29,0,1,1,0,0,0,0,2,2,0,0,0,0,0,0,1,0,1,28,19,47,51
20192020,007,BELL,031,Bell County,390,Yellow Creek School Center,031390,007031390,210039000074,SESC,907,KG,34,30,0,1,1,0,0,0,0,1,1,0,0,0,0,0,0,0,1,1,30,31,61,64
20192020,007,BELL,031,Bell County,390,Yellow Creek School Center,031390,007031390,210039000074,SESC,907,01,47,44,0,0,0,0,0,0,0,0,0,2,1,3,0,0,0,1,0,1,41,46,87,91
20192020,007,BELL,031,Bell County,390,Yellow Creek School Center,031390,007031390,210039000074,SESC,907,02,37,33,0,0,0,0,0,0,0,0,0,1,1,2,1,0,1,1,0,1,30,36,66,70
20192020,007,BELL,031,Bell County,390,Yellow Creek School Center,031390,007031390,210039000074,SESC,907,03,33,31,0,0,0,0,0,0,0,0,0,0,0,0,0,0,0,1,1,2,30,32,62,64
20192020,007,BELL,031,Bell County,390,Yellow Creek School Center,031390,007031390,210039000074,SESC,907,04,33,33,0,0,0,0,0,0,0,0,0,0,0,0,0,0,0,0,0,0,33,33,66,66
20192020,007,BELL,031,Bell County,390,Yellow Creek School Center,031390,007031390,210039000074,SESC,907,05,39,26,0,0,0,1,0,1,0,0,0,0,0,0,0,0,0,0,0,0,25,39,64,65
20192020,007,BELL,031,Bell County,390,Yellow Creek School Center,031390,007031390,210039000074,SESC,907,06,29,30,0,0,0,0,0,0,0,1,1,0,0,0,0,0,0,0,1,1,30,27,57,59
20192020,007,BELL,031,Bell County,390,Yellow Creek School Center,031390,007031390,210039000074,SESC,907,07,30,24,1,0,1,0,0,0,0,0,0,0,0,0,0,0,0,0,0,0,23,30,53,54
20192020,019,CAMPBELL,032,Bellevue Independent,"",---District Total---,032,"","",NKCES,905,09,21,30,0,1,1,0,0,0,0,1,1,2,0,2,0,0,0,4,2,6,24,17,41,51
20192020,019,CAMPBELL,032,Bellevue Independent,"",---District Total---,032,"","",NKCES,905,All Students,277,322,12,12,24,0,0,0,0,2,2,16,18,34,1,3,4,24,22,46,269,220,489,599
20192020,019,CAMPBELL,032,Bellevue Independent,"",---District Total---,032,"","",NKCES,905,PS,38,25,1,1,2,0,0,0,0,0,0,0,5,5,0,0,0,2,1,3,22,31,53,63
20192020,019,CAMPBELL,032,Bellevue Independent,"",---District Total---,032,"","",NKCES,905,KG,13,19,2,0,2,0,0,0,0,0,0,1,2,3,0,0,0,0,0,0,16,11,27,32
20192020,019,CAMPBELL,032,Bellevue Independent,"",---District Total---,032,"","",NKCES,905,01,16,22,0,2,2,0,0,0,0,0,0,1,0,1,0,0,0,1,1,2,20,13,33,38
20192020,019,CAMPBELL,032,Bellevue Independent,"",---District Total---,032,"","",NKCES,905,02,14,20,1,0,1,0,0,0,0,0,0,2,0,2,0,0,0,1,0,1,16,14,30,34
20192020,019,CAMPBELL,032,Bellevue Independent,"",---District Total---,032,"","",NKCES,905,03,15,22,2,1,3,0,0,0,0,0,0,0,3,3,0,0,0,3,0,3,17,11,28,37
20192020,019,CAMPBELL,032,Bellevue Independent,"",---District Total---,032,"","",NKCES,905,04,22,16,0,1,1,0,0,0,0,1,1,1,1,2,0,0,0,3,3,6,12,16,28,38
20192020,019,CAMPBELL,032,Bellevue Independent,"",---District Total---,032,"","",NKCES,905,05,24,21,2,1,3,0,0,0,0,0,0,2,2,4,0,0,0,0,3,3,17,18,35,45
20192020,019,CAMPBELL,032,Bellevue Independent,"",---District Total---,032,"","",NKCES,905,06,23,31,0,1,1,0,0,0,0,0,0,0,0,0,0,1,1,2,2,4,29,19,48,54
20192020,019,CAMPBELL,032,Bellevue Independent,"",---District Total---,032,"","",NKCES,905,07,32,23,2,0,2,0,0,0,0,0,0,2,2,4,0,1,1,1,6,7,18,23,41,55
20192020,019,CAMPBELL,032,Bellevue Independent,"",---District Total---,032,"","",NKCES,905,08,21,35,1,1,2,0,0,0,0,0,0,0,3,3,1,0,1,4,0,4,29,17,46,56
20192020,019,CAMPBELL,032,Bellevue Independent,"",---District Total---,032,"","",NKCES,905,10,24,25,0,3,3,0,0,0,0,0,0,1,2,3,0,0,0,3,2,5,21,17,38,49
20192020,019,CAMPBELL,032,Bellevue Independent,"",---District Total---,032,"","",NKCES,905,11,28,33,1,0,1,0,0,0,0,0,0,2,0,2,0,1,1,1,2,3,29,25,54,61
20192020,019,CAMPBELL,032,Bellevue Independent,"",---District Total---,032,"","",NKCES,905,12,24,25,1,1,2,0,0,0,0,0,0,2,3,5,0,0,0,1,1,2,21,19,40,49
20192020,019,CAMPBELL,032,Bellevue Independent,010,Bellevue High School,032010,019032010,210042000075,NKCES,905,12,24,25,1,1,2,0,0,0,0,0,0,2,3,5,0,0,0,1,1,2,21,19,40,49
20192020,019,CAMPBELL,032,Bellevue Independent,010,Bellevue High School,032010,019032010,210042000075,NKCES,905,All Students,173,202,5,7,12,0,0,0,0,1,1,9,10,19,1,3,4,16,15,31,171,137,308,375
20192020,019,CAMPBELL,032,Bellevue Independent,010,Bellevue High School,032010,019032010,210042000075,NKCES,905,06,23,31,0,1,1,0,0,0,0,0,0,0,0,0,0,1,1,2,2,4,29,19,48,54
20192020,019,CAMPBELL,032,Bellevue Independent,010,Bellevue High School,032010,019032010,210042000075,NKCES,905,07,32,23,2,0,2,0,0,0,0,0,0,2,2,4,0,1,1,1,6,7,18,23,41,55
20192020,019,CAMPBELL,032,Bellevue Independent,010,Bellevue High School,032010,019032010,210042000075,NKCES,905,08,21,35,1,1,2,0,0,0,0,0,0,0,3,3,1,0,1,4,0,4,29,17,46,56
20192020,019,CAMPBELL,032,Bellevue Independent,010,Bellevue High School,032010,019032010,210042000075,NKCES,905,09,21,30,0,1,1,0,0,0,0,1,1,2,0,2,0,0,0,4,2,6,24,17,41,51
20192020,019,CAMPBELL,032,Bellevue Independent,010,Bellevue High School,032010,019032010,210042000075,NKCES,905,10,24,25,0,3,3,0,0,0,0,0,0,1,2,3,0,0,0,3,2,5,21,17,38,49
20192020,019,CAMPBELL,032,Bellevue Independent,010,Bellevue High School,032010,019032010,210042000075,NKCES,905,11,28,33,1,0,1,0,0,0,0,0,0,2,0,2,0,1,1,1,2,3,29,25,54,61
20192020,019,CAMPBELL,032,Bellevue Independent,020,Grandview Elementary School,032020,019032020,210042000076,NKCES,905,04,22,16,0,1,1,0,0,0,0,1,1,1,1,2,0,0,0,3,3,6,12,16,28,38
20192020,019,CAMPBELL,032,Bellevue Independent,020,Grandview Elementary School,032020,019032020,210042000076,NKCES,905,All Students,104,120,7,5,12,0,0,0,0,1,1,7,8,15,0,0,0,8,7,15,98,83,181,224
20192020,019,CAMPBELL,032,Bellevue Independent,020,Grandview Elementary School,032020,019032020,210042000076,NKCES,905,PS,38,25,1,1,2,0,0,0,0,0,0,0,5,5,0,0,0,2,1,3,22,31,53,63
20192020,019,CAMPBELL,032,Bellevue Independent,020,Grandview Elementary School,032020,019032020,210042000076,NKCES,905,KG,13,19,2,0,2,0,0,0,0,0,0,1,2,3,0,0,0,0,0,0,16,11,27,32
20192020,019,CAMPBELL,032,Bellevue Independent,020,Grandview Elementary School,032020,019032020,210042000076,NKCES,905,01,16,22,0,2,2,0,0,0,0,0,0,1,0,1,0,0,0,1,1,2,20,13,33,38
20192020,019,CAMPBELL,032,Bellevue Independent,020,Grandview Elementary School,032020,019032020,210042000076,NKCES,905,02,14,20,1,0,1,0,0,0,0,0,0,2,0,2,0,0,0,1,0,1,16,14,30,34
20192020,019,CAMPBELL,032,Bellevue Independent,020,Grandview Elementary School,032020,019032020,210042000076,NKCES,905,03,15,22,2,1,3,0,0,0,0,0,0,0,3,3,0,0,0,3,0,3,17,11,28,37
20192020,019,CAMPBELL,032,Bellevue Independent,020,Grandview Elementary School,032020,019032020,210042000076,NKCES,905,05,24,21,2,1,3,0,0,0,0,0,0,2,2,4,0,0,0,0,3,3,17,18,35,45
20192020,073,MADISON,034,Berea Independent,"",---District Total---,034,"","",SESC,907,07,45,49,2,2,4,0,0,0,0,1,1,3,0,3,0,0,0,5,4,9,39,38,77,94
20192020,073,MADISON,034,Berea Independent,"",---District Total---,034,"","",SESC,907,All Students,533,554,22,15,37,0,0,0,2,6,8,44,27,71,0,0,0,24,19,43,462,466,928,1087
20192020,073,MADISON,034,Berea Independent,"",---District Total---,034,"","",SESC,907,PS,27,32,0,1,1,0,0,0,0,0,0,1,1,2,0,0,0,0,1,1,31,24,55,59
20192020,073,MADISON,034,Berea Independent,"",---District Total---,034,"","",SESC,907,KG,34,42,2,1,3,0,0,0,0,1,1,1,1,2,0,0,0,3,2,5,36,29,65,76
20192020,073,MADISON,034,Berea Independent,"",---District Total---,034,"","",SESC,907,01,48,41,0,1,1,0,0,0,0,0,0,6,0,6,0,0,0,1,2,3,34,45,79,89
20192020,073,MADISON,034,Berea Independent,"",---District Total---,034,"","",SESC,907,02,38,40,2,1,3,0,0,0,0,0,0,2,3,5,0,0,0,4,3,7,32,31,63,78
20192020,073,MADISON,034,Berea Independent,"",---District Total---,034,"","",SESC,907,03,37,42,2,1,3,0,0,0,0,0,0,4,2,6,0,0,0,2,2,4,34,32,66,79
20192020,073,MADISON,034,Berea Independent,"",---District Total---,034,"","",SESC,907,04,38,33,2,1,3,0,0,0,0,1,1,2,3,5,0,0,0,2,1,3,27,32,59,71
20192020,073,MADISON,034,Berea Independent,"",---District Total---,034,"","",SESC,907,05,44,46,2,0,2,0,0,0,1,0,1,2,4,6,0,0,0,2,0,2,39,40,79,90
20192020,073,MADISON,034,Berea Independent,"",---District Total---,034,"","",SESC,907,06,35,50,0,1,1,0,0,0,0,0,0,9,4,13,0,0,0,0,2,2,41,28,69,85
20192020,073,MADISON,034,Berea Independent,"",---District Total---,034,"","",SESC,907,08,54,48,0,2,2,0,0,0,0,1,1,4,4,8,0,0,0,0,0,0,44,47,91,102
20192020,073,MADISON,034,Berea Independent,"",---District Total---,034,"","",SESC,907,09,52,48,3,1,4,0,0,0,0,0,0,3,1,4,0,0,0,3,1,4,39,49,88,100
20192020,073,MADISON,034,Berea Independent,"",---District Total---,034,"","",SESC,907,10,45,38,2,4,6,0,0,0,1,0,1,3,2,5,0,0,0,0,1,1,32,38,70,83
20192020,073,MADISON,034,Berea Independent,"",---District Total---,034,"","",SESC,907,11,32,38,0,0,0,0,0,0,0,1,1,3,2,5,0,0,0,1,1,2,34,28,62,70
20192020,073,MADISON,034,Berea Independent,"",---District Total---,034,"","",SESC,907,12,31,39,5,0,5,0,0,0,0,1,1,2,1,3,0,0,0,1,0,1,31,29,60,70
20192020,073,MADISON,034,Berea Independent,010,Berea Community Elementary School,034010,073034010,210048000077,SESC,907,04,38,33,2,1,3,0,0,0,0,1,1,2,3,5,0,0,0,2,1,3,27,32,59,71
20192020,073,MADISON,034,Berea Independent,010,Berea Community Elementary School,034010,073034010,210048000077,SESC,907,05,44,46,2,0,2,0,0,0,1,0,1,2,4,6,0,0,0,2,0,2,39,40,79,90
20192020,073,MADISON,034,Berea Independent,010,Berea Community Elementary School,034010,073034010,210048000077,SESC,907,PS,27,32,0,1,1,0,0,0,0,0,0,1,1,2,0,0,0,0,1,1,31,24,55,59
20192020,073,MADISON,034,Berea Independent,010,Berea Community Elementary School,034010,073034010,210048000077,SESC,907,KG,34,42,2,1,3,0,0,0,0,1,1,1,1,2,0,0,0,3,2,5,36,29,65,76
20192020,073,MADISON,034,Berea Independent,010,Berea Community Elementary School,034010,073034010,210048000077,SESC,907,01,48,41,0,1,1,0,0,0,0,0,0,6,0,6,0,0,0,1,2,3,34,45,79,89
20192020,073,MADISON,034,Berea Independent,010,Berea Community Elementary School,034010,073034010,210048000077,SESC,907,02,38,40,2,1,3,0,0,0,0,0,0,2,3,5,0,0,0,4,3,7,32,31,63,78
20192020,073,MADISON,034,Berea Independent,010,Berea Community Elementary School,034010,073034010,210048000077,SESC,907,03,37,42,2,1,3,0,0,0,0,0,0,4,2,6,0,0,0,2,2,4,34,32,66,79
20192020,073,MADISON,034,Berea Independent,010,Berea Community Elementary School,034010,073034010,210048000077,SESC,907,All Students,239,244,10,5,15,0,0,0,1,2,3,17,13,30,0,0,0,14,10,24,202,209,411,483
20192020,073,MADISON,034,Berea Independent,015,Berea Community Middle School,034015,073034015,210048001658,SESC,907,06,35,50,0,1,1,0,0,0,0,0,0,9,4,13,0,0,0,0,2,2,41,28,69,85
20192020,073,MADISON,034,Berea Independent,015,Berea Community Middle School,034015,073034015,210048001658,SESC,907,08,54,48,0,2,2,0,0,0,0,1,1,4,4,8,0,0,0,0,0,0,44,47,91,102
20192020,073,MADISON,034,Berea Independent,015,Berea Community Middle School,034015,073034015,210048001658,SESC,907,All Students,134,147,2,5,7,0,0,0,0,2,2,16,8,24,0,0,0,5,6,11,124,113,237,281
20192020,073,MADISON,034,Berea Independent,015,Berea Community Middle School,034015,073034015,210048001658,SESC,907,07,45,49,2,2,4,0,0,0,0,1,1,3,0,3,0,0,0,5,4,9,39,38,77,94
20192020,073,MADISON,034,Berea Independent,020,Berea Community High School,034020,073034020,210048000078,SESC,907,All Students,160,163,10,5,15,0,0,0,1,2,3,11,6,17,0,0,0,5,3,8,136,144,280,323
20192020,073,MADISON,034,Berea Independent,020,Berea Community High School,034020,073034020,210048000078,SESC,907,09,52,48,3,1,4,0,0,0,0,0,0,3,1,4,0,0,0,3,1,4,39,49,88,100
20192020,073,MADISON,034,Berea Independent,020,Berea Community High School,034020,073034020,210048000078,SESC,907,10,45,38,2,4,6,0,0,0,1,0,1,3,2,5,0,0,0,0,1,1,32,38,70,83
20192020,073,MADISON,034,Berea Independent,020,Berea Community High School,034020,073034020,210048000078,SESC,907,11,32,38,0,0,0,0,0,0,0,1,1,3,2,5,0,0,0,1,1,2,34,28,62,70
20192020,073,MADISON,034,Berea Independent,020,Berea Community High School,034020,073034020,210048000078,SESC,907,12,31,39,5,0,5,0,0,0,0,1,1,2,1,3,0,0,0,1,0,1,31,29,60,70
20192020,008,BOONE,035,Boone County,"",---District Total---,035,"","",NKCES,905,14,6,15,1,0,1,0,0,0,0,0,0,0,1,1,0,0,0,0,0,0,14,5,19,21
20192020,008,BOONE,035,Boone County,"",---District Total---,035,"","",NKCES,905,PS,228,371,29,29,58,1,0,1,8,3,11,35,26,61,0,0,0,17,11,28,281,159,440,599
20192020,008,BOONE,035,Boone County,"",---District Total---,035,"","",NKCES,905,All Students,9939,10453,615,533,1148,9,5,14,219,235,454,968,919,1887,48,43,91,465,443,908,8129,7761,15890,20392
20192020,008,BOONE,035,Boone County,"",---District Total---,035,"","",NKCES,905,KG,686,743,44,40,84,1,1,2,22,15,37,77,64,141,3,7,10,42,37,79,554,522,1076,1429
20192020,008,BOONE,035,Boone County,"",---District Total---,035,"","",NKCES,905,01,752,793,51,44,95,0,0,0,21,21,42,64,79,143,2,2,4,48,34,82,607,572,1179,1545
20192020,008,BOONE,035,Boone County,"",---District Total---,035,"","",NKCES,905,02,659,714,48,37,85,0,0,0,18,11,29,71,64,135,5,4,9,35,49,84,537,494,1031,1373
20192020,008,BOONE,035,Boone County,"",---District Total---,035,"","",NKCES,905,03,776,782,45,53,98,1,0,1,16,22,38,75,75,150,4,2,6,44,34,78,597,590,1187,1558
20192020,008,BOONE,035,Boone County,"",---District Total---,035,"","",NKCES,905,04,762,821,60,39,99,0,0,0,19,18,37,79,68,147,3,2,5,38,40,78,622,595,1217,1583
20192020,008,BOONE,035,Boone County,"",---District Total---,035,"","",NKCES,905,05,795,815,40,46,86,1,0,1,17,17,34,79,79,158,4,5,9,41,39,80,633,609,1242,1610
20192020,008,BOONE,035,Boone County,"",---District Total---,035,"","",NKCES,905,06,833,840,49,43,92,0,2,2,17,19,36,93,91,184,6,4,10,29,29,58,646,645,1291,1673
20192020,008,BOONE,035,Boone County,"",---District Total---,035,"","",NKCES,905,07,803,819,44,32,76,0,1,1,10,21,31,97,78,175,5,4,9,44,34,78,619,633,1252,1622
20192020,008,BOONE,035,Boone County,"",---District Total---,035,"","",NKCES,905,08,771,864,55,40,95,2,0,2,14,16,30,77,66,143,6,3,9,37,42,79,673,604,1277,1635
20192020,008,BOONE,035,Boone County,"",---District Total---,035,"","",NKCES,905,09,826,873,52,44,96,1,1,2,15,12,27,76,81,157,4,5,9,32,34,66,693,649,1342,1699
20192020,008,BOONE,035,Boone County,"",---District Total---,035,"","",NKCES,905,10,777,831,45,36,81,0,0,0,17,19,36,57,61,118,1,1,2,28,27,55,683,633,1316,1608
20192020,008,BOONE,035,Boone County,"",---District Total---,035,"","",NKCES,905,11,748,762,39,44,83,2,0,2,16,23,39,57,58,115,1,2,3,24,26,50,623,595,1218,1510
20192020,008,BOONE,035,Boone County,"",---District Total---,035,"","",NKCES,905,12,745,781,42,35,77,1,0,1,17,21,38,66,54,120,4,2,6,23,18,41,628,615,1243,1526
20192020,008,BOONE,035,Boone County,005,A M Yealey Elementary School,035005,008035005,210051000079,NKCES,905,04,39,49,3,3,6,0,0,0,1,1,2,5,3,8,1,0,1,3,2,5,36,30,66,88
20192020,008,BOONE,035,Boone County,005,A M Yealey Elementary School,035005,008035005,210051000079,NKCES,905,All Students,256,289,10,13,23,0,1,1,12,12,24,19,12,31,3,0,3,20,16,36,225,202,427,545
20192020,008,BOONE,035,Boone County,005,A M Yealey Elementary School,035005,008035005,210051000079,NKCES,905,PS,12,25,0,2,2,0,0,0,2,0,2,1,0,1,0,0,0,0,0,0,22,10,32,37
20192020,008,BOONE,035,Boone County,005,A M Yealey Elementary School,035005,008035005,210051000079,NKCES,905,KG,44,53,1,3,4,0,1,1,6,2,8,3,0,3,0,0,0,6,5,11,37,33,70,97
20192020,008,BOONE,035,Boone County,005,A M Yealey Elementary School,035005,008035005,210051000079,NKCES,905,01,40,44,1,4,5,0,0,0,0,4,4,4,2,6,0,0,0,2,1,3,37,29,66,84
20192020,008,BOONE,035,Boone County,005,A M Yealey Elementary School,035005,008035005,210051000079,NKCES,905,02,39,49,2,1,3,0,0,0,2,0,2,2,2,4,1,0,1,1,2,3,41,34,75,88
20192020,008,BOONE,035,Boone County,005,A M Yealey Elementary School,035005,008035005,210051000079,NKCES,905,03,47,45,1,1,2,0,0,0,2,2,4,3,2,5,0,0,0,6,2,8,33,40,73,92
20192020,008,BOONE,035,Boone County,005,A M Yealey Elementary School,035005,008035005,210051000079,NKCES,905,05,47,49,2,1,3,0,0,0,1,3,4,2,3,5,1,0,1,2,4,6,41,36,77,96
20192020,008,BOONE,035,Boone County,006,Erpenbeck Elementary School,035006,008035006,210051001710,NKCES,905,03,69,46,4,9,13,0,0,0,4,7,11,6,8,14,0,0,0,2,0,2,30,45,75,115
20192020,008,BOONE,035,Boone County,006,Erpenbeck Elementary School,035006,008035006,210051001710,NKCES,905,05,57,58,1,2,3,0,0,0,6,2,8,4,5,9,0,0,0,5,1,6,42,47,89,115
20192020,008,BOONE,035,Boone County,006,Erpenbeck Elementary School,035006,008035006,210051001710,NKCES,905,All Students,343,348,14,17,31,0,0,0,31,34,65,20,22,42,1,0,1,22,15,37,260,255,515,691
20192020,008,BOONE,035,Boone County,006,Erpenbeck Elementary School,035006,008035006,210051001710,NKCES,905,PS,10,26,2,1,3,0,0,0,1,0,1,0,1,1,0,0,0,0,0,0,23,8,31,36
20192020,008,BOONE,035,Boone County,006,Erpenbeck Elementary School,035006,008035006,210051001710,NKCES,905,KG,56,60,3,1,4,0,0,0,4,6,10,1,0,1,1,0,1,5,3,8,46,46,92,116
20192020,008,BOONE,035,Boone County,006,Erpenbeck Elementary School,035006,008035006,210051001710,NKCES,905,01,60,64,1,3,4,0,0,0,10,11,21,3,3,6,0,0,0,4,2,6,46,41,87,124
20192020,008,BOONE,035,Boone County,006,Erpenbeck Elementary School,035006,008035006,210051001710,NKCES,905,02,49,62,2,0,2,0,0,0,2,2,4,2,3,5,0,0,0,2,5,7,54,39,93,111
20192020,008,BOONE,035,Boone County,006,Erpenbeck Elementary School,035006,008035006,210051001710,NKCES,905,04,52,58,3,2,5,0,0,0,5,6,11,4,3,7,0,0,0,4,4,8,42,37,79,110
20192020,008,BOONE,035,Boone County,008,North Pointe Elementary School,035008,008035008,210051001883,NKCES,905,PS,7,23,2,0,2,0,0,0,1,0,1,2,1,3,0,0,0,0,1,1,18,5,23,30
20192020,008,BOONE,035,Boone County,008,North Pointe Elementary School,035008,008035008,210051001883,NKCES,905,04,42,52,5,0,5,0,0,0,2,2,4,2,4,6,0,1,1,0,3,3,43,32,75,94
20192020,008,BOONE,035,Boone County,008,North Pointe Elementary School,035008,008035008,210051001883,NKCES,905,All Students,214,241,15,7,22,0,0,0,9,5,14,7,22,29,1,2,3,6,8,14,203,170,373,455
20192020,008,BOONE,035,Boone County,008,North Pointe Elementary School,035008,008035008,210051001883,NKCES,905,05,35,39,2,2,4,0,0,0,2,0,2,0,2,2,0,0,0,4,2,6,31,29,60,74
20192020,008,BOONE,035,Boone County,008,North Pointe Elementary School,035008,008035008,210051001883,NKCES,905,01,26,50,2,0,2,0,0,0,1,1,2,1,4,5,0,0,0,0,0,0,46,21,67,76
20192020,008,BOONE,035,Boone County,008,North Pointe Elementary School,035008,008035008,210051001883,NKCES,905,03,41,38,2,2,4,0,0,0,3,1,4,0,5,5,0,0,0,0,0,0,33,33,66,79
20192020,008,BOONE,035,Boone County,008,North Pointe Elementary School,035008,008035008,210051001883,NKCES,905,02,34,37,3,2,5,0,0,0,0,0,0,2,1,3,1,1,2,1,1,2,30,29,59,71
20192020,008,BOONE,035,Boone County,008,North Pointe Elementary School,035008,008035008,210051001883,NKCES,905,KG,36,25,1,1,2,0,0,0,1,1,2,2,6,8,0,0,0,1,2,3,20,26,46,61
20192020,008,BOONE,035,Boone County,010,Camp Ernst Middle School,035010,008035010,210051001971,NKCES,905,All Students,400,395,30,13,43,1,1,2,6,1,7,23,27,50,3,2,5,20,20,40,312,336,648,795
20192020,008,BOONE,035,Boone County,010,Camp Ernst Middle School,035010,008035010,210051001971,NKCES,905,06,151,135,10,5,15,0,0,0,4,0,4,11,13,24,1,0,1,6,9,15,103,124,227,286
20192020,008,BOONE,035,Boone County,010,Camp Ernst Middle School,035010,008035010,210051001971,NKCES,905,07,137,126,9,5,14,0,1,1,0,1,1,8,6,14,1,2,3,10,5,15,98,117,215,263
20192020,008,BOONE,035,Boone County,010,Camp Ernst Middle School,035010,008035010,210051001971,NKCES,905,08,112,134,11,3,14,1,0,1,2,0,2,4,8,12,1,0,1,4,6,10,111,95,206,246
20192020,008,BOONE,035,Boone County,011,Shirley Mann Elementary School,035011,008035011,210051002022,NKCES,905,05,80,86,0,2,2,0,0,0,3,5,8,3,1,4,0,0,0,2,2,4,78,70,148,166
20192020,008,BOONE,035,Boone County,011,Shirley Mann Elementary School,035011,008035011,210051002022,NKCES,905,All Students,404,435,4,6,10,0,0,0,22,20,42,16,13,29,0,0,0,15,15,30,378,350,728,839
20192020,008,BOONE,035,Boone County,011,Shirley Mann Elementary School,035011,008035011,210051002022,NKCES,905,PS,17,25,2,1,3,0,0,0,2,0,2,4,3,7,0,0,0,0,0,0,17,13,30,42
20192020,008,BOONE,035,Boone County,011,Shirley Mann Elementary School,035011,008035011,210051002022,NKCES,905,KG,48,65,0,0,0,0,0,0,6,3,9,3,2,5,0,0,0,4,3,7,52,40,92,113
20192020,008,BOONE,035,Boone County,011,Shirley Mann Elementary School,035011,008035011,210051002022,NKCES,905,01,71,68,2,0,2,0,0,0,2,0,2,1,4,5,0,0,0,5,1,6,58,66,124,139
20192020,008,BOONE,035,Boone County,011,Shirley Mann Elementary School,035011,008035011,210051002022,NKCES,905,02,56,71,0,2,2,0,0,0,4,4,8,4,2,6,0,0,0,1,2,3,62,46,108,127
20192020,008,BOONE,035,Boone County,011,Shirley Mann Elementary School,035011,008035011,210051002022,NKCES,905,03,68,66,1,1,2,0,0,0,2,5,7,1,0,1,0,0,0,2,3,5,60,59,119,134
20192020,008,BOONE,035,Boone County,011,Shirley Mann Elementary School,035011,008035011,210051002022,NKCES,905,04,81,79,1,1,2,0,0,0,5,3,8,4,4,8,0,0,0,1,4,5,68,69,137,160
20192020,008,BOONE,035,Boone County,012,Thornwilde Elementary School,035012,008035012,210051002290,NKCES,905,04,68,39,2,4,6,0,0,0,0,1,1,2,2,4,0,0,0,1,7,8,34,54,88,107
20192020,008,BOONE,035,Boone County,012,Thornwilde Elementary School,035012,008035012,210051002290,NKCES,905,All Students,333,330,19,18,37,0,0,0,1,5,6,20,14,34,0,0,0,21,22,43,269,274,543,663
20192020,008,BOONE,035,Boone County,012,Thornwilde Elementary School,035012,008035012,210051002290,NKCES,905,PS,14,21,3,3,6,0,0,0,0,1,1,0,1,1,0,0,0,2,0,2,16,9,25,35
20192020,008,BOONE,035,Boone County,012,Thornwilde Elementary School,035012,008035012,210051002290,NKCES,905,KG,41,55,0,1,1,0,0,0,0,0,0,6,2,8,0,0,0,1,3,4,48,35,83,96
20192020,008,BOONE,035,Boone County,012,Thornwilde Elementary School,035012,008035012,210051002290,NKCES,905,01,61,57,3,3,6,0,0,0,0,1,1,2,6,8,0,0,0,6,6,12,46,45,91,118
20192020,008,BOONE,035,Boone County,012,Thornwilde Elementary School,035012,008035012,210051002290,NKCES,905,02,45,61,9,1,10,0,0,0,1,1,2,6,1,7,0,0,0,4,1,5,41,41,82,106
20192020,008,BOONE,035,Boone County,012,Thornwilde Elementary School,035012,008035012,210051002290,NKCES,905,03,59,67,2,4,6,0,0,0,0,1,1,2,1,3,0,0,0,5,4,9,58,49,107,126
20192020,008,BOONE,035,Boone County,012,Thornwilde Elementary School,035012,008035012,210051002290,NKCES,905,05,59,51,3,5,8,0,0,0,0,1,1,2,2,4,0,0,0,4,1,5,42,50,92,110
20192020,008,BOONE,035,Boone County,015,Randall K. Cooper High School,035015,008035015,210051002206,NKCES,905,12,136,153,10,6,16,0,0,0,5,3,8,8,3,11,2,0,2,2,0,2,126,124,250,289
20192020,008,BOONE,035,Boone County,015,Randall K. Cooper High School,035015,008035015,210051002206,NKCES,905,All Students,650,709,35,29,64,1,1,2,11,14,25,23,20,43,4,0,4,20,21,41,615,565,1180,1359
20192020,008,BOONE,035,Boone County,015,Randall K. Cooper High School,035015,008035015,210051002206,NKCES,905,07,1,0,0,0,0,0,0,0,0,0,0,0,0,0,0,0,0,0,0,0,0,1,1,1
20192020,008,BOONE,035,Boone County,015,Randall K. Cooper High School,035015,008035015,210051002206,NKCES,905,08,1,4,0,0,0,0,0,0,0,0,0,0,0,0,0,0,0,0,0,0,4,1,5,5
20192020,008,BOONE,035,Boone County,015,Randall K. Cooper High School,035015,008035015,210051002206,NKCES,905,09,177,196,8,9,17,0,1,1,2,4,6,10,5,15,1,0,1,7,7,14,168,151,319,373
20192020,008,BOONE,035,Boone County,015,Randall K. Cooper High School,035015,008035015,210051002206,NKCES,905,10,167,186,10,9,19,0,0,0,2,3,5,2,7,9,0,0,0,6,6,12,166,142,308,353
20192020,008,BOONE,035,Boone County,015,Randall K. Cooper High School,035015,008035015,210051002206,NKCES,905,11,166,166,7,5,12,1,0,1,2,4,6,3,5,8,1,0,1,5,8,13,147,144,291,332
20192020,008,BOONE,035,Boone County,015,Randall K. Cooper High School,035015,008035015,210051002206,NKCES,905,14,2,4,0,0,0,0,0,0,0,0,0,0,0,0,0,0,0,0,0,0,4,2,6,6
20192020,008,BOONE,035,Boone County,017,Longbranch Elementary School,035017,008035017,210051002245,NKCES,905,04,83,73,1,2,3,0,0,0,2,0,2,1,7,8,0,0,0,3,4,7,66,70,136,156
20192020,008,BOONE,035,Boone County,017,Longbranch Elementary School,035017,008035017,210051002245,NKCES,905,All Students,447,418,11,14,25,0,0,0,9,5,14,18,22,40,0,3,3,26,30,56,354,373,727,865
20192020,008,BOONE,035,Boone County,017,Longbranch Elementary School,035017,008035017,210051002245,NKCES,905,PS,11,36,1,0,1,0,0,0,1,0,1,0,1,1,0,0,0,5,1,6,29,9,38,47
20192020,008,BOONE,035,Boone County,017,Longbranch Elementary School,035017,008035017,210051002245,NKCES,905,KG,71,76,3,1,4,0,0,0,2,0,2,5,4,9,0,1,1,4,2,6,62,63,125,147
20192020,008,BOONE,035,Boone County,017,Longbranch Elementary School,035017,008035017,210051002245,NKCES,905,01,77,75,3,2,5,0,0,0,2,2,4,3,5,8,0,0,0,8,4,12,59,64,123,152
20192020,008,BOONE,035,Boone County,017,Longbranch Elementary School,035017,008035017,210051002245,NKCES,905,02,64,53,2,3,5,0,0,0,1,1,2,3,3,6,0,1,1,3,11,14,44,45,89,117
20192020,008,BOONE,035,Boone County,017,Longbranch Elementary School,035017,008035017,210051002245,NKCES,905,03,77,67,0,5,5,0,0,0,2,0,2,3,1,4,0,0,0,4,4,8,58,67,125,144
20192020,008,BOONE,035,Boone County,017,Longbranch Elementary School,035017,008035017,210051002245,NKCES,905,05,75,74,2,1,3,0,0,0,0,2,2,3,2,5,0,1,1,4,5,9,65,64,129,149
20192020,008,BOONE,035,Boone County,020,Rector A. Jones Middle School,035020,008035020,210051000080,NKCES,905,07,122,148,20,14,34,0,0,0,2,2,4,48,36,84,2,1,3,9,7,16,67,62,129,270
20192020,008,BOONE,035,Boone County,020,Rector A. Jones Middle School,035020,008035020,210051000080,NKCES,905,All Students,371,402,60,51,111,0,0,0,3,4,7,121,110,231,8,4,12,19,20,39,191,182,373,773
20192020,008,BOONE,035,Boone County,020,Rector A. Jones Middle School,035020,008035020,210051000080,NKCES,905,06,128,128,16,17,33,0,0,0,1,2,3,45,39,84,3,2,5,3,5,8,60,63,123,256
20192020,008,BOONE,035,Boone County,020,Rector A. Jones Middle School,035020,008035020,210051000080,NKCES,905,08,121,126,24,20,44,0,0,0,0,0,0,28,35,63,3,1,4,7,8,15,64,57,121,247
20192020,008,BOONE,035,Boone County,025,Ballyshannon Middle School,035025,008035025,210051002460,NKCES,905,07,117,92,3,5,8,0,0,0,0,2,2,6,2,8,0,0,0,7,5,12,76,103,179,209
20192020,008,BOONE,035,Boone County,025,Ballyshannon Middle School,035025,008035025,210051002460,NKCES,905,All Students,345,306,9,13,22,0,0,0,4,8,12,16,9,25,0,0,0,16,17,33,261,298,559,651
20192020,008,BOONE,035,Boone County,025,Ballyshannon Middle School,035025,008035025,210051002460,NKCES,905,06,112,112,3,6,9,0,0,0,2,3,5,4,4,8,0,0,0,4,2,6,99,97,196,224
20192020,008,BOONE,035,Boone County,025,Ballyshannon Middle School,035025,008035025,210051002460,NKCES,905,08,116,102,3,2,5,0,0,0,2,3,5,6,3,9,0,0,0,5,10,15,86,98,184,218
20192020,008,BOONE,035,Boone County,030,Boone County High School,035030,008035030,210051000081,NKCES,905,11,147,167,17,16,33,0,0,0,7,4,11,18,22,40,0,1,1,6,6,12,119,98,217,314
20192020,008,BOONE,035,Boone County,030,Boone County High School,035030,008035030,210051000081,NKCES,905,All Students,654,710,72,62,134,0,0,0,14,9,23,86,94,180,3,6,9,34,29,63,501,454,955,1364
20192020,008,BOONE,035,Boone County,030,Boone County High School,035030,008035030,210051000081,NKCES,905,09,174,203,21,18,39,0,0,0,2,0,2,23,27,50,2,2,4,13,9,22,142,118,260,377
20192020,008,BOONE,035,Boone County,030,Boone County High School,035030,008035030,210051000081,NKCES,905,10,166,167,18,12,30,0,0,0,2,1,3,20,21,41,0,1,1,9,9,18,118,122,240,333
20192020,008,BOONE,035,Boone County,030,Boone County High School,035030,008035030,210051000081,NKCES,905,12,166,165,15,16,31,0,0,0,3,4,7,25,24,49,1,2,3,6,5,11,115,115,230,331
20192020,008,BOONE,035,Boone County,030,Boone County High School,035030,008035030,210051000081,NKCES,905,14,1,8,1,0,1,0,0,0,0,0,0,0,0,0,0,0,0,0,0,0,7,1,8,9
20192020,008,BOONE,035,Boone County,040,Burlington Elementary School,035040,008035040,210051000082,NKCES,905,05,65,74,4,6,10,1,0,1,0,1,1,3,2,5,0,2,2,0,2,2,66,52,118,139
20192020,008,BOONE,035,Boone County,040,Burlington Elementary School,035040,008035040,210051000082,NKCES,905,All Students,376,352,23,23,46,2,0,2,1,2,3,14,15,29,1,2,3,21,25,46,290,309,599,728
20192020,008,BOONE,035,Boone County,040,Burlington Elementary School,035040,008035040,210051000082,NKCES,905,PS,26,37,3,2,5,0,0,0,0,0,0,2,1,3,0,0,0,1,2,3,31,21,52,63
20192020,008,BOONE,035,Boone County,040,Burlington Elementary School,035040,008035040,210051000082,NKCES,905,KG,54,56,1,3,4,0,0,0,0,0,0,1,3,4,0,0,0,4,4,8,50,44,94,110
20192020,008,BOONE,035,Boone County,040,Burlington Elementary School,035040,008035040,210051000082,NKCES,905,01,57,55,2,5,7,0,0,0,0,0,0,3,2,5,0,0,0,3,3,6,47,47,94,112
20192020,008,BOONE,035,Boone County,040,Burlington Elementary School,035040,008035040,210051000082,NKCES,905,02,61,47,4,2,6,0,0,0,1,0,1,1,3,4,1,0,1,6,7,13,34,49,83,108
20192020,008,BOONE,035,Boone County,040,Burlington Elementary School,035040,008035040,210051000082,NKCES,905,03,62,58,3,4,7,1,0,1,0,1,1,3,3,6,0,0,0,4,5,9,47,49,96,120
20192020,008,BOONE,035,Boone County,040,Burlington Elementary School,035040,008035040,210051000082,NKCES,905,04,77,62,9,3,12,0,0,0,0,0,0,3,2,5,0,0,0,4,4,8,46,68,114,139
20192020,008,BOONE,035,Boone County,041,Charles H. Kelly Elementary School,035041,008035041,210051001519,NKCES,905,04,21,25,0,0,0,0,0,0,0,0,0,0,0,0,0,0,0,1,0,1,24,21,45,46
20192020,008,BOONE,035,Boone County,041,Charles H. Kelly Elementary School,035041,008035041,210051001519,NKCES,905,All Students,105,121,0,2,2,0,0,0,0,0,0,4,4,8,0,0,0,3,1,4,114,98,212,226
20192020,008,BOONE,035,Boone County,041,Charles H. Kelly Elementary School,035041,008035041,210051001519,NKCES,905,KG,12,18,0,0,0,0,0,0,0,0,0,0,0,0,0,0,0,1,0,1,17,12,29,30
20192020,008,BOONE,035,Boone County,041,Charles H. Kelly Elementary School,035041,008035041,210051001519,NKCES,905,01,17,24,0,0,0,0,0,0,0,0,0,0,1,1,0,0,0,0,0,0,24,16,40,41
20192020,008,BOONE,035,Boone County,041,Charles H. Kelly Elementary School,035041,008035041,210051001519,NKCES,905,02,14,16,0,1,1,0,0,0,0,0,0,1,0,1,0,0,0,0,1,1,15,12,27,30
20192020,008,BOONE,035,Boone County,041,Charles H. Kelly Elementary School,035041,008035041,210051001519,NKCES,905,03,16,20,0,0,0,0,0,0,0,0,0,2,0,2,0,0,0,0,0,0,18,16,34,36
20192020,008,BOONE,035,Boone County,041,Charles H. Kelly Elementary School,035041,008035041,210051001519,NKCES,905,05,25,18,0,1,1,0,0,0,0,0,0,1,3,4,0,0,0,1,0,1,16,21,37,43
20192020,008,BOONE,035,Boone County,043,Conner Middle School,035043,008035043,210051000083,NKCES,905,07,153,145,3,4,7,0,0,0,1,5,6,8,10,18,0,0,0,7,10,17,126,124,250,298
20192020,008,BOONE,035,Boone County,043,Conner Middle School,035043,008035043,210051000083,NKCES,905,All Students,466,464,15,15,30,0,0,0,5,11,16,30,26,56,0,1,1,15,24,39,399,389,788,930
20192020,008,BOONE,035,Boone County,043,Conner Middle School,035043,008035043,210051000083,NKCES,905,06,158,155,4,5,9,0,0,0,2,3,5,10,11,21,0,1,1,3,6,9,136,132,268,313
20192020,008,BOONE,035,Boone County,043,Conner Middle School,035043,008035043,210051000083,NKCES,905,08,155,164,8,6,14,0,0,0,2,3,5,12,5,17,0,0,0,5,8,13,137,133,270,319
20192020,008,BOONE,035,Boone County,045,Conner High School,035045,008035045,210051000084,NKCES,905,12,165,157,2,4,6,1,0,1,4,2,6,5,5,10,1,0,1,6,5,11,138,149,287,322
20192020,008,BOONE,035,Boone County,045,Conner High School,035045,008035045,210051000084,NKCES,905,All Students,734,723,25,18,43,1,0,1,17,16,33,27,29,56,2,2,4,20,15,35,631,654,1285,1457
20192020,008,BOONE,035,Boone County,045,Conner High School,035045,008035045,210051000084,NKCES,905,08,10,5,0,1,1,0,0,0,0,0,0,0,0,0,0,0,0,0,0,0,5,9,14,15
20192020,008,BOONE,035,Boone County,045,Conner High School,035045,008035045,210051000084,NKCES,905,09,192,190,7,3,10,0,0,0,8,6,14,8,11,19,0,1,1,5,6,11,162,165,327,382
20192020,008,BOONE,035,Boone County,045,Conner High School,035045,008035045,210051000084,NKCES,905,10,176,191,8,4,12,0,0,0,2,3,5,5,10,15,1,0,1,5,1,6,170,158,328,367
20192020,008,BOONE,035,Boone County,045,Conner High School,035045,008035045,210051000084,NKCES,905,11,189,178,8,6,14,0,0,0,3,5,8,9,2,11,0,1,1,4,3,7,154,172,326,367
20192020,008,BOONE,035,Boone County,045,Conner High School,035045,008035045,210051000084,NKCES,905,14,2,2,0,0,0,0,0,0,0,0,0,0,1,1,0,0,0,0,0,0,2,1,3,4
20192020,008,BOONE,035,Boone County,050,Florence Elementary School,035050,008035050,210051000085,NKCES,905,04,40,36,9,6,15,0,0,0,0,1,1,5,9,14,1,1,2,2,3,5,19,20,39,76
20192020,008,BOONE,035,Boone County,050,Florence Elementary School,035050,008035050,210051000085,NKCES,905,05,43,46,5,6,11,0,0,0,2,0,2,11,9,20,2,0,2,3,2,5,23,26,49,89
20192020,008,BOONE,035,Boone County,050,Florence Elementary School,035050,008035050,210051000085,NKCES,905,All Students,252,277,56,42,98,0,0,0,4,3,7,55,54,109,11,8,19,15,17,32,136,128,264,529
20192020,008,BOONE,035,Boone County,050,Florence Elementary School,035050,008035050,210051000085,NKCES,905,PS,41,46,7,15,22,0,0,0,1,0,1,5,2,7,0,0,0,5,3,8,28,21,49,87
20192020,008,BOONE,035,Boone County,050,Florence Elementary School,035050,008035050,210051000085,NKCES,905,KG,42,59,11,12,23,0,0,0,1,1,2,13,9,22,1,4,5,4,0,4,29,16,45,101
20192020,008,BOONE,035,Boone County,050,Florence Elementary School,035050,008035050,210051000085,NKCES,905,01,36,51,15,5,20,0,0,0,0,0,0,5,5,10,2,0,2,3,5,8,26,21,47,87
20192020,008,BOONE,035,Boone County,050,Florence Elementary School,035050,008035050,210051000085,NKCES,905,02,44,37,6,7,13,0,0,0,1,0,1,8,10,18,2,1,3,2,4,6,18,22,40,81
20192020,008,BOONE,035,Boone County,050,Florence Elementary School,035050,008035050,210051000085,NKCES,905,03,47,48,10,6,16,0,0,0,0,1,1,13,12,25,3,2,5,1,3,4,21,23,44,95
20192020,008,BOONE,035,Boone County,055,Chester Goodridge Elementary School,035055,008035055,210051000086,NKCES,905,04,50,54,3,4,7,0,0,0,0,0,0,3,2,5,0,0,0,4,1,5,44,43,87,104
20192020,008,BOONE,035,Boone County,055,Chester Goodridge Elementary School,035055,008035055,210051000086,NKCES,905,02,44,45,1,0,1,0,0,0,1,0,1,4,4,8,0,0,0,2,2,4,37,38,75,89
20192020,008,BOONE,035,Boone County,055,Chester Goodridge Elementary School,035055,008035055,210051000086,NKCES,905,All Students,327,341,11,10,21,0,0,0,2,1,3,22,22,44,1,1,2,18,17,35,287,276,563,668
20192020,008,BOONE,035,Boone County,055,Chester Goodridge Elementary School,035055,008035055,210051000086,NKCES,905,PS,16,24,1,1,2,0,0,0,0,0,0,1,1,2,0,0,0,0,1,1,22,13,35,40
20192020,008,BOONE,035,Boone County,055,Chester Goodridge Elementary School,035055,008035055,210051000086,NKCES,905,KG,56,57,2,0,2,0,0,0,0,0,0,5,2,7,0,1,1,3,1,4,47,52,99,113
20192020,008,BOONE,035,Boone County,055,Chester Goodridge Elementary School,035055,008035055,210051000086,NKCES,905,01,51,55,0,3,3,0,0,0,0,0,0,3,5,8,0,0,0,4,3,7,48,40,88,106
20192020,008,BOONE,035,Boone County,055,Chester Goodridge Elementary School,035055,008035055,210051000086,NKCES,905,05,70,58,1,2,3,0,0,0,1,1,2,4,5,9,1,0,1,2,5,7,49,57,106,128
20192020,008,BOONE,035,Boone County,055,Chester Goodridge Elementary School,035055,008035055,210051000086,NKCES,905,03,56,72,4,1,5,0,0,0,0,0,0,3,4,7,0,0,0,3,5,8,62,46,108,128
20192020,008,BOONE,035,Boone County,065,Hillard Collins Elementary School,035065,008035065,210051001608,NKCES,905,All Students,364,401,67,73,140,1,0,1,4,2,6,113,100,213,0,0,0,37,26,63,179,163,342,765
20192020,008,BOONE,035,Boone County,065,Hillard Collins Elementary School,035065,008035065,210051001608,NKCES,905,PS,24,26,4,3,7,0,0,0,0,0,0,9,8,17,0,0,0,2,3,5,11,10,21,50
20192020,008,BOONE,035,Boone County,065,Hillard Collins Elementary School,035065,008035065,210051001608,NKCES,905,KG,65,58,14,13,27,1,0,1,0,1,1,15,14,29,0,0,0,4,7,11,24,30,54,123
20192020,008,BOONE,035,Boone County,065,Hillard Collins Elementary School,035065,008035065,210051001608,NKCES,905,01,64,70,12,11,23,0,0,0,1,0,1,19,17,36,0,0,0,6,3,9,32,33,65,134
20192020,008,BOONE,035,Boone County,065,Hillard Collins Elementary School,035065,008035065,210051001608,NKCES,905,02,59,56,7,14,21,0,0,0,0,0,0,19,13,32,0,0,0,3,4,7,27,28,55,115
20192020,008,BOONE,035,Boone County,065,Hillard Collins Elementary School,035065,008035065,210051001608,NKCES,905,03,64,70,10,14,24,0,0,0,0,0,0,14,20,34,0,0,0,12,4,16,34,26,60,134
20192020,008,BOONE,035,Boone County,065,Hillard Collins Elementary School,035065,008035065,210051001608,NKCES,905,04,53,76,11,9,20,0,0,0,2,1,3,24,16,40,0,0,0,5,2,7,34,25,59,129
20192020,008,BOONE,035,Boone County,065,Hillard Collins Elementary School,035065,008035065,210051001608,NKCES,905,05,59,71,13,12,25,0,0,0,1,0,1,22,20,42,0,0,0,7,6,13,28,21,49,130
20192020,008,BOONE,035,Boone County,071,Larry A. Ryle High School,035071,008035071,210051000011,NKCES,905,12,225,202,10,9,19,0,0,0,4,12,16,19,19,38,0,0,0,6,7,13,163,178,341,427
20192020,008,BOONE,035,Boone County,071,Larry A. Ryle High School,035071,008035071,210051000011,NKCES,905,14,1,1,0,0,0,0,0,0,0,0,0,0,0,0,0,0,0,0,0,0,1,1,2,2
20192020,008,BOONE,035,Boone County,071,Larry A. Ryle High School,035071,008035071,210051000011,NKCES,905,All Students,979,947,37,50,87,2,0,2,22,36,58,107,105,212,1,1,2,28,36,64,750,751,1501,1926
20192020,008,BOONE,035,Boone County,071,Larry A. Ryle High School,035071,008035071,210051000011,NKCES,905,09,271,260,14,14,28,1,0,1,3,2,5,34,38,72,1,1,2,7,10,17,200,206,406,531
20192020,008,BOONE,035,Boone County,071,Larry A. Ryle High School,035071,008035071,210051000011,NKCES,905,10,254,262,7,11,18,0,0,0,11,12,23,29,22,51,0,0,0,7,11,18,208,198,406,516
20192020,008,BOONE,035,Boone County,071,Larry A. Ryle High School,035071,008035071,210051000011,NKCES,905,11,228,222,6,16,22,1,0,1,4,10,14,25,26,51,0,0,0,8,8,16,178,168,346,450
20192020,008,BOONE,035,Boone County,075,Gray Middle School,035075,008035075,210051000638,NKCES,905,06,165,182,3,4,7,0,2,2,3,9,12,13,12,25,0,1,1,7,5,12,156,132,288,347
20192020,008,BOONE,035,Boone County,075,Gray Middle School,035075,008035075,210051000638,NKCES,905,08,159,187,4,2,6,0,0,0,4,5,9,16,8,24,1,1,2,4,5,9,158,138,296,346
20192020,008,BOONE,035,Boone County,075,Gray Middle School,035075,008035075,210051000638,NKCES,905,All Students,499,554,9,6,15,0,2,2,11,18,29,44,34,78,1,3,4,15,14,29,474,422,896,1053
20192020,008,BOONE,035,Boone County,075,Gray Middle School,035075,008035075,210051000638,NKCES,905,07,175,185,2,0,2,0,0,0,4,4,8,15,14,29,0,1,1,4,4,8,160,152,312,360
20192020,008,BOONE,035,Boone County,080,New Haven Elementary School,035080,008035080,210051000088,NKCES,905,03,70,76,0,3,3,0,0,0,2,2,4,7,3,10,0,0,0,1,1,2,66,61,127,146
20192020,008,BOONE,035,Boone County,080,New Haven Elementary School,035080,008035080,210051000088,NKCES,905,05,71,89,1,4,5,0,0,0,0,2,2,2,4,6,0,0,0,5,3,8,81,58,139,160
20192020,008,BOONE,035,Boone County,080,New Haven Elementary School,035080,008035080,210051000088,NKCES,905,All Students,403,477,7,9,16,0,0,0,11,10,21,33,24,57,0,0,0,17,11,28,409,349,758,880
20192020,008,BOONE,035,Boone County,080,New Haven Elementary School,035080,008035080,210051000088,NKCES,905,PS,15,27,1,0,1,0,0,0,0,0,0,4,2,6,0,0,0,1,0,1,21,13,34,42
20192020,008,BOONE,035,Boone County,080,New Haven Elementary School,035080,008035080,210051000088,NKCES,905,KG,49,62,0,0,0,0,0,0,1,0,1,5,1,6,0,0,0,3,1,4,53,47,100,111
20192020,008,BOONE,035,Boone County,080,New Haven Elementary School,035080,008035080,210051000088,NKCES,905,01,81,81,1,2,3,0,0,0,4,1,5,8,5,13,0,0,0,1,2,3,67,71,138,162
20192020,008,BOONE,035,Boone County,080,New Haven Elementary School,035080,008035080,210051000088,NKCES,905,02,63,69,1,0,1,0,0,0,2,2,4,1,6,7,0,0,0,5,2,7,60,53,113,132
20192020,008,BOONE,035,Boone County,080,New Haven Elementary School,035080,008035080,210051000088,NKCES,905,04,69,100,4,0,4,0,0,0,2,3,5,10,5,15,0,0,0,2,2,4,82,59,141,169
20192020,008,BOONE,035,Boone County,081,Ockerman Elementary School,035081,008035081,210051000089,NKCES,905,03,66,52,5,3,8,0,0,0,0,1,1,14,15,29,1,0,1,0,0,0,32,47,79,118
20192020,008,BOONE,035,Boone County,081,Ockerman Elementary School,035081,008035081,210051000089,NKCES,905,05,65,58,6,2,8,0,0,0,1,0,1,19,17,36,0,2,2,1,5,6,31,39,70,123
20192020,008,BOONE,035,Boone County,081,Ockerman Elementary School,035081,008035081,210051000089,NKCES,905,All Students,349,353,37,20,57,0,0,0,5,4,9,83,85,168,2,4,6,9,16,25,217,220,437,702
20192020,008,BOONE,035,Boone County,081,Ockerman Elementary School,035081,008035081,210051000089,NKCES,905,PS,18,24,2,0,2,0,0,0,0,1,1,5,5,10,0,0,0,1,0,1,16,12,28,42
20192020,008,BOONE,035,Boone County,081,Ockerman Elementary School,035081,008035081,210051000089,NKCES,905,KG,69,57,7,4,11,0,0,0,0,1,1,13,17,30,0,1,1,1,4,5,36,42,78,126
20192020,008,BOONE,035,Boone County,081,Ockerman Elementary School,035081,008035081,210051000089,NKCES,905,01,60,56,6,3,9,0,0,0,1,1,2,8,15,23,0,0,0,1,1,2,40,40,80,116
20192020,008,BOONE,035,Boone County,081,Ockerman Elementary School,035081,008035081,210051000089,NKCES,905,02,55,65,8,4,12,0,0,0,3,1,4,15,14,29,0,1,1,2,4,6,37,31,68,120
20192020,008,BOONE,035,Boone County,081,Ockerman Elementary School,035081,008035081,210051000089,NKCES,905,04,34,65,5,4,9,0,0,0,0,0,0,14,7,21,1,0,1,4,2,6,41,21,62,99
20192020,008,BOONE,035,Boone County,083,Stephens Elementary School,035083,008035083,210051001695,NKCES,905,03,34,57,3,0,3,0,0,0,1,1,2,4,1,5,0,0,0,4,3,7,45,29,74,91
20192020,008,BOONE,035,Boone County,083,Stephens Elementary School,035083,008035083,210051001695,NKCES,905,05,44,44,0,0,0,0,0,0,0,0,0,3,4,7,0,0,0,1,1,2,40,39,79,88
20192020,008,BOONE,035,Boone County,083,Stephens Elementary School,035083,008035083,210051001695,NKCES,905,All Students,257,285,14,5,19,0,0,0,2,1,3,21,20,41,1,2,3,18,14,32,229,215,444,542
20192020,008,BOONE,035,Boone County,083,Stephens Elementary School,035083,008035083,210051001695,NKCES,905,PS,17,31,1,1,2,1,0,1,0,1,1,2,0,2,0,0,0,0,0,0,27,15,42,48
20192020,008,BOONE,035,Boone County,083,Stephens Elementary School,035083,008035083,210051001695,NKCES,905,KG,43,42,1,1,2,0,0,0,1,0,1,5,4,9,1,0,1,1,2,3,33,36,69,85
20192020,008,BOONE,035,Boone County,083,Stephens Elementary School,035083,008035083,210051001695,NKCES,905,01,51,43,3,3,6,0,0,0,0,0,0,4,5,9,0,2,2,5,3,8,31,38,69,94
20192020,008,BOONE,035,Boone County,083,Stephens Elementary School,035083,008035083,210051001695,NKCES,905,02,32,46,3,0,3,0,0,0,0,0,0,3,2,5,0,0,0,3,3,6,37,27,64,78
20192020,008,BOONE,035,Boone County,083,Stephens Elementary School,035083,008035083,210051001695,NKCES,905,04,53,53,4,1,5,0,0,0,0,0,0,2,4,6,0,0,0,4,2,6,43,46,89,106
20192020,008,BOONE,035,Boone County,085,Ockerman Middle School,035085,008035085,210051000090,NKCES,905,06,119,123,12,6,18,0,0,0,5,2,7,9,12,21,2,0,2,6,2,8,89,97,186,242
20192020,008,BOONE,035,Boone County,085,Ockerman Middle School,035085,008035085,210051000090,NKCES,905,08,93,129,4,6,10,1,0,1,4,5,9,10,7,17,1,1,2,9,4,13,100,70,170,222
20192020,008,BOONE,035,Boone County,085,Ockerman Middle School,035085,008035085,210051000090,NKCES,905,All Students,309,370,22,16,38,1,0,1,12,14,26,31,29,60,5,1,6,22,9,31,277,240,517,679
20192020,008,BOONE,035,Boone County,085,Ockerman Middle School,035085,008035085,210051000090,NKCES,905,07,97,118,6,4,10,0,0,0,3,7,10,12,10,22,2,0,2,7,3,10,88,73,161,215
20192020,008,BOONE,035,Boone County,170,Boone County Alternative Center,035170,008035170,210051002266,NKCES,905,07,1,5,1,0,1,0,0,0,0,0,0,0,0,0,0,0,0,0,0,0,4,1,5,6
20192020,008,BOONE,035,Boone County,170,Boone County Alternative Center,035170,008035170,210051002266,NKCES,905,All Students,102,205,13,1,14,0,0,0,1,0,1,15,7,22,0,1,1,8,5,13,168,88,256,307
20192020,008,BOONE,035,Boone County,170,Boone County Alternative Center,035170,008035170,210051002266,NKCES,905,06,0,5,1,0,1,0,0,0,0,0,0,1,0,1,0,0,0,0,0,0,3,0,3,5
20192020,008,BOONE,035,Boone County,170,Boone County Alternative Center,035170,008035170,210051002266,NKCES,905,08,4,13,1,0,1,0,0,0,0,0,0,1,0,1,0,0,0,3,1,4,8,3,11,17
20192020,008,BOONE,035,Boone County,170,Boone County Alternative Center,035170,008035170,210051002266,NKCES,905,09,12,24,2,0,2,0,0,0,0,0,0,1,0,1,0,1,1,0,2,2,21,9,30,36
20192020,008,BOONE,035,Boone County,170,Boone County Alternative Center,035170,008035170,210051002266,NKCES,905,10,14,25,2,0,2,0,0,0,0,0,0,1,1,2,0,0,0,1,0,1,21,13,34,39
20192020,008,BOONE,035,Boone County,170,Boone County Alternative Center,035170,008035170,210051002266,NKCES,905,11,18,29,1,1,2,0,0,0,0,0,0,2,3,5,0,0,0,1,1,2,25,13,38,47
20192020,008,BOONE,035,Boone County,170,Boone County Alternative Center,035170,008035170,210051002266,NKCES,905,12,53,104,5,0,5,0,0,0,1,0,1,9,3,12,0,0,0,3,1,4,86,49,135,157
20192020,009,BOURBON,041,Bourbon County,"",---District Total---,041,"","",CKEC,901,All Students,1237,1383,50,27,77,0,1,1,2,4,6,236,178,414,0,0,0,53,39,92,1042,988,2030,2620
20192020,009,BOURBON,041,Bourbon County,"",---District Total---,041,"","",CKEC,901,PS,132,147,15,13,28,0,0,0,0,0,0,18,23,41,0,0,0,7,11,18,107,85,192,279
20192020,009,BOURBON,041,Bourbon County,"",---District Total---,041,"","",CKEC,901,KG,75,97,4,5,9,0,1,1,1,1,2,15,12,27,0,0,0,2,4,6,75,52,127,172
20192020,009,BOURBON,041,Bourbon County,"",---District Total---,041,"","",CKEC,901,01,98,106,1,2,3,0,0,0,0,0,0,16,11,27,0,0,0,3,4,7,86,81,167,204
20192020,009,BOURBON,041,Bourbon County,"",---District Total---,041,"","",CKEC,901,02,80,112,6,2,8,0,0,0,0,0,0,15,11,26,0,0,0,7,6,13,84,61,145,192
20192020,009,BOURBON,041,Bourbon County,"",---District Total---,041,"","",CKEC,901,03,91,118,1,2,3,0,0,0,0,0,0,21,18,39,0,0,0,7,0,7,89,71,160,209
20192020,009,BOURBON,041,Bourbon County,"",---District Total---,041,"","",CKEC,901,04,93,112,3,0,3,0,0,0,0,0,0,20,13,33,0,0,0,5,3,8,84,77,161,205
20192020,009,BOURBON,041,Bourbon County,"",---District Total---,041,"","",CKEC,901,05,89,110,1,2,3,0,0,0,0,0,0,18,17,35,0,0,0,6,3,9,85,67,152,199
20192020,009,BOURBON,041,Bourbon County,"",---District Total---,041,"","",CKEC,901,06,105,110,5,4,9,0,0,0,0,1,1,25,12,37,0,0,0,9,5,14,71,83,154,215
20192020,009,BOURBON,041,Bourbon County,"",---District Total---,041,"","",CKEC,901,07,108,103,3,1,4,0,0,0,0,0,0,23,16,39,0,0,0,3,6,9,74,85,159,211
20192020,009,BOURBON,041,Bourbon County,"",---District Total---,041,"","",CKEC,901,08,112,102,4,0,4,0,0,0,0,0,0,17,18,35,0,0,0,2,3,5,79,91,170,214
20192020,009,BOURBON,041,Bourbon County,"",---District Total---,041,"","",CKEC,901,09,106,129,6,2,8,0,0,0,1,0,1,29,18,47,0,0,0,0,1,1,93,85,178,235
20192020,009,BOURBON,041,Bourbon County,"",---District Total---,041,"","",CKEC,901,10,111,97,2,4,6,0,0,0,0,2,2,11,13,24,0,0,0,2,2,4,82,90,172,208
20192020,009,BOURBON,041,Bourbon County,"",---District Total---,041,"","",CKEC,901,11,77,91,3,2,5,0,0,0,0,0,0,14,8,22,0,0,0,5,0,5,69,67,136,168
20192020,009,BOURBON,041,Bourbon County,"",---District Total---,041,"","",CKEC,901,12,92,96,11,1,12,0,0,0,0,0,0,12,11,23,0,0,0,2,2,4,71,78,149,188
20192020,009,BOURBON,041,Bourbon County,010,Bourbon Central Elementary School,041010,009041010,210054001576,CKEC,901,03,35,55,1,2,3,0,0,0,0,0,0,13,5,18,0,0,0,5,0,5,36,28,64,90
20192020,009,BOURBON,041,Bourbon County,010,Bourbon Central Elementary School,041010,009041010,210054001576,CKEC,901,05,41,57,1,0,1,0,0,0,0,0,0,13,7,20,0,0,0,3,2,5,40,32,72,98
20192020,009,BOURBON,041,Bourbon County,010,Bourbon Central Elementary School,041010,009041010,210054001576,CKEC,901,02,34,51,6,2,8,0,0,0,0,0,0,9,9,18,0,0,0,7,5,12,29,18,47,85
20192020,009,BOURBON,041,Bourbon County,010,Bourbon Central Elementary School,041010,009041010,210054001576,CKEC,901,04,44,58,2,0,2,0,0,0,0,0,0,13,6,19,0,0,0,4,2,6,39,36,75,102
20192020,009,BOURBON,041,Bourbon County,010,Bourbon Central Elementary School,041010,009041010,210054001576,CKEC,901,01,39,50,0,2,2,0,0,0,0,0,0,9,5,14,0,0,0,2,3,5,39,29,68,89
20192020,009,BOURBON,041,Bourbon County,010,Bourbon Central Elementary School,041010,009041010,210054001576,CKEC,901,All Students,224,311,13,10,23,0,0,0,1,0,1,66,39,105,0,0,0,22,13,35,209,162,371,535
20192020,009,BOURBON,041,Bourbon County,010,Bourbon Central Elementary School,041010,009041010,210054001576,CKEC,901,KG,31,40,3,4,7,0,0,0,1,0,1,9,7,16,0,0,0,1,1,2,26,19,45,71
20192020,009,BOURBON,041,Bourbon County,011,Bourbon County Preschool Headstart,041011,009041011,210054002054,CKEC,901,All Students,0,0,0,0,0,0,0,0,0,0,0,0,0,0,0,0,0,0,0,0,0,0,0,0
20192020,009,BOURBON,041,Bourbon County,011,Bourbon County Preschool Headstart,041011,009041011,210054002054,CKEC,901,PS,132,147,15,13,28,0,0,0,0,0,0,18,23,41,0,0,0,7,11,18,107,85,192,279
20192020,009,BOURBON,041,Bourbon County,030,Cane Ridge Elementary School,041030,009041030,210054000024,CKEC,901,01,40,46,1,0,1,0,0,0,0,0,0,6,2,8,0,0,0,1,0,1,38,38,76,86
20192020,009,BOURBON,041,Bourbon County,030,Cane Ridge Elementary School,041030,009041030,210054000024,CKEC,901,03,44,50,0,0,0,0,0,0,0,0,0,6,11,17,0,0,0,1,0,1,43,33,76,94
20192020,009,BOURBON,041,Bourbon County,030,Cane Ridge Elementary School,041030,009041030,210054000024,CKEC,901,04,37,41,1,0,1,0,0,0,0,0,0,6,4,10,0,0,0,0,1,1,34,32,66,78
20192020,009,BOURBON,041,Bourbon County,030,Cane Ridge Elementary School,041030,009041030,210054000024,CKEC,901,05,35,36,0,2,2,0,0,0,0,0,0,2,6,8,0,0,0,2,1,3,32,26,58,71
20192020,009,BOURBON,041,Bourbon County,030,Cane Ridge Elementary School,041030,009041030,210054000024,CKEC,901,All Students,221,259,2,3,5,0,1,1,0,1,1,28,25,53,0,0,0,5,6,11,224,185,409,480
20192020,009,BOURBON,041,Bourbon County,030,Cane Ridge Elementary School,041030,009041030,210054000024,CKEC,901,KG,33,43,0,1,1,0,1,1,0,1,1,3,1,4,0,0,0,1,3,4,39,26,65,76
20192020,009,BOURBON,041,Bourbon County,030,Cane Ridge Elementary School,041030,009041030,210054000024,CKEC,901,02,32,43,0,0,0,0,0,0,0,0,0,5,1,6,0,0,0,0,1,1,38,30,68,75
20192020,009,BOURBON,041,Bourbon County,090,North Middletown Elementary School,041090,009041090,210054000096,CKEC,901,All Students,81,85,1,0,1,0,0,0,0,0,0,11,18,29,0,0,0,3,1,4,70,62,132,166
20192020,009,BOURBON,041,Bourbon County,090,North Middletown Elementary School,041090,009041090,210054000096,CKEC,901,01,19,10,0,0,0,0,0,0,0,0,0,1,4,5,0,0,0,0,1,1,9,14,23,29
20192020,009,BOURBON,041,Bourbon County,090,North Middletown Elementary School,041090,009041090,210054000096,CKEC,901,03,12,13,0,0,0,0,0,0,0,0,0,2,2,4,0,0,0,1,0,1,10,10,20,25
20192020,009,BOURBON,041,Bourbon County,090,North Middletown Elementary School,041090,009041090,210054000096,CKEC,901,05,13,17,0,0,0,0,0,0,0,0,0,3,4,7,0,0,0,1,0,1,13,9,22,30
20192020,009,BOURBON,041,Bourbon County,090,North Middletown Elementary School,041090,009041090,210054000096,CKEC,901,04,12,13,0,0,0,0,0,0,0,0,0,1,3,4,0,0,0,1,0,1,11,9,20,25
20192020,009,BOURBON,041,Bourbon County,090,North Middletown Elementary School,041090,009041090,210054000096,CKEC,901,02,14,18,0,0,0,0,0,0,0,0,0,1,1,2,0,0,0,0,0,0,17,13,30,32
20192020,009,BOURBON,041,Bourbon County,090,North Middletown Elementary School,041090,009041090,210054000096,CKEC,901,KG,11,14,1,0,1,0,0,0,0,0,0,3,4,7,0,0,0,0,0,0,10,7,17,25
20192020,009,BOURBON,041,Bourbon County,110,Bourbon County High School,041110,009041110,210054000098,CKEC,901,11,77,91,3,2,5,0,0,0,0,0,0,14,8,22,0,0,0,5,0,5,69,67,136,168
20192020,009,BOURBON,041,Bourbon County,110,Bourbon County High School,041110,009041110,210054000098,CKEC,901,All Students,386,413,22,9,31,0,0,0,1,2,3,66,50,116,0,0,0,9,5,14,315,320,635,799
20192020,009,BOURBON,041,Bourbon County,110,Bourbon County High School,041110,009041110,210054000098,CKEC,901,09,106,129,6,2,8,0,0,0,1,0,1,29,18,47,0,0,0,0,1,1,93,85,178,235
20192020,009,BOURBON,041,Bourbon County,110,Bourbon County High School,041110,009041110,210054000098,CKEC,901,10,111,97,2,4,6,0,0,0,0,2,2,11,13,24,0,0,0,2,2,4,82,90,172,208
20192020,009,BOURBON,041,Bourbon County,110,Bourbon County High School,041110,009041110,210054000098,CKEC,901,12,92,96,11,1,12,0,0,0,0,0,0,12,11,23,0,0,0,2,2,4,71,78,149,188
20192020,009,BOURBON,041,Bourbon County,120,Bourbon County Middle School,041120,009041120,210054000099,CKEC,901,07,108,103,3,1,4,0,0,0,0,0,0,23,16,39,0,0,0,3,6,9,74,85,159,211
20192020,009,BOURBON,041,Bourbon County,120,Bourbon County Middle School,041120,009041120,210054000099,CKEC,901,08,112,102,4,0,4,0,0,0,0,0,0,17,18,35,0,0,0,2,3,5,79,91,170,214
20192020,009,BOURBON,041,Bourbon County,120,Bourbon County Middle School,041120,009041120,210054000099,CKEC,901,All Students,325,315,12,5,17,0,0,0,0,1,1,65,46,111,0,0,0,14,14,28,224,259,483,640
20192020,009,BOURBON,041,Bourbon County,120,Bourbon County Middle School,041120,009041120,210054000099,CKEC,901,06,105,110,5,4,9,0,0,0,0,1,1,25,12,37,0,0,0,9,5,14,71,83,154,215
20192020,114,WARREN,042,Bowling Green Independent,"",---District Total---,042,"","",GRREC,902,02,167,163,20,30,50,2,0,2,7,8,15,34,28,62,2,1,3,10,17,27,88,83,171,330
20192020,114,WARREN,042,Bowling Green Independent,"",---District Total---,042,"","",GRREC,902,All Students,2072,2134,431,406,837,6,7,13,111,102,213,400,387,787,13,13,26,126,115,241,1047,1042,2089,4206
20192020,114,WARREN,042,Bowling Green Independent,"",---District Total---,042,"","",GRREC,902,PS,54,71,11,16,27,0,1,1,6,3,9,16,16,32,2,1,3,6,6,12,30,11,41,125
20192020,114,WARREN,042,Bowling Green Independent,"",---District Total---,042,"","",GRREC,902,KG,152,162,31,28,59,0,0,0,10,7,17,28,38,66,2,2,4,14,10,24,77,67,144,314
20192020,114,WARREN,042,Bowling Green Independent,"",---District Total---,042,"","",GRREC,902,01,164,145,34,25,59,1,4,5,7,8,15,28,28,56,3,1,4,9,14,23,63,84,147,309
20192020,114,WARREN,042,Bowling Green Independent,"",---District Total---,042,"","",GRREC,902,03,153,157,45,27,72,0,0,0,11,8,19,19,35,54,0,1,1,13,7,20,69,75,144,310
20192020,114,WARREN,042,Bowling Green Independent,"",---District Total---,042,"","",GRREC,902,04,150,165,44,34,78,1,0,1,9,7,16,24,29,53,1,2,3,14,7,21,72,71,143,315
20192020,114,WARREN,042,Bowling Green Independent,"",---District Total---,042,"","",GRREC,902,05,169,134,21,37,58,1,2,3,7,7,14,30,28,58,2,0,2,8,9,17,65,86,151,303
20192020,114,WARREN,042,Bowling Green Independent,"",---District Total---,042,"","",GRREC,902,06,164,159,31,32,63,0,0,0,6,1,7,35,34,69,0,0,0,10,13,23,77,84,161,323
20192020,114,WARREN,042,Bowling Green Independent,"",---District Total---,042,"","",GRREC,902,07,146,195,47,35,82,1,1,2,9,4,13,28,24,52,1,3,4,13,7,20,96,72,168,341
20192020,114,WARREN,042,Bowling Green Independent,"",---District Total---,042,"","",GRREC,902,08,143,163,35,27,62,0,0,0,8,9,17,29,26,55,0,1,1,6,8,14,85,72,157,306
20192020,114,WARREN,042,Bowling Green Independent,"",---District Total---,042,"","",GRREC,902,09,174,184,35,27,62,0,0,0,7,10,17,33,40,73,0,1,1,13,12,25,96,84,180,358
20192020,114,WARREN,042,Bowling Green Independent,"",---District Total---,042,"","",GRREC,902,10,191,165,23,41,64,0,0,0,14,12,26,38,30,68,1,1,2,5,5,10,84,102,186,356
20192020,114,WARREN,042,Bowling Green Independent,"",---District Total---,042,"","",GRREC,902,11,158,153,34,34,68,0,0,0,10,10,20,26,26,52,1,0,1,6,3,9,76,85,161,311
20192020,114,WARREN,042,Bowling Green Independent,"",---District Total---,042,"","",GRREC,902,12,140,186,30,29,59,0,0,0,6,11,17,48,21,69,0,0,0,5,3,8,97,76,173,326
20192020,114,WARREN,042,Bowling Green Independent,"",---District Total---,042,"","",GRREC,902,14,1,3,1,0,1,0,0,0,0,0,0,0,0,0,0,0,0,0,0,0,2,1,3,4
20192020,114,WARREN,042,Bowling Green Independent,010,Dishman McGinnis Elementary School,042010,114042010,210057000100,GRREC,902,03,37,37,10,9,19,0,0,0,2,0,2,9,18,27,0,0,0,3,1,4,13,9,22,74
20192020,114,WARREN,042,Bowling Green Independent,010,Dishman McGinnis Elementary School,042010,114042010,210057000100,GRREC,902,04,32,40,10,7,17,1,0,1,3,0,3,14,16,30,0,0,0,1,2,3,11,7,18,72
20192020,114,WARREN,042,Bowling Green Independent,010,Dishman McGinnis Elementary School,042010,114042010,210057000100,GRREC,902,05,38,30,3,10,13,0,0,0,1,4,5,15,12,27,0,0,0,3,1,4,8,11,19,68
20192020,114,WARREN,042,Bowling Green Independent,010,Dishman McGinnis Elementary School,042010,114042010,210057000100,GRREC,902,KG,34,38,6,8,14,0,0,0,2,1,3,13,18,31,0,0,0,4,2,6,13,5,18,72
20192020,114,WARREN,042,Bowling Green Independent,010,Dishman McGinnis Elementary School,042010,114042010,210057000100,GRREC,902,01,22,39,9,8,17,1,1,2,0,0,0,12,8,20,0,0,0,2,1,3,15,4,19,61
20192020,114,WARREN,042,Bowling Green Independent,010,Dishman McGinnis Elementary School,042010,114042010,210057000100,GRREC,902,02,43,35,3,10,13,0,0,0,3,3,6,17,15,32,1,0,1,0,4,4,11,11,22,78
20192020,114,WARREN,042,Bowling Green Independent,010,Dishman McGinnis Elementary School,042010,114042010,210057000100,GRREC,902,All Students,206,219,41,52,93,2,1,3,11,8,19,80,87,167,1,0,1,13,11,24,71,47,118,425
20192020,114,WARREN,042,Bowling Green Independent,011,Childrens Crisis Stabilization Unit,042011,114042011,210057001830,GRREC,902,02,0,0,0,0,0,0,0,0,0,0,0,0,0,0,0,0,0,0,0,0,0,0,0,0
20192020,114,WARREN,042,Bowling Green Independent,011,Childrens Crisis Stabilization Unit,042011,114042011,210057001830,GRREC,902,03,0,0,0,0,0,0,0,0,0,0,0,0,0,0,0,0,0,0,0,0,0,0,0,0
20192020,114,WARREN,042,Bowling Green Independent,011,Childrens Crisis Stabilization Unit,042011,114042011,210057001830,GRREC,902,04,0,0,0,0,0,0,0,0,0,0,0,0,0,0,0,0,0,0,0,0,0,0,0,0
20192020,114,WARREN,042,Bowling Green Independent,011,Childrens Crisis Stabilization Unit,042011,114042011,210057001830,GRREC,902,05,0,0,0,0,0,0,0,0,0,0,0,0,0,0,0,0,0,0,0,0,0,0,0,0
20192020,114,WARREN,042,Bowling Green Independent,011,Childrens Crisis Stabilization Unit,042011,114042011,210057001830,GRREC,902,06,0,0,0,0,0,0,0,0,0,0,0,0,0,0,0,0,0,0,0,0,0,0,0,0
20192020,114,WARREN,042,Bowling Green Independent,011,Childrens Crisis Stabilization Unit,042011,114042011,210057001830,GRREC,902,07,0,0,0,0,0,0,0,0,0,0,0,0,0,0,0,0,0,0,0,0,0,0,0,0
20192020,114,WARREN,042,Bowling Green Independent,011,Childrens Crisis Stabilization Unit,042011,114042011,210057001830,GRREC,902,09,0,0,0,0,0,0,0,0,0,0,0,0,0,0,0,0,0,0,0,0,0,0,0,0
20192020,114,WARREN,042,Bowling Green Independent,011,Childrens Crisis Stabilization Unit,042011,114042011,210057001830,GRREC,902,08,0,0,0,0,0,0,0,0,0,0,0,0,0,0,0,0,0,0,0,0,0,0,0,0
20192020,114,WARREN,042,Bowling Green Independent,011,Childrens Crisis Stabilization Unit,042011,114042011,210057001830,GRREC,902,10,0,0,0,0,0,0,0,0,0,0,0,0,0,0,0,0,0,0,0,0,0,0,0,0
20192020,114,WARREN,042,Bowling Green Independent,011,Childrens Crisis Stabilization Unit,042011,114042011,210057001830,GRREC,902,12,0,0,0,0,0,0,0,0,0,0,0,0,0,0,0,0,0,0,0,0,0,0,0,0
20192020,114,WARREN,042,Bowling Green Independent,011,Childrens Crisis Stabilization Unit,042011,114042011,210057001830,GRREC,902,All Students,0,0,0,0,0,0,0,0,0,0,0,0,0,0,0,0,0,0,0,0,0,0,0,0
20192020,114,WARREN,042,Bowling Green Independent,011,Childrens Crisis Stabilization Unit,042011,114042011,210057001830,GRREC,902,11,0,0,0,0,0,0,0,0,0,0,0,0,0,0,0,0,0,0,0,0,0,0,0,0
20192020,114,WARREN,042,Bowling Green Independent,011,Childrens Crisis Stabilization Unit,042011,114042011,210057001830,GRREC,902,KG,0,0,0,0,0,0,0,0,0,0,0,0,0,0,0,0,0,0,0,0,0,0,0,0
20192020,114,WARREN,042,Bowling Green Independent,011,Childrens Crisis Stabilization Unit,042011,114042011,210057001830,GRREC,902,01,0,0,0,0,0,0,0,0,0,0,0,0,0,0,0,0,0,0,0,0,0,0,0,0
20192020,114,WARREN,042,Bowling Green Independent,013,Warren Regional Juvenile Detention Ctr,042013,114042013,210057001911,GRREC,902,All Students,1,12,3,0,3,0,0,0,0,0,0,2,1,3,0,0,0,0,0,0,7,0,7,13
20192020,114,WARREN,042,Bowling Green Independent,013,Warren Regional Juvenile Detention Ctr,042013,114042013,210057001911,GRREC,902,09,0,3,1,0,1,0,0,0,0,0,0,0,0,0,0,0,0,0,0,0,2,0,2,3
20192020,114,WARREN,042,Bowling Green Independent,013,Warren Regional Juvenile Detention Ctr,042013,114042013,210057001911,GRREC,902,10,0,4,1,0,1,0,0,0,0,0,0,1,0,1,0,0,0,0,0,0,2,0,2,4
20192020,114,WARREN,042,Bowling Green Independent,013,Warren Regional Juvenile Detention Ctr,042013,114042013,210057001911,GRREC,902,11,1,2,1,0,1,0,0,0,0,0,0,0,1,1,0,0,0,0,0,0,1,0,1,3
20192020,114,WARREN,042,Bowling Green Independent,013,Warren Regional Juvenile Detention Ctr,042013,114042013,210057001911,GRREC,902,12,0,3,0,0,0,0,0,0,0,0,0,1,0,1,0,0,0,0,0,0,2,0,2,3
20192020,114,WARREN,042,Bowling Green Independent,057,Parker-Bennett-Curry School,042057,114042057,210057000102,GRREC,902,05,26,27,10,8,18,0,0,0,1,1,2,10,10,20,0,0,0,1,1,2,5,6,11,53
20192020,114,WARREN,042,Bowling Green Independent,057,Parker-Bennett-Curry School,042057,114042057,210057000102,GRREC,902,All Students,161,184,86,50,136,0,3,3,11,8,19,48,59,107,2,0,2,13,10,23,24,31,55,345
20192020,114,WARREN,042,Bowling Green Independent,057,Parker-Bennett-Curry School,042057,114042057,210057000102,GRREC,902,KG,26,27,10,6,16,0,0,0,2,0,2,7,13,20,1,0,1,3,2,5,4,5,9,53
20192020,114,WARREN,042,Bowling Green Independent,057,Parker-Bennett-Curry School,042057,114042057,210057000102,GRREC,902,01,29,35,14,8,22,0,3,3,1,2,3,11,9,20,0,0,0,1,4,5,8,3,11,64
20192020,114,WARREN,042,Bowling Green Independent,057,Parker-Bennett-Curry School,042057,114042057,210057000102,GRREC,902,02,28,27,10,9,19,0,0,0,1,1,2,10,10,20,0,0,0,2,2,4,4,6,10,55
20192020,114,WARREN,042,Bowling Green Independent,057,Parker-Bennett-Curry School,042057,114042057,210057000102,GRREC,902,03,28,33,19,9,28,0,0,0,5,2,7,4,10,14,0,0,0,4,0,4,1,7,8,61
20192020,114,WARREN,042,Bowling Green Independent,057,Parker-Bennett-Curry School,042057,114042057,210057000102,GRREC,902,04,24,35,23,10,33,0,0,0,1,2,3,6,7,13,1,0,1,2,1,3,2,4,6,59
20192020,114,WARREN,042,Bowling Green Independent,060,Potter Gray Elementary,042060,114042060,210057000103,GRREC,902,04,47,35,3,3,6,0,0,0,2,1,3,0,2,2,0,0,0,2,1,3,28,40,68,82
20192020,114,WARREN,042,Bowling Green Independent,060,Potter Gray Elementary,042060,114042060,210057000103,GRREC,902,03,30,32,1,2,3,0,0,0,1,1,2,0,1,1,0,0,0,2,2,4,28,24,52,62
20192020,114,WARREN,042,Bowling Green Independent,060,Potter Gray Elementary,042060,114042060,210057000103,GRREC,902,06,0,2,0,0,0,0,0,0,0,0,0,0,0,0,0,0,0,0,0,0,2,0,2,2
20192020,114,WARREN,042,Bowling Green Independent,060,Potter Gray Elementary,042060,114042060,210057000103,GRREC,902,All Students,213,206,11,14,25,1,0,1,9,6,15,6,5,11,0,0,0,13,10,23,166,178,344,419
20192020,114,WARREN,042,Bowling Green Independent,060,Potter Gray Elementary,042060,114042060,210057000103,GRREC,902,KG,32,39,3,2,5,0,0,0,3,1,4,1,1,2,0,0,0,1,2,3,31,26,57,71
20192020,114,WARREN,042,Bowling Green Independent,060,Potter Gray Elementary,042060,114042060,210057000103,GRREC,902,01,28,28,3,0,3,0,0,0,2,2,4,2,0,2,0,0,0,2,2,4,19,24,43,56
20192020,114,WARREN,042,Bowling Green Independent,060,Potter Gray Elementary,042060,114042060,210057000103,GRREC,902,05,42,25,0,7,7,0,0,0,0,0,0,1,1,2,0,0,0,3,1,4,21,33,54,67
20192020,114,WARREN,042,Bowling Green Independent,060,Potter Gray Elementary,042060,114042060,210057000103,GRREC,902,02,34,45,1,0,1,1,0,1,1,1,2,2,0,2,0,0,0,3,2,5,37,31,68,79
20192020,114,WARREN,042,Bowling Green Independent,065,Bowling Green Junior High,042065,114042065,210057000104,GRREC,902,07,142,194,47,34,81,1,1,2,9,4,13,28,22,50,1,3,4,12,7,19,96,71,167,336
20192020,114,WARREN,042,Bowling Green Independent,065,Bowling Green Junior High,042065,114042065,210057000104,GRREC,902,All Students,435,501,113,90,203,1,1,2,21,11,32,89,81,170,1,4,5,28,27,55,248,221,469,936
20192020,114,WARREN,042,Bowling Green Independent,065,Bowling Green Junior High,042065,114042065,210057000104,GRREC,902,06,164,156,31,32,63,0,0,0,6,1,7,35,34,69,0,0,0,10,13,23,74,84,158,320
20192020,114,WARREN,042,Bowling Green Independent,065,Bowling Green Junior High,042065,114042065,210057000104,GRREC,902,08,129,151,35,24,59,0,0,0,6,6,12,26,25,51,0,1,1,6,7,13,78,66,144,280
20192020,114,WARREN,042,Bowling Green Independent,070,Bowling Green High School,042070,114042070,210057000105,GRREC,902,12,122,143,22,20,42,0,0,0,5,11,16,29,18,47,0,0,0,4,1,5,83,72,155,265
20192020,114,WARREN,042,Bowling Green Independent,070,Bowling Green High School,042070,114042070,210057000105,GRREC,902,14,1,3,1,0,1,0,0,0,0,0,0,0,0,0,0,0,0,0,0,0,2,1,3,4
20192020,114,WARREN,042,Bowling Green Independent,070,Bowling Green High School,042070,114042070,210057000105,GRREC,902,All Students,635,617,106,117,223,0,0,0,38,46,84,111,108,219,2,2,4,26,21,47,334,341,675,1252
20192020,114,WARREN,042,Bowling Green Independent,070,Bowling Green High School,042070,114042070,210057000105,GRREC,902,08,6,10,0,0,0,0,0,0,2,3,5,1,0,1,0,0,0,0,0,0,7,3,10,16
20192020,114,WARREN,042,Bowling Green Independent,070,Bowling Green High School,042070,114042070,210057000105,GRREC,902,09,170,173,33,26,59,0,0,0,7,10,17,28,38,66,0,1,1,13,12,25,92,83,175,343
20192020,114,WARREN,042,Bowling Green Independent,070,Bowling Green High School,042070,114042070,210057000105,GRREC,902,10,186,152,20,40,60,0,0,0,14,12,26,33,27,60,1,1,2,5,5,10,79,101,180,338
20192020,114,WARREN,042,Bowling Green Independent,070,Bowling Green High School,042070,114042070,210057000105,GRREC,902,11,150,136,30,31,61,0,0,0,10,10,20,20,25,45,1,0,1,4,3,7,71,81,152,286
20192020,114,WARREN,042,Bowling Green Independent,080,T C Cherry Elementary School,042080,114042080,210057000106,GRREC,902,03,22,25,7,2,9,0,0,0,2,0,2,4,5,9,0,1,1,2,1,3,10,13,23,47
20192020,114,WARREN,042,Bowling Green Independent,080,T C Cherry Elementary School,042080,114042080,210057000106,GRREC,902,02,24,20,2,6,8,0,0,0,1,0,1,4,2,6,1,1,2,2,5,7,10,10,20,44
20192020,114,WARREN,042,Bowling Green Independent,080,T C Cherry Elementary School,042080,114042080,210057000106,GRREC,902,04,13,21,3,3,6,0,0,0,0,0,0,1,3,4,0,1,1,4,1,5,13,5,18,34
20192020,114,WARREN,042,Bowling Green Independent,080,T C Cherry Elementary School,042080,114042080,210057000106,GRREC,902,05,18,23,3,4,7,0,0,0,1,0,1,3,2,5,2,0,2,0,3,3,14,9,23,41
20192020,114,WARREN,042,Bowling Green Independent,080,T C Cherry Elementary School,042080,114042080,210057000106,GRREC,902,All Students,137,129,23,26,49,0,0,0,4,1,5,20,21,41,7,6,13,13,16,29,62,67,129,266
20192020,114,WARREN,042,Bowling Green Independent,080,T C Cherry Elementary School,042080,114042080,210057000106,GRREC,902,PS,54,71,11,16,27,0,1,1,6,3,9,16,16,32,2,1,3,6,6,12,30,11,41,125
20192020,114,WARREN,042,Bowling Green Independent,080,T C Cherry Elementary School,042080,114042080,210057000106,GRREC,902,KG,24,23,3,7,10,0,0,0,0,0,0,5,4,9,1,2,3,4,3,7,10,8,18,47
20192020,114,WARREN,042,Bowling Green Independent,080,T C Cherry Elementary School,042080,114042080,210057000106,GRREC,902,01,36,17,5,4,9,0,0,0,0,1,1,3,5,8,3,1,4,1,3,4,5,22,27,53
20192020,114,WARREN,042,Bowling Green Independent,090,W R McNeill Elementary School,042090,114042090,210057000107,GRREC,902,03,36,30,8,5,13,0,0,0,1,5,6,2,1,3,0,0,0,2,3,5,17,22,39,66
20192020,114,WARREN,042,Bowling Green Independent,090,W R McNeill Elementary School,042090,114042090,210057000107,GRREC,902,01,49,26,3,5,8,0,0,0,4,3,7,0,6,6,0,0,0,3,4,7,16,31,47,75
20192020,114,WARREN,042,Bowling Green Independent,090,W R McNeill Elementary School,042090,114042090,210057000107,GRREC,902,KG,36,35,9,5,14,0,0,0,3,5,8,2,2,4,0,0,0,2,1,3,19,23,42,71
20192020,114,WARREN,042,Bowling Green Independent,090,W R McNeill Elementary School,042090,114042090,210057000107,GRREC,902,05,45,29,5,8,13,1,2,3,4,2,6,1,3,4,0,0,0,1,3,4,17,27,44,74
20192020,114,WARREN,042,Bowling Green Independent,090,W R McNeill Elementary School,042090,114042090,210057000107,GRREC,902,04,34,34,5,11,16,0,0,0,3,4,7,3,1,4,0,1,1,5,2,7,18,15,33,68
20192020,114,WARREN,042,Bowling Green Independent,090,W R McNeill Elementary School,042090,114042090,210057000107,GRREC,902,02,38,36,4,5,9,1,0,1,1,3,4,1,1,2,0,0,0,3,4,7,26,25,51,74
20192020,114,WARREN,042,Bowling Green Independent,090,W R McNeill Elementary School,042090,114042090,210057000107,GRREC,902,All Students,238,190,34,39,73,2,2,4,16,22,38,9,14,23,0,1,1,16,17,33,113,143,256,428
20192020,114,WARREN,042,Bowling Green Independent,098,Bowling Green Learning Center,042098,114042098,210057001696,GRREC,902,08,8,2,0,3,3,0,0,0,0,0,0,2,1,3,0,0,0,0,1,1,0,3,3,10
20192020,114,WARREN,042,Bowling Green Independent,098,Bowling Green Learning Center,042098,114042098,210057001696,GRREC,902,All Students,46,76,14,18,32,0,0,0,1,0,1,35,11,46,0,0,0,4,3,7,22,14,36,122
20192020,114,WARREN,042,Bowling Green Independent,098,Bowling Green Learning Center,042098,114042098,210057001696,GRREC,902,06,0,1,0,0,0,0,0,0,0,0,0,0,0,0,0,0,0,0,0,0,1,0,1,1
20192020,114,WARREN,042,Bowling Green Independent,098,Bowling Green Learning Center,042098,114042098,210057001696,GRREC,902,07,4,1,0,1,1,0,0,0,0,0,0,0,2,2,0,0,0,1,0,1,0,1,1,5
20192020,114,WARREN,042,Bowling Green Independent,098,Bowling Green Learning Center,042098,114042098,210057001696,GRREC,902,09,4,8,1,1,2,0,0,0,0,0,0,5,2,7,0,0,0,0,0,0,2,1,3,12
20192020,114,WARREN,042,Bowling Green Independent,098,Bowling Green Learning Center,042098,114042098,210057001696,GRREC,902,10,5,9,2,1,3,0,0,0,0,0,0,4,3,7,0,0,0,0,0,0,3,1,4,14
20192020,114,WARREN,042,Bowling Green Independent,098,Bowling Green Learning Center,042098,114042098,210057001696,GRREC,902,11,7,15,3,3,6,0,0,0,0,0,0,6,0,6,0,0,0,2,0,2,4,4,8,22
20192020,114,WARREN,042,Bowling Green Independent,098,Bowling Green Learning Center,042098,114042098,210057001696,GRREC,902,12,18,40,8,9,17,0,0,0,1,0,1,18,3,21,0,0,0,1,2,3,12,4,16,58
20192020,010,BOYD,045,Boyd County,"",---District Total---,045,"","",KEDC,903,11,91,130,1,1,2,0,0,0,0,0,0,0,3,3,0,0,0,2,2,4,127,85,212,221
20192020,010,BOYD,045,Boyd County,"",---District Total---,045,"","",KEDC,903,14,3,2,0,0,0,0,0,0,0,0,0,0,0,0,0,0,0,0,0,0,2,3,5,5
20192020,010,BOYD,045,Boyd County,"",---District Total---,045,"","",KEDC,903,12,100,117,1,2,3,0,0,0,0,1,1,2,0,2,0,0,0,4,0,4,110,97,207,217
20192020,010,BOYD,045,Boyd County,"",---District Total---,045,"","",KEDC,903,All Students,1460,1562,12,7,19,3,0,3,9,2,11,22,33,55,1,6,7,41,38,79,1474,1374,2848,3022
20192020,010,BOYD,045,Boyd County,"",---District Total---,045,"","",KEDC,903,PS,118,121,0,1,1,0,0,0,0,1,1,2,4,6,0,0,0,3,2,5,116,110,226,239
20192020,010,BOYD,045,Boyd County,"",---District Total---,045,"","",KEDC,903,KG,97,123,0,0,0,0,0,0,1,0,1,2,4,6,0,0,0,3,3,6,117,90,207,220
20192020,010,BOYD,045,Boyd County,"",---District Total---,045,"","",KEDC,903,01,105,117,0,1,1,0,0,0,1,0,1,3,1,4,0,0,0,5,3,8,108,100,208,222
20192020,010,BOYD,045,Boyd County,"",---District Total---,045,"","",KEDC,903,02,121,114,1,0,1,0,0,0,1,0,1,2,3,5,0,0,0,5,4,9,105,114,219,235
20192020,010,BOYD,045,Boyd County,"",---District Total---,045,"","",KEDC,903,03,104,116,0,0,0,0,0,0,0,1,1,3,5,8,0,0,0,4,1,5,109,97,206,220
20192020,010,BOYD,045,Boyd County,"",---District Total---,045,"","",KEDC,903,04,109,109,0,0,0,1,0,1,1,0,1,0,1,1,0,0,0,7,4,11,100,104,204,218
20192020,010,BOYD,045,Boyd County,"",---District Total---,045,"","",KEDC,903,05,121,112,0,1,1,0,0,0,1,0,1,3,3,6,0,1,1,2,5,7,106,111,217,233
20192020,010,BOYD,045,Boyd County,"",---District Total---,045,"","",KEDC,903,06,136,119,1,0,1,1,0,1,1,0,1,4,3,7,0,0,0,2,5,7,110,128,238,255
20192020,010,BOYD,045,Boyd County,"",---District Total---,045,"","",KEDC,903,07,111,122,1,1,2,1,0,1,0,0,0,0,2,2,0,2,2,1,3,4,119,103,222,233
20192020,010,BOYD,045,Boyd County,"",---District Total---,045,"","",KEDC,903,08,128,109,2,1,3,0,0,0,1,0,1,2,2,4,0,2,2,4,1,5,100,122,222,237
20192020,010,BOYD,045,Boyd County,"",---District Total---,045,"","",KEDC,903,09,122,135,3,0,3,0,0,0,0,0,0,1,3,4,1,1,2,2,3,5,128,115,243,257
20192020,010,BOYD,045,Boyd County,"",---District Total---,045,"","",KEDC,903,10,112,137,2,0,2,0,0,0,2,0,2,0,3,3,0,0,0,0,4,4,133,105,238,249
20192020,010,BOYD,045,Boyd County,010,Boyd County High School,045010,010045010,210062000108,KEDC,903,09,112,112,0,0,0,0,0,0,0,0,0,0,3,3,0,1,1,1,3,4,111,105,216,224
20192020,010,BOYD,045,Boyd County,010,Boyd County High School,045010,010045010,210062000108,KEDC,903,All Students,394,458,1,1,2,0,0,0,2,1,3,2,8,10,0,1,1,5,8,13,448,375,823,852
20192020,010,BOYD,045,Boyd County,010,Boyd County High School,045010,010045010,210062000108,KEDC,903,10,102,116,0,0,0,0,0,0,2,0,2,0,3,3,0,0,0,0,4,4,114,95,209,218
20192020,010,BOYD,045,Boyd County,010,Boyd County High School,045010,010045010,210062000108,KEDC,903,11,85,124,1,1,2,0,0,0,0,0,0,0,2,2,0,0,0,2,1,3,121,81,202,209
20192020,010,BOYD,045,Boyd County,010,Boyd County High School,045010,010045010,210062000108,KEDC,903,12,92,104,0,0,0,0,0,0,0,1,1,2,0,2,0,0,0,2,0,2,100,91,191,196
20192020,010,BOYD,045,Boyd County,010,Boyd County High School,045010,010045010,210062000108,KEDC,903,14,3,2,0,0,0,0,0,0,0,0,0,0,0,0,0,0,0,0,0,0,2,3,5,5
20192020,010,BOYD,045,Boyd County,020,Cannonsburg Elementary School,045020,010045020,210062000109,KEDC,903,03,21,28,0,0,0,0,0,0,0,0,0,1,2,3,0,0,0,1,1,2,26,18,44,49
20192020,010,BOYD,045,Boyd County,020,Cannonsburg Elementary School,045020,010045020,210062000109,KEDC,903,04,25,19,0,0,0,0,0,0,0,0,0,0,0,0,0,0,0,0,1,1,19,24,43,44
20192020,010,BOYD,045,Boyd County,020,Cannonsburg Elementary School,045020,010045020,210062000109,KEDC,903,05,28,29,0,0,0,0,0,0,1,0,1,0,2,2,0,1,1,0,0,0,28,25,53,57
20192020,010,BOYD,045,Boyd County,020,Cannonsburg Elementary School,045020,010045020,210062000109,KEDC,903,All Students,142,147,1,0,1,0,0,0,2,0,2,1,5,6,0,1,1,1,4,5,142,132,274,289
20192020,010,BOYD,045,Boyd County,020,Cannonsburg Elementary School,045020,010045020,210062000109,KEDC,903,KG,20,27,0,0,0,0,0,0,0,0,0,0,1,1,0,0,0,0,0,0,27,19,46,47
20192020,010,BOYD,045,Boyd County,020,Cannonsburg Elementary School,045020,010045020,210062000109,KEDC,903,01,21,22,0,0,0,0,0,0,1,0,1,0,0,0,0,0,0,0,0,0,21,21,42,43
20192020,010,BOYD,045,Boyd County,020,Cannonsburg Elementary School,045020,010045020,210062000109,KEDC,903,02,27,22,1,0,1,0,0,0,0,0,0,0,0,0,0,0,0,0,2,2,21,25,46,49
20192020,010,BOYD,045,Boyd County,035,Boyd County Middle School,045035,010045035,210062000112,KEDC,903,All Students,369,336,1,1,2,2,0,2,2,0,2,4,7,11,0,4,4,6,9,15,321,348,669,705
20192020,010,BOYD,045,Boyd County,035,Boyd County Middle School,045035,010045035,210062000112,KEDC,903,07,110,118,0,1,1,1,0,1,0,0,0,0,2,2,0,2,2,1,3,4,116,102,218,228
20192020,010,BOYD,045,Boyd County,035,Boyd County Middle School,045035,010045035,210062000112,KEDC,903,08,123,100,0,0,0,0,0,0,1,0,1,1,2,3,0,2,2,3,1,4,95,118,213,223
20192020,010,BOYD,045,Boyd County,035,Boyd County Middle School,045035,010045035,210062000112,KEDC,903,06,136,118,1,0,1,1,0,1,1,0,1,3,3,6,0,0,0,2,5,7,110,128,238,254
20192020,010,BOYD,045,Boyd County,045,Boyd County Central School,045045,010045045,210062002466,KEDC,903,06,0,1,0,0,0,0,0,0,0,0,0,1,0,1,0,0,0,0,0,0,0,0,0,1
20192020,010,BOYD,045,Boyd County,045,Boyd County Central School,045045,010045045,210062002466,KEDC,903,08,1,1,0,0,0,0,0,0,0,0,0,0,0,0,0,0,0,0,0,0,1,1,2,2
20192020,010,BOYD,045,Boyd County,045,Boyd County Central School,045045,010045045,210062002466,KEDC,903,09,3,1,0,0,0,0,0,0,0,0,0,0,0,0,0,0,0,0,0,0,1,3,4,4
20192020,010,BOYD,045,Boyd County,045,Boyd County Central School,045045,010045045,210062002466,KEDC,903,11,2,2,0,0,0,0,0,0,0,0,0,0,1,1,0,0,0,0,0,0,2,1,3,4
20192020,010,BOYD,045,Boyd County,045,Boyd County Central School,045045,010045045,210062002466,KEDC,903,12,1,3,0,0,0,0,0,0,0,0,0,0,0,0,0,0,0,0,0,0,3,1,4,4
20192020,010,BOYD,045,Boyd County,045,Boyd County Central School,045045,010045045,210062002466,KEDC,903,All Students,9,15,0,0,0,0,0,0,0,0,0,1,1,2,0,0,0,0,0,0,14,8,22,24
20192020,010,BOYD,045,Boyd County,045,Boyd County Central School,045045,010045045,210062002466,KEDC,903,10,2,4,0,0,0,0,0,0,0,0,0,0,0,0,0,0,0,0,0,0,4,2,6,6
20192020,010,BOYD,045,Boyd County,045,Boyd County Central School,045045,010045045,210062002466,KEDC,903,07,0,3,0,0,0,0,0,0,0,0,0,0,0,0,0,0,0,0,0,0,3,0,3,3
20192020,010,BOYD,045,Boyd County,080,Summit Elementary School,045080,010045080,210062000117,KEDC,903,KG,36,45,0,0,0,0,0,0,1,0,1,2,1,3,0,0,0,2,3,5,40,32,72,81
20192020,010,BOYD,045,Boyd County,080,Summit Elementary School,045080,010045080,210062000117,KEDC,903,All Students,236,258,0,0,0,1,0,1,1,0,1,7,8,15,0,0,0,13,8,21,236,220,456,494
20192020,010,BOYD,045,Boyd County,080,Summit Elementary School,045080,010045080,210062000117,KEDC,903,01,41,38,0,0,0,0,0,0,0,0,0,2,1,3,0,0,0,0,0,0,36,40,76,79
20192020,010,BOYD,045,Boyd County,080,Summit Elementary School,045080,010045080,210062000117,KEDC,903,02,38,38,0,0,0,0,0,0,0,0,0,1,3,4,0,0,0,4,0,4,33,35,68,76
20192020,010,BOYD,045,Boyd County,080,Summit Elementary School,045080,010045080,210062000117,KEDC,903,03,32,45,0,0,0,0,0,0,0,0,0,1,1,2,0,0,0,2,0,2,42,31,73,77
20192020,010,BOYD,045,Boyd County,080,Summit Elementary School,045080,010045080,210062000117,KEDC,903,04,46,52,0,0,0,1,0,1,0,0,0,0,1,1,0,0,0,4,2,6,47,43,90,98
20192020,010,BOYD,045,Boyd County,080,Summit Elementary School,045080,010045080,210062000117,KEDC,903,05,43,40,0,0,0,0,0,0,0,0,0,1,1,2,0,0,0,1,3,4,38,39,77,83
20192020,010,BOYD,045,Boyd County,085,Ramey-Estep High School,045085,010045085,210062000640,KEDC,903,10,8,17,2,0,2,0,0,0,0,0,0,0,0,0,0,0,0,0,0,0,15,8,23,25
20192020,010,BOYD,045,Boyd County,085,Ramey-Estep High School,045085,010045085,210062000640,KEDC,903,11,4,4,0,0,0,0,0,0,0,0,0,0,0,0,0,0,0,0,1,1,4,3,7,8
20192020,010,BOYD,045,Boyd County,085,Ramey-Estep High School,045085,010045085,210062000640,KEDC,903,12,7,10,1,2,3,0,0,0,0,0,0,0,0,0,0,0,0,2,0,2,7,5,12,17
20192020,010,BOYD,045,Boyd County,085,Ramey-Estep High School,045085,010045085,210062000640,KEDC,903,All Students,31,62,9,3,12,0,0,0,0,0,0,2,0,2,1,0,1,4,1,5,46,27,73,93
20192020,010,BOYD,045,Boyd County,085,Ramey-Estep High School,045085,010045085,210062000640,KEDC,903,07,1,1,1,0,1,0,0,0,0,0,0,0,0,0,0,0,0,0,0,0,0,1,1,2
20192020,010,BOYD,045,Boyd County,085,Ramey-Estep High School,045085,010045085,210062000640,KEDC,903,08,4,8,2,1,3,0,0,0,0,0,0,1,0,1,0,0,0,1,0,1,4,3,7,12
20192020,010,BOYD,045,Boyd County,085,Ramey-Estep High School,045085,010045085,210062000640,KEDC,903,09,7,22,3,0,3,0,0,0,0,0,0,1,0,1,1,0,1,1,0,1,16,7,23,29
20192020,010,BOYD,045,Boyd County,095,Catlettsburg Elementary School,045095,010045095,210062000118,KEDC,903,02,27,19,0,0,0,0,0,0,1,0,1,1,0,1,0,0,0,1,0,1,16,27,43,46
20192020,010,BOYD,045,Boyd County,095,Catlettsburg Elementary School,045095,010045095,210062000118,KEDC,903,05,23,22,0,1,1,0,0,0,0,0,0,2,0,2,0,0,0,1,1,2,19,21,40,45
20192020,010,BOYD,045,Boyd County,095,Catlettsburg Elementary School,045095,010045095,210062000118,KEDC,903,04,13,16,0,0,0,0,0,0,1,0,1,0,0,0,0,0,0,1,1,2,14,12,26,29
20192020,010,BOYD,045,Boyd County,095,Catlettsburg Elementary School,045095,010045095,210062000118,KEDC,903,All Students,120,118,0,2,2,0,0,0,2,1,3,5,2,7,0,0,0,6,3,9,105,112,217,238
20192020,010,BOYD,045,Boyd County,095,Catlettsburg Elementary School,045095,010045095,210062000118,KEDC,903,KG,16,20,0,0,0,0,0,0,0,0,0,0,1,1,0,0,0,0,0,0,20,15,35,36
20192020,010,BOYD,045,Boyd County,095,Catlettsburg Elementary School,045095,010045095,210062000118,KEDC,903,01,18,27,0,1,1,0,0,0,0,0,0,1,0,1,0,0,0,2,1,3,24,16,40,45
20192020,010,BOYD,045,Boyd County,095,Catlettsburg Elementary School,045095,010045095,210062000118,KEDC,903,03,23,14,0,0,0,0,0,0,0,1,1,1,1,2,0,0,0,1,0,1,12,21,33,37
20192020,010,BOYD,045,Boyd County,097,Ponderosa Elementary School,045097,010045097,210062000030,KEDC,903,03,28,29,0,0,0,0,0,0,0,0,0,0,1,1,0,0,0,0,0,0,29,27,56,57
20192020,010,BOYD,045,Boyd County,097,Ponderosa Elementary School,045097,010045097,210062000030,KEDC,903,All Students,159,168,0,0,0,0,0,0,0,0,0,0,2,2,0,0,0,6,5,11,162,152,314,327
20192020,010,BOYD,045,Boyd County,097,Ponderosa Elementary School,045097,010045097,210062000030,KEDC,903,KG,25,31,0,0,0,0,0,0,0,0,0,0,1,1,0,0,0,1,0,1,30,24,54,56
20192020,010,BOYD,045,Boyd County,097,Ponderosa Elementary School,045097,010045097,210062000030,KEDC,903,01,25,30,0,0,0,0,0,0,0,0,0,0,0,0,0,0,0,3,2,5,27,23,50,55
20192020,010,BOYD,045,Boyd County,097,Ponderosa Elementary School,045097,010045097,210062000030,KEDC,903,02,29,35,0,0,0,0,0,0,0,0,0,0,0,0,0,0,0,0,2,2,35,27,62,64
20192020,010,BOYD,045,Boyd County,097,Ponderosa Elementary School,045097,010045097,210062000030,KEDC,903,04,25,22,0,0,0,0,0,0,0,0,0,0,0,0,0,0,0,2,0,2,20,25,45,47
20192020,010,BOYD,045,Boyd County,097,Ponderosa Elementary School,045097,010045097,210062000030,KEDC,903,05,27,21,0,0,0,0,0,0,0,0,0,0,0,0,0,0,0,0,1,1,21,26,47,48
20192020,010,BOYD,045,Boyd County,120,Boyd Co Career & Tech Educ Ctr Voc Sch,045120,010045120,210062001479,KEDC,903,09,0,0,0,0,0,0,0,0,0,0,0,0,0,0,0,0,0,0,0,0,0,0,0,0
20192020,010,BOYD,045,Boyd County,120,Boyd Co Career & Tech Educ Ctr Voc Sch,045120,010045120,210062001479,KEDC,903,11,0,0,0,0,0,0,0,0,0,0,0,0,0,0,0,0,0,0,0,0,0,0,0,0
20192020,010,BOYD,045,Boyd County,120,Boyd Co Career & Tech Educ Ctr Voc Sch,045120,010045120,210062001479,KEDC,903,12,0,0,0,0,0,0,0,0,0,0,0,0,0,0,0,0,0,0,0,0,0,0,0,0
20192020,010,BOYD,045,Boyd County,120,Boyd Co Career & Tech Educ Ctr Voc Sch,045120,010045120,210062001479,KEDC,903,All Students,0,0,0,0,0,0,0,0,0,0,0,0,0,0,0,0,0,0,0,0,0,0,0,0
20192020,010,BOYD,045,Boyd County,120,Boyd Co Career & Tech Educ Ctr Voc Sch,045120,010045120,210062001479,KEDC,903,10,0,0,0,0,0,0,0,0,0,0,0,0,0,0,0,0,0,0,0,0,0,0,0,0
20192020,010,BOYD,045,Boyd County,198,Boyd Co Early Childhood Academy,045198,010045198,210062001923,KEDC,903,PS,118,121,0,1,1,0,0,0,0,1,1,2,4,6,0,0,0,3,2,5,116,110,226,239
20192020,010,BOYD,045,Boyd County,198,Boyd Co Early Childhood Academy,045198,010045198,210062001923,KEDC,903,All Students,0,0,0,0,0,0,0,0,0,0,0,0,0,0,0,0,0,0,0,0,0,0,0,0
20192020,011,BOYLE,051,Boyle County,"",---District Total---,051,"","",CKEC,901,04,106,95,2,2,4,0,0,0,0,0,0,4,4,8,0,0,0,3,5,8,86,95,181,201
20192020,011,BOYLE,051,Boyle County,"",---District Total---,051,"","",CKEC,901,01,89,100,3,0,3,0,0,0,2,2,4,4,4,8,0,0,0,4,4,8,87,79,166,189
20192020,011,BOYLE,051,Boyle County,"",---District Total---,051,"","",CKEC,901,KG,112,86,0,2,2,0,0,0,0,1,1,5,3,8,0,0,0,6,3,9,75,103,178,198
20192020,011,BOYLE,051,Boyle County,"",---District Total---,051,"","",CKEC,901,12,91,110,2,1,3,0,0,0,2,1,3,1,2,3,0,0,0,2,3,5,103,84,187,201
20192020,011,BOYLE,051,Boyle County,"",---District Total---,051,"","",CKEC,901,10,100,110,2,3,5,0,0,0,2,1,3,1,4,5,0,0,0,6,0,6,99,92,191,210
20192020,011,BOYLE,051,Boyle County,"",---District Total---,051,"","",CKEC,901,09,105,116,2,1,3,0,0,0,2,2,4,0,4,4,0,0,0,2,2,4,110,96,206,221
20192020,011,BOYLE,051,Boyle County,"",---District Total---,051,"","",CKEC,901,11,92,109,1,0,1,0,0,0,4,1,5,3,4,7,0,0,0,2,1,3,99,86,185,201
20192020,011,BOYLE,051,Boyle County,"",---District Total---,051,"","",CKEC,901,07,125,99,5,1,6,0,0,0,2,2,4,3,4,7,0,0,0,3,5,8,86,113,199,224
20192020,011,BOYLE,051,Boyle County,"",---District Total---,051,"","",CKEC,901,08,104,110,1,0,1,0,1,1,2,2,4,11,6,17,0,0,0,3,4,7,93,91,184,214
20192020,011,BOYLE,051,Boyle County,"",---District Total---,051,"","",CKEC,901,05,89,100,0,2,2,1,0,1,1,0,1,6,3,9,0,0,0,10,1,11,82,83,165,189
20192020,011,BOYLE,051,Boyle County,"",---District Total---,051,"","",CKEC,901,06,92,133,3,0,3,2,0,2,0,0,0,3,9,12,0,0,0,6,1,7,119,82,201,225
20192020,011,BOYLE,051,Boyle County,"",---District Total---,051,"","",CKEC,901,All Students,1258,1359,25,15,40,4,1,5,21,13,34,49,54,103,0,0,0,53,33,86,1207,1142,2349,2617
20192020,011,BOYLE,051,Boyle County,"",---District Total---,051,"","",CKEC,901,PS,66,105,3,1,4,0,0,0,2,0,2,9,2,11,0,0,0,6,5,11,85,58,143,171
20192020,011,BOYLE,051,Boyle County,"",---District Total---,051,"","",CKEC,901,02,66,91,0,2,2,1,0,1,1,0,1,7,5,12,0,0,0,4,0,4,78,59,137,157
20192020,011,BOYLE,051,Boyle County,"",---District Total---,051,"","",CKEC,901,03,87,100,4,1,5,0,0,0,3,1,4,1,2,3,0,0,0,2,4,6,90,79,169,187
20192020,011,BOYLE,051,Boyle County,003,Boyle County Middle School,051003,011051003,210063000119,CKEC,901,08,104,108,1,0,1,0,1,1,2,2,4,11,6,17,0,0,0,3,4,7,91,91,182,212
20192020,011,BOYLE,051,Boyle County,003,Boyle County Middle School,051003,011051003,210063000119,CKEC,901,All Students,321,339,9,1,10,2,1,3,4,4,8,17,19,36,0,0,0,12,10,22,295,286,581,660
20192020,011,BOYLE,051,Boyle County,003,Boyle County Middle School,051003,011051003,210063000119,CKEC,901,06,92,132,3,0,3,2,0,2,0,0,0,3,9,12,0,0,0,6,1,7,118,82,200,224
20192020,011,BOYLE,051,Boyle County,003,Boyle County Middle School,051003,011051003,210063000119,CKEC,901,07,125,99,5,1,6,0,0,0,2,2,4,3,4,7,0,0,0,3,5,8,86,113,199,224
20192020,011,BOYLE,051,Boyle County,004,Boyle County Day Treatment,051004,011051004,210063001713,CKEC,901,12,0,3,0,0,0,0,0,0,0,0,0,1,0,1,0,0,0,0,0,0,2,0,2,3
20192020,011,BOYLE,051,Boyle County,004,Boyle County Day Treatment,051004,011051004,210063001713,CKEC,901,All Students,2,12,1,0,1,0,0,0,0,0,0,2,0,2,0,0,0,0,0,0,9,2,11,14
20192020,011,BOYLE,051,Boyle County,004,Boyle County Day Treatment,051004,011051004,210063001713,CKEC,901,06,0,1,0,0,0,0,0,0,0,0,0,0,0,0,0,0,0,0,0,0,1,0,1,1
20192020,011,BOYLE,051,Boyle County,004,Boyle County Day Treatment,051004,011051004,210063001713,CKEC,901,08,0,2,0,0,0,0,0,0,0,0,0,0,0,0,0,0,0,0,0,0,2,0,2,2
20192020,011,BOYLE,051,Boyle County,004,Boyle County Day Treatment,051004,011051004,210063001713,CKEC,901,09,0,2,0,0,0,0,0,0,0,0,0,0,0,0,0,0,0,0,0,0,2,0,2,2
20192020,011,BOYLE,051,Boyle County,004,Boyle County Day Treatment,051004,011051004,210063001713,CKEC,901,10,1,2,1,0,1,0,0,0,0,0,0,1,0,1,0,0,0,0,0,0,0,1,1,3
20192020,011,BOYLE,051,Boyle County,004,Boyle County Day Treatment,051004,011051004,210063001713,CKEC,901,11,1,2,0,0,0,0,0,0,0,0,0,0,0,0,0,0,0,0,0,0,2,1,3,3
20192020,011,BOYLE,051,Boyle County,005,Boyle County High School,051005,011051005,210063000120,CKEC,901,11,91,107,1,0,1,0,0,0,4,1,5,3,4,7,0,0,0,2,1,3,97,85,182,198
20192020,011,BOYLE,051,Boyle County,005,Boyle County High School,051005,011051005,210063000120,CKEC,901,All Students,386,436,6,5,11,0,0,0,10,5,15,3,14,17,0,0,0,12,6,18,405,356,761,822
20192020,011,BOYLE,051,Boyle County,005,Boyle County High School,051005,011051005,210063000120,CKEC,901,09,105,114,2,1,3,0,0,0,2,2,4,0,4,4,0,0,0,2,2,4,108,96,204,219
20192020,011,BOYLE,051,Boyle County,005,Boyle County High School,051005,011051005,210063000120,CKEC,901,10,99,108,1,3,4,0,0,0,2,1,3,0,4,4,0,0,0,6,0,6,99,91,190,207
20192020,011,BOYLE,051,Boyle County,005,Boyle County High School,051005,011051005,210063000120,CKEC,901,12,91,107,2,1,3,0,0,0,2,1,3,0,2,2,0,0,0,2,3,5,101,84,185,198
20192020,011,BOYLE,051,Boyle County,040,Junction City Elementary School,051040,011051040,210063000121,CKEC,901,04,27,29,1,0,1,0,0,0,0,0,0,3,1,4,0,0,0,0,1,1,25,25,50,56
20192020,011,BOYLE,051,Boyle County,040,Junction City Elementary School,051040,011051040,210063000121,CKEC,901,All Students,153,191,1,1,2,0,0,0,1,0,1,15,9,24,0,0,0,10,5,15,164,138,302,344
20192020,011,BOYLE,051,Boyle County,040,Junction City Elementary School,051040,011051040,210063000121,CKEC,901,PS,23,38,2,0,2,0,0,0,1,0,1,8,0,8,0,0,0,4,3,7,23,20,43,61
20192020,011,BOYLE,051,Boyle County,040,Junction City Elementary School,051040,011051040,210063000121,CKEC,901,KG,26,36,0,0,0,0,0,0,0,0,0,4,0,4,0,0,0,3,1,4,29,25,54,62
20192020,011,BOYLE,051,Boyle County,040,Junction City Elementary School,051040,011051040,210063000121,CKEC,901,01,27,35,0,0,0,0,0,0,1,0,1,3,3,6,0,0,0,2,1,3,29,23,52,62
20192020,011,BOYLE,051,Boyle County,040,Junction City Elementary School,051040,011051040,210063000121,CKEC,901,02,15,31,0,1,1,0,0,0,0,0,0,3,2,5,0,0,0,3,0,3,25,12,37,46
20192020,011,BOYLE,051,Boyle County,040,Junction City Elementary School,051040,011051040,210063000121,CKEC,901,03,26,32,0,0,0,0,0,0,0,0,0,1,1,2,0,0,0,0,2,2,31,23,54,58
20192020,011,BOYLE,051,Boyle County,040,Junction City Elementary School,051040,011051040,210063000121,CKEC,901,05,32,28,0,0,0,0,0,0,0,0,0,1,2,3,0,0,0,2,0,2,25,30,55,60
20192020,011,BOYLE,051,Boyle County,050,Woodlawn Elementary School,051050,011051050,210063000122,CKEC,901,04,62,42,0,1,1,0,0,0,0,0,0,1,2,3,0,0,0,1,4,5,40,55,95,104
20192020,011,BOYLE,051,Boyle County,050,Woodlawn Elementary School,051050,011051050,210063000122,CKEC,901,All Students,278,256,6,7,13,0,0,0,6,4,10,9,6,15,0,0,0,13,9,22,222,252,474,534
20192020,011,BOYLE,051,Boyle County,050,Woodlawn Elementary School,051050,011051050,210063000122,CKEC,901,PS,28,45,1,1,2,0,0,0,1,0,1,1,1,2,0,0,0,2,1,3,40,25,65,73
20192020,011,BOYLE,051,Boyle County,050,Woodlawn Elementary School,051050,011051050,210063000122,CKEC,901,KG,58,31,0,2,2,0,0,0,0,1,1,1,1,2,0,0,0,3,1,4,27,53,80,89
20192020,011,BOYLE,051,Boyle County,050,Woodlawn Elementary School,051050,011051050,210063000122,CKEC,901,01,37,45,2,0,2,0,0,0,1,2,3,1,0,1,0,0,0,2,2,4,39,33,72,82
20192020,011,BOYLE,051,Boyle County,050,Woodlawn Elementary School,051050,011051050,210063000122,CKEC,901,02,37,40,0,1,1,0,0,0,1,0,1,2,2,4,0,0,0,0,0,0,37,34,71,77
20192020,011,BOYLE,051,Boyle County,050,Woodlawn Elementary School,051050,011051050,210063000122,CKEC,901,03,46,46,4,1,5,0,0,0,3,1,4,0,1,1,0,0,0,1,2,3,38,41,79,92
20192020,011,BOYLE,051,Boyle County,050,Woodlawn Elementary School,051050,011051050,210063000122,CKEC,901,05,38,52,0,2,2,0,0,0,1,0,1,4,0,4,0,0,0,6,0,6,41,36,77,90
20192020,011,BOYLE,051,Boyle County,080,Perryville Elementary School,051080,011051080,210063000124,CKEC,901,04,17,24,1,1,2,0,0,0,0,0,0,0,1,1,0,0,0,2,0,2,21,15,36,41
20192020,011,BOYLE,051,Boyle County,080,Perryville Elementary School,051080,011051080,210063000124,CKEC,901,All Students,118,125,2,1,3,2,0,2,0,0,0,3,6,9,0,0,0,6,3,9,112,108,220,243
20192020,011,BOYLE,051,Boyle County,080,Perryville Elementary School,051080,011051080,210063000124,CKEC,901,PS,15,22,0,0,0,0,0,0,0,0,0,0,1,1,0,0,0,0,1,1,22,13,35,37
20192020,011,BOYLE,051,Boyle County,080,Perryville Elementary School,051080,011051080,210063000124,CKEC,901,KG,28,19,0,0,0,0,0,0,0,0,0,0,2,2,0,0,0,0,1,1,19,25,44,47
20192020,011,BOYLE,051,Boyle County,080,Perryville Elementary School,051080,011051080,210063000124,CKEC,901,01,25,20,1,0,1,0,0,0,0,0,0,0,1,1,0,0,0,0,1,1,19,23,42,45
20192020,011,BOYLE,051,Boyle County,080,Perryville Elementary School,051080,011051080,210063000124,CKEC,901,02,14,20,0,0,0,1,0,1,0,0,0,2,1,3,0,0,0,1,0,1,16,13,29,34
20192020,011,BOYLE,051,Boyle County,080,Perryville Elementary School,051080,011051080,210063000124,CKEC,901,03,15,22,0,0,0,0,0,0,0,0,0,0,0,0,0,0,0,1,0,1,21,15,36,37
20192020,011,BOYLE,051,Boyle County,080,Perryville Elementary School,051080,011051080,210063000124,CKEC,901,05,19,20,0,0,0,1,0,1,0,0,0,1,1,2,0,0,0,2,1,3,16,17,33,39
20192020,012,BRACKEN,055,Bracken County,"",---District Total---,055,"","",NKCES,905,05,48,53,0,0,0,0,0,0,0,0,0,1,0,1,0,0,0,1,1,2,51,47,98,101
20192020,012,BRACKEN,055,Bracken County,"",---District Total---,055,"","",NKCES,905,All Students,545,638,0,0,0,0,0,0,0,1,1,19,8,27,0,0,0,16,15,31,603,521,1124,1183
20192020,012,BRACKEN,055,Bracken County,"",---District Total---,055,"","",NKCES,905,PS,30,33,0,0,0,0,0,0,0,0,0,0,1,1,0,0,0,0,1,1,33,28,61,63
20192020,012,BRACKEN,055,Bracken County,"",---District Total---,055,"","",NKCES,905,KG,39,43,0,0,0,0,0,0,0,0,0,3,0,3,0,0,0,0,1,1,40,38,78,82
20192020,012,BRACKEN,055,Bracken County,"",---District Total---,055,"","",NKCES,905,01,42,61,0,0,0,0,0,0,0,0,0,0,1,1,0,0,0,1,2,3,60,39,99,103
20192020,012,BRACKEN,055,Bracken County,"",---District Total---,055,"","",NKCES,905,02,45,42,0,0,0,0,0,0,0,1,1,1,0,1,0,0,0,0,0,0,41,44,85,87
20192020,012,BRACKEN,055,Bracken County,"",---District Total---,055,"","",NKCES,905,03,34,43,0,0,0,0,0,0,0,0,0,0,0,0,0,0,0,3,1,4,40,33,73,77
20192020,012,BRACKEN,055,Bracken County,"",---District Total---,055,"","",NKCES,905,04,26,52,0,0,0,0,0,0,0,0,0,1,1,2,0,0,0,2,1,3,49,24,73,78
20192020,012,BRACKEN,055,Bracken County,"",---District Total---,055,"","",NKCES,905,06,45,53,0,0,0,0,0,0,0,0,0,0,2,2,0,0,0,2,2,4,51,41,92,98
20192020,012,BRACKEN,055,Bracken County,"",---District Total---,055,"","",NKCES,905,07,47,57,0,0,0,0,0,0,0,0,0,5,0,5,0,0,0,1,1,2,51,46,97,104
20192020,012,BRACKEN,055,Bracken County,"",---District Total---,055,"","",NKCES,905,08,39,50,0,0,0,0,0,0,0,0,0,2,0,2,0,0,0,3,2,5,45,37,82,89
20192020,012,BRACKEN,055,Bracken County,"",---District Total---,055,"","",NKCES,905,09,42,47,0,0,0,0,0,0,0,0,0,0,0,0,0,0,0,2,0,2,45,42,87,89
20192020,012,BRACKEN,055,Bracken County,"",---District Total---,055,"","",NKCES,905,10,50,44,0,0,0,0,0,0,0,0,0,4,1,5,0,0,0,1,1,2,39,48,87,94
20192020,012,BRACKEN,055,Bracken County,"",---District Total---,055,"","",NKCES,905,11,40,52,0,0,0,0,0,0,0,0,0,2,2,4,0,0,0,0,2,2,50,36,86,92
20192020,012,BRACKEN,055,Bracken County,"",---District Total---,055,"","",NKCES,905,12,47,40,0,0,0,0,0,0,0,0,0,0,1,1,0,0,0,0,1,1,40,45,85,87
20192020,012,BRACKEN,055,Bracken County,"",---District Total---,055,"","",NKCES,905,14,1,1,0,0,0,0,0,0,0,0,0,0,0,0,0,0,0,0,0,0,1,1,2,2
20192020,012,BRACKEN,055,Bracken County,010,Bracken County High School,055010,012055010,210066000125,NKCES,905,09,42,47,0,0,0,0,0,0,0,0,0,0,0,0,0,0,0,2,0,2,45,42,87,89
20192020,012,BRACKEN,055,Bracken County,010,Bracken County High School,055010,012055010,210066000125,NKCES,905,10,50,44,0,0,0,0,0,0,0,0,0,4,1,5,0,0,0,1,1,2,39,48,87,94
20192020,012,BRACKEN,055,Bracken County,010,Bracken County High School,055010,012055010,210066000125,NKCES,905,11,40,52,0,0,0,0,0,0,0,0,0,2,2,4,0,0,0,0,2,2,50,36,86,92
20192020,012,BRACKEN,055,Bracken County,010,Bracken County High School,055010,012055010,210066000125,NKCES,905,12,47,40,0,0,0,0,0,0,0,0,0,0,1,1,0,0,0,0,1,1,40,45,85,87
20192020,012,BRACKEN,055,Bracken County,010,Bracken County High School,055010,012055010,210066000125,NKCES,905,14,1,1,0,0,0,0,0,0,0,0,0,0,0,0,0,0,0,0,0,0,1,1,2,2
20192020,012,BRACKEN,055,Bracken County,010,Bracken County High School,055010,012055010,210066000125,NKCES,905,All Students,180,184,0,0,0,0,0,0,0,0,0,6,4,10,0,0,0,3,4,7,175,172,347,364
20192020,012,BRACKEN,055,Bracken County,050,Taylor Elementary School,055050,012055050,210066000128,NKCES,905,03,34,43,0,0,0,0,0,0,0,0,0,0,0,0,0,0,0,3,1,4,40,33,73,77
20192020,012,BRACKEN,055,Bracken County,050,Taylor Elementary School,055050,012055050,210066000128,NKCES,905,05,48,53,0,0,0,0,0,0,0,0,0,1,0,1,0,0,0,1,1,2,51,47,98,101
20192020,012,BRACKEN,055,Bracken County,050,Taylor Elementary School,055050,012055050,210066000128,NKCES,905,04,26,52,0,0,0,0,0,0,0,0,0,1,1,2,0,0,0,2,1,3,49,24,73,78
20192020,012,BRACKEN,055,Bracken County,050,Taylor Elementary School,055050,012055050,210066000128,NKCES,905,All Students,234,294,0,0,0,0,0,0,0,1,1,6,2,8,0,0,0,7,6,13,281,225,506,528
20192020,012,BRACKEN,055,Bracken County,050,Taylor Elementary School,055050,012055050,210066000128,NKCES,905,PS,30,33,0,0,0,0,0,0,0,0,0,0,1,1,0,0,0,0,1,1,33,28,61,63
20192020,012,BRACKEN,055,Bracken County,050,Taylor Elementary School,055050,012055050,210066000128,NKCES,905,KG,39,43,0,0,0,0,0,0,0,0,0,3,0,3,0,0,0,0,1,1,40,38,78,82
20192020,012,BRACKEN,055,Bracken County,050,Taylor Elementary School,055050,012055050,210066000128,NKCES,905,01,42,61,0,0,0,0,0,0,0,0,0,0,1,1,0,0,0,1,2,3,60,39,99,103
20192020,012,BRACKEN,055,Bracken County,050,Taylor Elementary School,055050,012055050,210066000128,NKCES,905,02,45,42,0,0,0,0,0,0,0,1,1,1,0,1,0,0,0,0,0,0,41,44,85,87
20192020,012,BRACKEN,055,Bracken County,060,Bracken County Middle School,055060,012055060,210066001560,NKCES,905,07,47,57,0,0,0,0,0,0,0,0,0,5,0,5,0,0,0,1,1,2,51,46,97,104
20192020,012,BRACKEN,055,Bracken County,060,Bracken County Middle School,055060,012055060,210066001560,NKCES,905,All Students,131,160,0,0,0,0,0,0,0,0,0,7,2,9,0,0,0,6,5,11,147,124,271,291
20192020,012,BRACKEN,055,Bracken County,060,Bracken County Middle School,055060,012055060,210066001560,NKCES,905,06,45,53,0,0,0,0,0,0,0,0,0,0,2,2,0,0,0,2,2,4,51,41,92,98
20192020,012,BRACKEN,055,Bracken County,060,Bracken County Middle School,055060,012055060,210066001560,NKCES,905,08,39,50,0,0,0,0,0,0,0,0,0,2,0,2,0,0,0,3,2,5,45,37,82,89
20192020,013,BREATHITT,061,Breathitt County,"",---District Total---,061,"","",KVEC,904,14,0,1,0,0,0,0,0,0,0,0,0,0,0,0,0,0,0,0,0,0,1,0,1,1
20192020,013,BREATHITT,061,Breathitt County,"",---District Total---,061,"","",KVEC,904,All Students,785,982,7,3,10,0,1,1,0,3,3,6,13,19,1,0,1,4,1,5,964,764,1728,1767
20192020,013,BREATHITT,061,Breathitt County,"",---District Total---,061,"","",KVEC,904,PS,62,63,0,1,1,0,0,0,0,0,0,0,0,0,0,0,0,1,0,1,62,61,123,125
20192020,013,BREATHITT,061,Breathitt County,"",---District Total---,061,"","",KVEC,904,KG,63,69,0,0,0,0,0,0,0,0,0,0,2,2,0,0,0,0,0,0,69,61,130,132
20192020,013,BREATHITT,061,Breathitt County,"",---District Total---,061,"","",KVEC,904,01,67,79,1,1,2,0,0,0,0,0,0,1,1,2,0,0,0,2,0,2,75,65,140,146
20192020,013,BREATHITT,061,Breathitt County,"",---District Total---,061,"","",KVEC,904,02,56,53,0,0,0,0,1,1,0,0,0,1,3,4,0,0,0,0,0,0,52,52,104,109
20192020,013,BREATHITT,061,Breathitt County,"",---District Total---,061,"","",KVEC,904,03,46,73,0,0,0,0,0,0,0,1,1,0,0,0,0,0,0,0,1,1,73,44,117,119
20192020,013,BREATHITT,061,Breathitt County,"",---District Total---,061,"","",KVEC,904,04,56,75,0,1,1,0,0,0,0,0,0,1,2,3,0,0,0,0,0,0,74,53,127,131
20192020,013,BREATHITT,061,Breathitt County,"",---District Total---,061,"","",KVEC,904,05,63,73,0,0,0,0,0,0,0,1,1,0,1,1,0,0,0,0,0,0,73,61,134,136
20192020,013,BREATHITT,061,Breathitt County,"",---District Total---,061,"","",KVEC,904,06,52,63,0,0,0,0,0,0,0,0,0,1,0,1,0,0,0,1,0,1,61,52,113,115
20192020,013,BREATHITT,061,Breathitt County,"",---District Total---,061,"","",KVEC,904,11,61,90,1,0,1,0,0,0,0,1,1,0,1,1,1,0,1,1,0,1,87,59,146,151
20192020,013,BREATHITT,061,Breathitt County,"",---District Total---,061,"","",KVEC,904,12,62,74,2,1,3,0,0,0,0,0,0,0,0,0,0,0,0,0,0,0,72,61,133,136
20192020,013,BREATHITT,061,Breathitt County,"",---District Total---,061,"","",KVEC,904,07,81,80,0,0,0,0,0,0,0,0,0,0,0,0,0,0,0,0,0,0,80,81,161,161
20192020,013,BREATHITT,061,Breathitt County,"",---District Total---,061,"","",KVEC,904,08,58,91,0,0,0,0,0,0,0,0,0,1,0,1,0,0,0,0,0,0,90,58,148,149
20192020,013,BREATHITT,061,Breathitt County,"",---District Total---,061,"","",KVEC,904,09,48,87,1,0,1,0,0,0,0,0,0,0,1,1,0,0,0,0,0,0,86,47,133,135
20192020,013,BREATHITT,061,Breathitt County,"",---District Total---,061,"","",KVEC,904,10,72,74,2,0,2,0,0,0,0,0,0,1,2,3,0,0,0,0,0,0,71,70,141,146
20192020,013,BREATHITT,061,Breathitt County,025,LBJ Elementary Preschool,061025,013061025,210069002494,KVEC,904,PS,20,28,0,1,1,0,0,0,0,0,0,0,0,0,0,0,0,0,0,0,28,19,47,48
20192020,013,BREATHITT,061,Breathitt County,025,LBJ Elementary Preschool,061025,013061025,210069002494,KVEC,904,All Students,0,0,0,0,0,0,0,0,0,0,0,0,0,0,0,0,0,0,0,0,0,0,0,0
20192020,013,BREATHITT,061,Breathitt County,030,Highland-Turner Elementary School,061030,013061030,210069001659,KVEC,904,KG,12,17,0,0,0,0,0,0,0,0,0,0,0,0,0,0,0,0,0,0,17,12,29,29
20192020,013,BREATHITT,061,Breathitt County,030,Highland-Turner Elementary School,061030,013061030,210069001659,KVEC,904,All Students,80,113,0,0,0,0,1,1,0,0,0,0,2,2,0,0,0,0,1,1,113,76,189,193
20192020,013,BREATHITT,061,Breathitt County,030,Highland-Turner Elementary School,061030,013061030,210069001659,KVEC,904,PS,24,16,0,0,0,0,0,0,0,0,0,0,0,0,0,0,0,1,0,1,15,24,39,40
20192020,013,BREATHITT,061,Breathitt County,030,Highland-Turner Elementary School,061030,013061030,210069001659,KVEC,904,01,14,17,0,0,0,0,0,0,0,0,0,0,0,0,0,0,0,0,0,0,17,14,31,31
20192020,013,BREATHITT,061,Breathitt County,030,Highland-Turner Elementary School,061030,013061030,210069001659,KVEC,904,02,13,12,0,0,0,0,1,1,0,0,0,0,1,1,0,0,0,0,0,0,12,11,23,25
20192020,013,BREATHITT,061,Breathitt County,030,Highland-Turner Elementary School,061030,013061030,210069001659,KVEC,904,03,7,20,0,0,0,0,0,0,0,0,0,0,0,0,0,0,0,0,1,1,20,6,26,27
20192020,013,BREATHITT,061,Breathitt County,030,Highland-Turner Elementary School,061030,013061030,210069001659,KVEC,904,04,12,16,0,0,0,0,0,0,0,0,0,0,1,1,0,0,0,0,0,0,16,11,27,28
20192020,013,BREATHITT,061,Breathitt County,030,Highland-Turner Elementary School,061030,013061030,210069001659,KVEC,904,05,13,19,0,0,0,0,0,0,0,0,0,0,0,0,0,0,0,0,0,0,19,13,32,32
20192020,013,BREATHITT,061,Breathitt County,030,Highland-Turner Elementary School,061030,013061030,210069001659,KVEC,904,06,9,12,0,0,0,0,0,0,0,0,0,0,0,0,0,0,0,0,0,0,12,9,21,21
20192020,013,BREATHITT,061,Breathitt County,031,Breathitt Regional Juvenile Det Ctr,061031,013061031,210069001623,KVEC,904,09,0,1,0,0,0,0,0,0,0,0,0,0,0,0,0,0,0,0,0,0,1,0,1,1
20192020,013,BREATHITT,061,Breathitt County,031,Breathitt Regional Juvenile Det Ctr,061031,013061031,210069001623,KVEC,904,10,0,3,2,0,2,0,0,0,0,0,0,0,0,0,0,0,0,0,0,0,1,0,1,3
20192020,013,BREATHITT,061,Breathitt County,031,Breathitt Regional Juvenile Det Ctr,061031,013061031,210069001623,KVEC,904,12,0,3,0,0,0,0,0,0,0,0,0,0,0,0,0,0,0,0,0,0,3,0,3,3
20192020,013,BREATHITT,061,Breathitt County,031,Breathitt Regional Juvenile Det Ctr,061031,013061031,210069001623,KVEC,904,All Students,1,8,2,0,2,0,0,0,0,0,0,0,0,0,0,0,0,0,0,0,6,1,7,9
20192020,013,BREATHITT,061,Breathitt County,031,Breathitt Regional Juvenile Det Ctr,061031,013061031,210069001623,KVEC,904,08,1,1,0,0,0,0,0,0,0,0,0,0,0,0,0,0,0,0,0,0,1,1,2,2
20192020,013,BREATHITT,061,Breathitt County,033,Breathitt County Day Treatment,061033,013061033,210069001842,KVEC,904,09,0,2,1,0,1,0,0,0,0,0,0,0,0,0,0,0,0,0,0,0,1,0,1,2
20192020,013,BREATHITT,061,Breathitt County,033,Breathitt County Day Treatment,061033,013061033,210069001842,KVEC,904,10,1,2,0,0,0,0,0,0,0,0,0,0,0,0,0,0,0,0,0,0,2,1,3,3
20192020,013,BREATHITT,061,Breathitt County,033,Breathitt County Day Treatment,061033,013061033,210069001842,KVEC,904,12,1,2,0,0,0,0,0,0,0,0,0,0,0,0,0,0,0,0,0,0,2,1,3,3
20192020,013,BREATHITT,061,Breathitt County,033,Breathitt County Day Treatment,061033,013061033,210069001842,KVEC,904,11,0,3,1,0,1,0,0,0,0,0,0,0,0,0,0,0,0,0,0,0,2,0,2,3
20192020,013,BREATHITT,061,Breathitt County,033,Breathitt County Day Treatment,061033,013061033,210069001842,KVEC,904,All Students,3,15,2,0,2,0,0,0,0,0,0,0,0,0,0,0,0,0,0,0,13,3,16,18
20192020,013,BREATHITT,061,Breathitt County,033,Breathitt County Day Treatment,061033,013061033,210069001842,KVEC,904,06,0,2,0,0,0,0,0,0,0,0,0,0,0,0,0,0,0,0,0,0,2,0,2,2
20192020,013,BREATHITT,061,Breathitt County,033,Breathitt County Day Treatment,061033,013061033,210069001842,KVEC,904,07,1,1,0,0,0,0,0,0,0,0,0,0,0,0,0,0,0,0,0,0,1,1,2,2
20192020,013,BREATHITT,061,Breathitt County,033,Breathitt County Day Treatment,061033,013061033,210069001842,KVEC,904,08,0,3,0,0,0,0,0,0,0,0,0,0,0,0,0,0,0,0,0,0,3,0,3,3
20192020,013,BREATHITT,061,Breathitt County,060,Breathitt County High School,061060,013061060,210069000129,KVEC,904,12,61,69,2,1,3,0,0,0,0,0,0,0,0,0,0,0,0,0,0,0,67,60,127,130
20192020,013,BREATHITT,061,Breathitt County,060,Breathitt County High School,061060,013061060,210069000129,KVEC,904,All Students,378,476,2,1,3,0,0,0,0,1,1,2,4,6,1,0,1,1,0,1,470,372,842,854
20192020,013,BREATHITT,061,Breathitt County,060,Breathitt County High School,061060,013061060,210069000129,KVEC,904,07,80,79,0,0,0,0,0,0,0,0,0,0,0,0,0,0,0,0,0,0,79,80,159,159
20192020,013,BREATHITT,061,Breathitt County,060,Breathitt County High School,061060,013061060,210069000129,KVEC,904,08,57,87,0,0,0,0,0,0,0,0,0,1,0,1,0,0,0,0,0,0,86,57,143,144
20192020,013,BREATHITT,061,Breathitt County,060,Breathitt County High School,061060,013061060,210069000129,KVEC,904,09,48,84,0,0,0,0,0,0,0,0,0,0,1,1,0,0,0,0,0,0,84,47,131,132
20192020,013,BREATHITT,061,Breathitt County,060,Breathitt County High School,061060,013061060,210069000129,KVEC,904,10,71,69,0,0,0,0,0,0,0,0,0,1,2,3,0,0,0,0,0,0,68,69,137,140
20192020,013,BREATHITT,061,Breathitt County,060,Breathitt County High School,061060,013061060,210069000129,KVEC,904,11,61,87,0,0,0,0,0,0,0,1,1,0,1,1,1,0,1,1,0,1,85,59,144,148
20192020,013,BREATHITT,061,Breathitt County,060,Breathitt County High School,061060,013061060,210069000129,KVEC,904,14,0,1,0,0,0,0,0,0,0,0,0,0,0,0,0,0,0,0,0,0,1,0,1,1
20192020,013,BREATHITT,061,Breathitt County,150,Sebastian Elementary School,061150,013061150,210069000132,KVEC,904,05,39,36,0,0,0,0,0,0,0,1,1,0,0,0,0,0,0,0,0,0,36,38,74,75
20192020,013,BREATHITT,061,Breathitt County,150,Sebastian Elementary School,061150,013061150,210069000132,KVEC,904,All Students,217,235,1,1,2,0,0,0,0,2,2,0,2,2,0,0,0,1,0,1,233,212,445,452
20192020,013,BREATHITT,061,Breathitt County,150,Sebastian Elementary School,061150,013061150,210069000132,KVEC,904,KG,32,30,0,0,0,0,0,0,0,0,0,0,1,1,0,0,0,0,0,0,30,31,61,62
20192020,013,BREATHITT,061,Breathitt County,150,Sebastian Elementary School,061150,013061150,210069000132,KVEC,904,01,32,37,1,0,1,0,0,0,0,0,0,0,0,0,0,0,0,0,0,0,36,32,68,69
20192020,013,BREATHITT,061,Breathitt County,150,Sebastian Elementary School,061150,013061150,210069000132,KVEC,904,02,29,25,0,0,0,0,0,0,0,0,0,0,0,0,0,0,0,0,0,0,25,29,54,54
20192020,013,BREATHITT,061,Breathitt County,150,Sebastian Elementary School,061150,013061150,210069000132,KVEC,904,03,25,37,0,0,0,0,0,0,0,1,1,0,0,0,0,0,0,0,0,0,37,24,61,62
20192020,013,BREATHITT,061,Breathitt County,150,Sebastian Elementary School,061150,013061150,210069000132,KVEC,904,04,30,36,0,1,1,0,0,0,0,0,0,0,1,1,0,0,0,0,0,0,36,28,64,66
20192020,013,BREATHITT,061,Breathitt County,150,Sebastian Elementary School,061150,013061150,210069000132,KVEC,904,06,30,34,0,0,0,0,0,0,0,0,0,0,0,0,0,0,0,1,0,1,33,30,63,64
20192020,013,BREATHITT,061,Breathitt County,185,Marie Roberts-Caney Elementary School,061185,013061185,210069000133,KVEC,904,05,11,18,0,0,0,0,0,0,0,0,0,0,1,1,0,0,0,0,0,0,18,10,28,29
20192020,013,BREATHITT,061,Breathitt County,185,Marie Roberts-Caney Elementary School,061185,013061185,210069000133,KVEC,904,All Students,106,135,0,1,1,0,0,0,0,0,0,4,5,9,0,0,0,2,0,2,129,100,229,241
20192020,013,BREATHITT,061,Breathitt County,185,Marie Roberts-Caney Elementary School,061185,013061185,210069000133,KVEC,904,PS,18,19,0,0,0,0,0,0,0,0,0,0,0,0,0,0,0,0,0,0,19,18,37,37
20192020,013,BREATHITT,061,Breathitt County,185,Marie Roberts-Caney Elementary School,061185,013061185,210069000133,KVEC,904,KG,19,22,0,0,0,0,0,0,0,0,0,0,1,1,0,0,0,0,0,0,22,18,40,41
20192020,013,BREATHITT,061,Breathitt County,185,Marie Roberts-Caney Elementary School,061185,013061185,210069000133,KVEC,904,01,21,25,0,1,1,0,0,0,0,0,0,1,1,2,0,0,0,2,0,2,22,19,41,46
20192020,013,BREATHITT,061,Breathitt County,185,Marie Roberts-Caney Elementary School,061185,013061185,210069000133,KVEC,904,02,14,16,0,0,0,0,0,0,0,0,0,1,2,3,0,0,0,0,0,0,15,12,27,30
20192020,013,BREATHITT,061,Breathitt County,185,Marie Roberts-Caney Elementary School,061185,013061185,210069000133,KVEC,904,03,14,16,0,0,0,0,0,0,0,0,0,0,0,0,0,0,0,0,0,0,16,14,30,30
20192020,013,BREATHITT,061,Breathitt County,185,Marie Roberts-Caney Elementary School,061185,013061185,210069000133,KVEC,904,04,14,23,0,0,0,0,0,0,0,0,0,1,0,1,0,0,0,0,0,0,22,14,36,37
20192020,013,BREATHITT,061,Breathitt County,185,Marie Roberts-Caney Elementary School,061185,013061185,210069000133,KVEC,904,06,13,15,0,0,0,0,0,0,0,0,0,1,0,1,0,0,0,0,0,0,14,13,27,28
20192020,014,BRECKINRIDGE,065,Breckinridge County,"",---District Total---,065,"","",GRREC,902,11,90,130,3,0,3,0,1,1,1,2,3,3,4,7,0,0,0,3,4,7,120,79,199,220
20192020,014,BRECKINRIDGE,065,Breckinridge County,"",---District Total---,065,"","",GRREC,902,All Students,1189,1375,29,32,61,4,5,9,8,5,13,32,24,56,0,2,2,54,51,105,1248,1070,2318,2564
20192020,014,BRECKINRIDGE,065,Breckinridge County,"",---District Total---,065,"","",GRREC,902,PS,72,90,0,0,0,0,0,0,1,1,2,5,3,8,0,1,1,6,1,7,78,66,144,162
20192020,014,BRECKINRIDGE,065,Breckinridge County,"",---District Total---,065,"","",GRREC,902,KG,67,117,3,2,5,0,0,0,1,0,1,2,1,3,0,0,0,5,2,7,106,62,168,184
20192020,014,BRECKINRIDGE,065,Breckinridge County,"",---District Total---,065,"","",GRREC,902,01,90,98,1,2,3,0,1,1,1,0,1,2,1,3,0,0,0,5,4,9,89,82,171,188
20192020,014,BRECKINRIDGE,065,Breckinridge County,"",---District Total---,065,"","",GRREC,902,02,68,97,1,3,4,0,0,0,0,1,1,3,0,3,0,0,0,5,9,14,88,55,143,165
20192020,014,BRECKINRIDGE,065,Breckinridge County,"",---District Total---,065,"","",GRREC,902,03,72,88,0,3,3,0,1,1,0,1,1,2,2,4,0,0,0,7,1,8,79,64,143,160
20192020,014,BRECKINRIDGE,065,Breckinridge County,"",---District Total---,065,"","",GRREC,902,04,88,109,2,3,5,1,0,1,1,0,1,4,0,4,0,1,1,3,5,8,98,79,177,197
20192020,014,BRECKINRIDGE,065,Breckinridge County,"",---District Total---,065,"","",GRREC,902,05,86,94,1,2,3,1,0,1,1,0,1,2,1,3,0,0,0,3,6,9,86,77,163,180
20192020,014,BRECKINRIDGE,065,Breckinridge County,"",---District Total---,065,"","",GRREC,902,06,109,101,0,3,3,1,1,2,2,0,2,0,2,2,0,1,1,6,4,10,92,98,190,210
20192020,014,BRECKINRIDGE,065,Breckinridge County,"",---District Total---,065,"","",GRREC,902,07,112,91,5,2,7,0,1,1,0,0,0,4,4,8,0,0,0,3,2,5,79,103,182,203
20192020,014,BRECKINRIDGE,065,Breckinridge County,"",---District Total---,065,"","",GRREC,902,08,93,108,4,3,7,1,0,1,0,0,0,1,3,4,0,0,0,2,5,7,100,82,182,201
20192020,014,BRECKINRIDGE,065,Breckinridge County,"",---District Total---,065,"","",GRREC,902,09,112,115,2,3,5,0,0,0,0,0,0,1,3,4,0,0,0,1,5,6,111,101,212,227
20192020,014,BRECKINRIDGE,065,Breckinridge County,"",---District Total---,065,"","",GRREC,902,10,113,118,3,3,6,0,0,0,1,0,1,4,1,5,0,0,0,6,0,6,104,109,213,231
20192020,014,BRECKINRIDGE,065,Breckinridge County,"",---District Total---,065,"","",GRREC,902,12,88,108,4,3,7,0,0,0,0,1,1,4,2,6,0,0,0,5,4,9,95,78,173,196
20192020,014,BRECKINRIDGE,065,Breckinridge County,"",---District Total---,065,"","",GRREC,902,14,1,1,0,0,0,0,0,0,0,0,0,0,0,0,0,0,0,0,0,0,1,1,2,2
20192020,014,BRECKINRIDGE,065,Breckinridge County,010,Breckinridge County High School,065010,014065010,210072000137,GRREC,902,All Students,411,480,12,9,21,1,1,2,2,3,5,12,10,22,0,0,0,15,13,28,438,375,813,891
20192020,014,BRECKINRIDGE,065,Breckinridge County,010,Breckinridge County High School,065010,014065010,210072000137,GRREC,902,08,7,8,0,0,0,1,0,1,0,0,0,0,0,0,0,0,0,0,0,0,7,7,14,15
20192020,014,BRECKINRIDGE,065,Breckinridge County,010,Breckinridge County High School,065010,014065010,210072000137,GRREC,902,09,112,115,2,3,5,0,0,0,0,0,0,1,3,4,0,0,0,1,5,6,111,101,212,227
20192020,014,BRECKINRIDGE,065,Breckinridge County,010,Breckinridge County High School,065010,014065010,210072000137,GRREC,902,10,113,118,3,3,6,0,0,0,1,0,1,4,1,5,0,0,0,6,0,6,104,109,213,231
20192020,014,BRECKINRIDGE,065,Breckinridge County,010,Breckinridge County High School,065010,014065010,210072000137,GRREC,902,11,90,130,3,0,3,0,1,1,1,2,3,3,4,7,0,0,0,3,4,7,120,79,199,220
20192020,014,BRECKINRIDGE,065,Breckinridge County,010,Breckinridge County High School,065010,014065010,210072000137,GRREC,902,12,88,108,4,3,7,0,0,0,0,1,1,4,2,6,0,0,0,5,4,9,95,78,173,196
20192020,014,BRECKINRIDGE,065,Breckinridge County,010,Breckinridge County High School,065010,014065010,210072000137,GRREC,902,14,1,1,0,0,0,0,0,0,0,0,0,0,0,0,0,0,0,0,0,0,1,1,2,2
20192020,014,BRECKINRIDGE,065,Breckinridge County,020,Hardinsburg Elementary School,065020,014065020,210072000138,GRREC,902,05,29,30,1,0,1,0,0,0,1,0,1,1,0,1,0,0,0,1,2,3,26,27,53,59
20192020,014,BRECKINRIDGE,065,Breckinridge County,020,Hardinsburg Elementary School,065020,014065020,210072000138,GRREC,902,04,28,44,1,2,3,0,0,0,1,0,1,1,0,1,0,0,0,3,4,7,38,22,60,72
20192020,014,BRECKINRIDGE,065,Breckinridge County,020,Hardinsburg Elementary School,065020,014065020,210072000138,GRREC,902,All Students,160,219,5,8,13,0,0,0,3,1,4,5,2,7,0,0,0,11,10,21,195,139,334,379
20192020,014,BRECKINRIDGE,065,Breckinridge County,020,Hardinsburg Elementary School,065020,014065020,210072000138,GRREC,902,PS,29,36,0,0,0,0,0,0,0,1,1,3,0,3,0,0,0,3,0,3,30,28,58,65
20192020,014,BRECKINRIDGE,065,Breckinridge County,020,Hardinsburg Elementary School,065020,014065020,210072000138,GRREC,902,KG,26,43,1,2,3,0,0,0,0,0,0,1,0,1,0,0,0,4,1,5,37,23,60,69
20192020,014,BRECKINRIDGE,065,Breckinridge County,020,Hardinsburg Elementary School,065020,014065020,210072000138,GRREC,902,01,32,36,1,1,2,0,0,0,1,0,1,0,0,0,0,0,0,0,1,1,34,30,64,68
20192020,014,BRECKINRIDGE,065,Breckinridge County,020,Hardinsburg Elementary School,065020,014065020,210072000138,GRREC,902,02,25,37,1,1,2,0,0,0,0,1,1,2,0,2,0,0,0,2,2,4,32,21,53,62
20192020,014,BRECKINRIDGE,065,Breckinridge County,020,Hardinsburg Elementary School,065020,014065020,210072000138,GRREC,902,03,20,29,0,2,2,0,0,0,0,0,0,0,2,2,0,0,0,1,0,1,28,16,44,49
20192020,014,BRECKINRIDGE,065,Breckinridge County,030,Ben Johnson Elementary School,065030,014065030,210072000139,GRREC,902,04,19,27,0,0,0,0,0,0,0,0,0,0,0,0,0,0,0,0,0,0,27,19,46,46
20192020,014,BRECKINRIDGE,065,Breckinridge County,030,Ben Johnson Elementary School,065030,014065030,210072000139,GRREC,902,All Students,94,125,0,0,0,0,1,1,0,0,0,0,0,0,0,0,0,2,4,6,123,89,212,219
20192020,014,BRECKINRIDGE,065,Breckinridge County,030,Ben Johnson Elementary School,065030,014065030,210072000139,GRREC,902,PS,10,10,0,0,0,0,0,0,0,0,0,0,1,1,0,0,0,0,0,0,10,9,19,20
20192020,014,BRECKINRIDGE,065,Breckinridge County,030,Ben Johnson Elementary School,065030,014065030,210072000139,GRREC,902,KG,14,21,0,0,0,0,0,0,0,0,0,0,0,0,0,0,0,0,0,0,21,14,35,35
20192020,014,BRECKINRIDGE,065,Breckinridge County,030,Ben Johnson Elementary School,065030,014065030,210072000139,GRREC,902,01,20,21,0,0,0,0,1,1,0,0,0,0,0,0,0,0,0,1,1,2,20,18,38,41
20192020,014,BRECKINRIDGE,065,Breckinridge County,030,Ben Johnson Elementary School,065030,014065030,210072000139,GRREC,902,02,10,22,0,0,0,0,0,0,0,0,0,0,0,0,0,0,0,0,2,2,22,8,30,32
20192020,014,BRECKINRIDGE,065,Breckinridge County,030,Ben Johnson Elementary School,065030,014065030,210072000139,GRREC,902,03,13,19,0,0,0,0,0,0,0,0,0,0,0,0,0,0,0,1,0,1,18,13,31,32
20192020,014,BRECKINRIDGE,065,Breckinridge County,030,Ben Johnson Elementary School,065030,014065030,210072000139,GRREC,902,05,18,15,0,0,0,0,0,0,0,0,0,0,0,0,0,0,0,0,1,1,15,17,32,33
20192020,014,BRECKINRIDGE,065,Breckinridge County,040,Custer Elementary School,065040,014065040,210072000140,GRREC,902,02,10,11,0,0,0,0,0,0,0,0,0,1,0,1,0,0,0,1,0,1,9,10,19,21
20192020,014,BRECKINRIDGE,065,Breckinridge County,040,Custer Elementary School,065040,014065040,210072000140,GRREC,902,All Students,66,82,0,0,0,0,0,0,1,0,1,4,3,7,0,0,0,5,0,5,72,63,135,148
20192020,014,BRECKINRIDGE,065,Breckinridge County,040,Custer Elementary School,065040,014065040,210072000140,GRREC,902,05,12,16,0,0,0,0,0,0,0,0,0,0,1,1,0,0,0,1,0,1,15,11,26,28
20192020,014,BRECKINRIDGE,065,Breckinridge County,040,Custer Elementary School,065040,014065040,210072000140,GRREC,902,PS,8,12,0,0,0,0,0,0,1,0,1,0,0,0,0,0,0,1,1,2,10,7,17,20
20192020,014,BRECKINRIDGE,065,Breckinridge County,040,Custer Elementary School,065040,014065040,210072000140,GRREC,902,KG,10,17,0,0,0,0,0,0,1,0,1,0,1,1,0,0,0,0,0,0,16,9,25,27
20192020,014,BRECKINRIDGE,065,Breckinridge County,040,Custer Elementary School,065040,014065040,210072000140,GRREC,902,01,11,16,0,0,0,0,0,0,0,0,0,1,1,2,0,0,0,1,0,1,14,10,24,27
20192020,014,BRECKINRIDGE,065,Breckinridge County,040,Custer Elementary School,065040,014065040,210072000140,GRREC,902,04,11,6,0,0,0,0,0,0,0,0,0,2,0,2,0,0,0,0,0,0,4,11,15,17
20192020,014,BRECKINRIDGE,065,Breckinridge County,040,Custer Elementary School,065040,014065040,210072000140,GRREC,902,03,12,16,0,0,0,0,0,0,0,0,0,0,0,0,0,0,0,2,0,2,14,12,26,28
20192020,014,BRECKINRIDGE,065,Breckinridge County,050,Irvington Elementary School,065050,014065050,210072000141,GRREC,902,03,27,24,0,1,1,0,1,1,0,1,1,2,0,2,0,0,0,3,1,4,19,23,42,51
20192020,014,BRECKINRIDGE,065,Breckinridge County,050,Irvington Elementary School,065050,014065050,210072000141,GRREC,902,All Students,151,176,3,7,10,2,1,3,0,1,1,6,0,6,0,1,1,10,13,23,155,128,283,327
20192020,014,BRECKINRIDGE,065,Breckinridge County,050,Irvington Elementary School,065050,014065050,210072000141,GRREC,902,PS,25,32,0,0,0,0,0,0,0,0,0,2,2,4,0,1,1,2,0,2,28,22,50,57
20192020,014,BRECKINRIDGE,065,Breckinridge County,050,Irvington Elementary School,065050,014065050,210072000141,GRREC,902,KG,17,36,2,0,2,0,0,0,0,0,0,1,0,1,0,0,0,1,1,2,32,16,48,53
20192020,014,BRECKINRIDGE,065,Breckinridge County,050,Irvington Elementary School,065050,014065050,210072000141,GRREC,902,01,27,25,0,1,1,0,0,0,0,0,0,1,0,1,0,0,0,3,2,5,21,24,45,52
20192020,014,BRECKINRIDGE,065,Breckinridge County,050,Irvington Elementary School,065050,014065050,210072000141,GRREC,902,02,23,27,0,2,2,0,0,0,0,0,0,0,0,0,0,0,0,2,5,7,25,16,41,50
20192020,014,BRECKINRIDGE,065,Breckinridge County,050,Irvington Elementary School,065050,014065050,210072000141,GRREC,902,04,30,32,1,1,2,1,0,1,0,0,0,1,0,1,0,1,1,0,1,1,29,27,56,62
20192020,014,BRECKINRIDGE,065,Breckinridge County,050,Irvington Elementary School,065050,014065050,210072000141,GRREC,902,05,27,32,0,2,2,1,0,1,0,0,0,1,0,1,0,0,0,1,3,4,29,22,51,59
20192020,014,BRECKINRIDGE,065,Breckinridge County,100,Breckinridge County Middle School,065100,014065100,210072001304,GRREC,902,All Students,307,293,9,8,17,1,2,3,2,0,2,5,9,14,0,1,1,11,11,22,265,276,541,600
20192020,014,BRECKINRIDGE,065,Breckinridge County,100,Breckinridge County Middle School,065100,014065100,210072001304,GRREC,902,05,0,1,0,0,0,0,0,0,0,0,0,0,0,0,0,0,0,0,0,0,1,0,1,1
20192020,014,BRECKINRIDGE,065,Breckinridge County,100,Breckinridge County Middle School,065100,014065100,210072001304,GRREC,902,06,109,101,0,3,3,1,1,2,2,0,2,0,2,2,0,1,1,6,4,10,92,98,190,210
20192020,014,BRECKINRIDGE,065,Breckinridge County,100,Breckinridge County Middle School,065100,014065100,210072001304,GRREC,902,07,112,91,5,2,7,0,1,1,0,0,0,4,4,8,0,0,0,3,2,5,79,103,182,203
20192020,014,BRECKINRIDGE,065,Breckinridge County,100,Breckinridge County Middle School,065100,014065100,210072001304,GRREC,902,08,86,100,4,3,7,0,0,0,0,0,0,1,3,4,0,0,0,2,5,7,93,75,168,186
20192020,015,BULLITT,071,Bullitt County,"",---District Total---,071,"","",OVEC,906,02,352,432,7,6,13,1,1,2,2,1,3,14,13,27,0,0,0,19,22,41,389,309,698,784
20192020,015,BULLITT,071,Bullitt County,"",---District Total---,071,"","",OVEC,906,03,445,476,5,3,8,0,1,1,3,7,10,20,22,42,0,0,0,16,22,38,432,390,822,921
20192020,015,BULLITT,071,Bullitt County,"",---District Total---,071,"","",OVEC,906,04,456,492,5,6,11,0,0,0,2,6,8,15,16,31,0,0,0,17,19,36,453,409,862,948
20192020,015,BULLITT,071,Bullitt County,"",---District Total---,071,"","",OVEC,906,05,506,521,5,3,8,1,0,1,9,3,12,37,19,56,1,0,1,20,22,42,448,459,907,1027
20192020,015,BULLITT,071,Bullitt County,"",---District Total---,071,"","",OVEC,906,06,549,546,10,12,22,0,0,0,4,5,9,19,23,42,0,0,0,19,23,42,494,486,980,1095
20192020,015,BULLITT,071,Bullitt County,"",---District Total---,071,"","",OVEC,906,07,496,553,10,6,16,2,0,2,4,3,7,22,18,40,0,0,0,12,20,32,503,449,952,1049
20192020,015,BULLITT,071,Bullitt County,"",---District Total---,071,"","",OVEC,906,08,489,486,9,5,14,1,2,3,3,3,6,25,13,38,0,0,0,16,16,32,432,450,882,975
20192020,015,BULLITT,071,Bullitt County,"",---District Total---,071,"","",OVEC,906,09,490,530,10,5,15,3,1,4,4,5,9,27,15,42,1,0,1,11,13,24,474,451,925,1020
20192020,015,BULLITT,071,Bullitt County,"",---District Total---,071,"","",OVEC,906,10,475,496,6,3,9,2,3,5,8,3,11,22,13,35,1,0,1,8,9,17,449,444,893,971
20192020,015,BULLITT,071,Bullitt County,"",---District Total---,071,"","",OVEC,906,11,524,530,3,8,11,2,0,2,7,6,13,20,19,39,0,0,0,10,10,20,488,481,969,1054
20192020,015,BULLITT,071,Bullitt County,"",---District Total---,071,"","",OVEC,906,14,2,6,0,0,0,0,0,0,0,0,0,0,0,0,0,0,0,0,0,0,6,2,8,8
20192020,015,BULLITT,071,Bullitt County,"",---District Total---,071,"","",OVEC,906,12,413,530,8,1,9,1,3,4,2,2,4,20,9,29,0,0,0,14,8,22,485,390,875,943
20192020,015,BULLITT,071,Bullitt County,"",---District Total---,071,"","",OVEC,906,All Students,6084,6633,89,69,158,14,13,27,54,50,104,288,223,511,4,3,7,206,220,426,5978,5506,11484,12717
20192020,015,BULLITT,071,Bullitt County,"",---District Total---,071,"","",OVEC,906,PS,159,255,9,2,11,1,0,1,4,2,6,10,7,17,0,1,1,16,9,25,215,138,353,414
20192020,015,BULLITT,071,Bullitt County,"",---District Total---,071,"","",OVEC,906,KG,465,519,7,5,12,0,1,1,1,2,3,21,18,39,1,1,2,28,22,50,461,416,877,984
20192020,015,BULLITT,071,Bullitt County,"",---District Total---,071,"","",OVEC,906,01,422,516,4,6,10,1,1,2,5,4,9,26,25,51,0,2,2,16,14,30,464,370,834,938
20192020,015,BULLITT,071,Bullitt County,005,Bernheim Middle School,071005,015071005,210075000414,OVEC,906,07,72,87,0,1,1,0,0,0,0,0,0,2,2,4,0,0,0,2,1,3,83,68,151,159
20192020,015,BULLITT,071,Bullitt County,005,Bernheim Middle School,071005,015071005,210075000414,OVEC,906,All Students,226,250,0,4,4,0,1,1,0,0,0,8,5,13,0,0,0,5,5,10,237,211,448,476
20192020,015,BULLITT,071,Bullitt County,005,Bernheim Middle School,071005,015071005,210075000414,OVEC,906,06,78,91,0,2,2,0,0,0,0,0,0,2,3,5,0,0,0,2,2,4,87,71,158,169
20192020,015,BULLITT,071,Bullitt County,005,Bernheim Middle School,071005,015071005,210075000414,OVEC,906,08,76,72,0,1,1,0,1,1,0,0,0,4,0,4,0,0,0,1,2,3,67,72,139,148
20192020,015,BULLITT,071,Bullitt County,006,Freedom Elementary School,071006,015071006,210075001958,OVEC,906,04,31,44,2,0,2,0,0,0,0,1,1,1,3,4,0,0,0,0,0,0,41,27,68,75
20192020,015,BULLITT,071,Bullitt County,006,Freedom Elementary School,071006,015071006,210075001958,OVEC,906,All Students,199,267,5,4,9,0,2,2,1,4,5,5,11,16,0,0,0,6,8,14,250,170,420,466
20192020,015,BULLITT,071,Bullitt County,006,Freedom Elementary School,071006,015071006,210075001958,OVEC,906,PS,11,15,2,0,2,0,0,0,0,1,1,0,0,0,0,0,0,2,0,2,11,10,21,26
20192020,015,BULLITT,071,Bullitt County,006,Freedom Elementary School,071006,015071006,210075001958,OVEC,906,KG,40,54,0,0,0,0,1,1,0,1,1,1,2,3,0,0,0,2,0,2,51,36,87,94
20192020,015,BULLITT,071,Bullitt County,006,Freedom Elementary School,071006,015071006,210075001958,OVEC,906,01,35,45,0,1,1,0,0,0,0,1,1,0,4,4,0,0,0,0,0,0,45,29,74,80
20192020,015,BULLITT,071,Bullitt County,006,Freedom Elementary School,071006,015071006,210075001958,OVEC,906,02,23,36,2,1,3,0,1,1,0,0,0,0,0,0,0,0,0,1,2,3,33,19,52,59
20192020,015,BULLITT,071,Bullitt County,006,Freedom Elementary School,071006,015071006,210075001958,OVEC,906,03,35,42,1,1,2,0,0,0,0,1,1,0,2,2,0,0,0,2,2,4,39,29,68,77
20192020,015,BULLITT,071,Bullitt County,006,Freedom Elementary School,071006,015071006,210075001958,OVEC,906,05,35,46,0,1,1,0,0,0,1,0,1,3,0,3,0,0,0,1,4,5,41,30,71,81
20192020,015,BULLITT,071,Bullitt County,007,Zoneton Middle School,071007,015071007,210075001973,OVEC,906,07,63,91,3,1,4,1,0,1,0,0,0,7,3,10,0,0,0,0,2,2,80,57,137,154
20192020,015,BULLITT,071,Bullitt County,007,Zoneton Middle School,071007,015071007,210075001973,OVEC,906,All Students,211,232,9,5,14,2,0,2,2,3,5,14,17,31,0,0,0,4,13,17,201,173,374,443
20192020,015,BULLITT,071,Bullitt County,007,Zoneton Middle School,071007,015071007,210075001973,OVEC,906,06,81,72,4,3,7,0,0,0,1,2,3,3,7,10,0,0,0,2,5,7,62,64,126,153
20192020,015,BULLITT,071,Bullitt County,007,Zoneton Middle School,071007,015071007,210075001973,OVEC,906,08,67,69,2,1,3,1,0,1,1,1,2,4,7,11,0,0,0,2,6,8,59,52,111,136
20192020,015,BULLITT,071,Bullitt County,008,Shepherdsville Elementary,071008,015071008,210075001974,OVEC,906,02,37,41,0,0,0,0,0,0,0,0,0,2,2,4,0,0,0,2,2,4,37,33,70,78
20192020,015,BULLITT,071,Bullitt County,008,Shepherdsville Elementary,071008,015071008,210075001974,OVEC,906,All Students,234,291,3,4,7,0,0,0,1,1,2,21,8,29,1,1,2,12,13,25,253,207,460,525
20192020,015,BULLITT,071,Bullitt County,008,Shepherdsville Elementary,071008,015071008,210075001974,OVEC,906,PS,13,20,1,0,1,0,0,0,0,0,0,1,1,2,0,0,0,3,0,3,15,12,27,33
20192020,015,BULLITT,071,Bullitt County,008,Shepherdsville Elementary,071008,015071008,210075001974,OVEC,906,KG,42,49,1,2,3,0,0,0,0,1,1,7,2,9,0,0,0,0,2,2,41,35,76,91
20192020,015,BULLITT,071,Bullitt County,008,Shepherdsville Elementary,071008,015071008,210075001974,OVEC,906,01,35,59,1,0,1,0,0,0,1,0,1,5,0,5,0,1,1,5,3,8,47,31,78,94
20192020,015,BULLITT,071,Bullitt County,008,Shepherdsville Elementary,071008,015071008,210075001974,OVEC,906,03,34,41,0,0,0,0,0,0,0,0,0,0,1,1,0,0,0,0,2,2,41,31,72,75
20192020,015,BULLITT,071,Bullitt County,008,Shepherdsville Elementary,071008,015071008,210075001974,OVEC,906,04,48,45,1,2,3,0,0,0,0,0,0,2,1,3,0,0,0,1,3,4,41,42,83,93
20192020,015,BULLITT,071,Bullitt County,008,Shepherdsville Elementary,071008,015071008,210075001974,OVEC,906,05,38,56,0,0,0,0,0,0,0,0,0,5,2,7,1,0,1,4,1,5,46,35,81,94
20192020,015,BULLITT,071,Bullitt County,009,Eastside Middle School,071009,015071009,210075001975,OVEC,906,08,104,100,1,1,2,0,0,0,0,1,1,2,0,2,0,0,0,4,1,5,93,101,194,204
20192020,015,BULLITT,071,Bullitt County,009,Eastside Middle School,071009,015071009,210075001975,OVEC,906,All Students,327,322,3,2,5,0,0,0,2,2,4,2,5,7,0,0,0,10,10,20,305,308,613,649
20192020,015,BULLITT,071,Bullitt County,009,Eastside Middle School,071009,015071009,210075001975,OVEC,906,06,118,100,0,0,0,0,0,0,1,1,2,0,5,5,0,0,0,3,5,8,96,107,203,218
20192020,015,BULLITT,071,Bullitt County,009,Eastside Middle School,071009,015071009,210075001975,OVEC,906,07,105,122,2,1,3,0,0,0,1,0,1,0,0,0,0,0,0,3,4,7,116,100,216,227
20192020,015,BULLITT,071,Bullitt County,010,Brooks Elementary School,071010,015071010,210075000144,OVEC,906,01,41,31,1,2,3,0,1,1,0,1,1,2,4,6,0,0,0,1,1,2,27,32,59,72
20192020,015,BULLITT,071,Bullitt County,010,Brooks Elementary School,071010,015071010,210075000144,OVEC,906,02,25,34,0,1,1,0,0,0,1,0,1,2,3,5,0,0,0,0,4,4,31,17,48,59
20192020,015,BULLITT,071,Bullitt County,010,Brooks Elementary School,071010,015071010,210075000144,OVEC,906,03,38,33,0,0,0,0,0,0,0,1,1,4,5,9,0,0,0,1,1,2,28,31,59,71
20192020,015,BULLITT,071,Bullitt County,010,Brooks Elementary School,071010,015071010,210075000144,OVEC,906,05,41,39,1,1,2,0,0,0,2,0,2,10,8,18,0,0,0,1,5,6,25,27,52,80
20192020,015,BULLITT,071,Bullitt County,010,Brooks Elementary School,071010,015071010,210075000144,OVEC,906,04,36,33,0,0,0,0,0,0,0,0,0,2,3,5,0,0,0,2,1,3,29,32,61,69
20192020,015,BULLITT,071,Bullitt County,010,Brooks Elementary School,071010,015071010,210075000144,OVEC,906,All Students,215,210,3,4,7,0,1,1,4,2,6,22,25,47,0,0,0,8,13,21,173,170,343,425
20192020,015,BULLITT,071,Bullitt County,010,Brooks Elementary School,071010,015071010,210075000144,OVEC,906,PS,22,30,0,0,0,0,0,0,0,0,0,3,2,5,0,0,0,0,4,4,27,16,43,52
20192020,015,BULLITT,071,Bullitt County,010,Brooks Elementary School,071010,015071010,210075000144,OVEC,906,KG,34,40,1,0,1,0,0,0,1,0,1,2,2,4,0,0,0,3,1,4,33,31,64,74
20192020,015,BULLITT,071,Bullitt County,015,Bullitt Central High School,071015,015071015,210075000145,OVEC,906,12,149,165,4,0,4,0,2,2,1,0,1,7,4,11,0,0,0,3,3,6,150,140,290,314
20192020,015,BULLITT,071,Bullitt County,015,Bullitt Central High School,071015,015071015,210075000145,OVEC,906,All Students,612,645,8,4,12,4,2,6,7,3,10,27,14,41,0,0,0,13,7,20,586,582,1168,1257
20192020,015,BULLITT,071,Bullitt County,015,Bullitt Central High School,071015,015071015,210075000145,OVEC,906,09,151,152,2,1,3,2,0,2,1,1,2,8,2,10,0,0,0,3,1,4,136,146,282,303
20192020,015,BULLITT,071,Bullitt County,015,Bullitt Central High School,071015,015071015,210075000145,OVEC,906,10,148,153,1,2,3,1,0,1,3,0,3,4,3,7,0,0,0,6,0,6,138,143,281,301
20192020,015,BULLITT,071,Bullitt County,015,Bullitt Central High School,071015,015071015,210075000145,OVEC,906,11,163,175,1,1,2,1,0,1,2,2,4,8,5,13,0,0,0,1,3,4,162,152,314,338
20192020,015,BULLITT,071,Bullitt County,015,Bullitt Central High School,071015,015071015,210075000145,OVEC,906,14,1,0,0,0,0,0,0,0,0,0,0,0,0,0,0,0,0,0,0,0,0,1,1,1
20192020,015,BULLITT,071,Bullitt County,016,Bullitt East High School,071016,015071016,210075001409,OVEC,906,12,147,181,1,1,2,1,1,2,0,0,0,3,2,5,0,0,0,7,2,9,169,141,310,328
20192020,015,BULLITT,071,Bullitt County,016,Bullitt East High School,071016,015071016,210075001409,OVEC,906,All Students,698,723,8,6,14,2,5,7,6,7,13,18,16,34,1,0,1,16,14,30,672,650,1322,1421
20192020,015,BULLITT,071,Bullitt County,016,Bullitt East High School,071016,015071016,210075001409,OVEC,906,09,187,210,4,3,7,1,1,2,1,2,3,6,5,11,1,0,1,6,6,12,191,170,361,397
20192020,015,BULLITT,071,Bullitt County,016,Bullitt East High School,071016,015071016,210075001409,OVEC,906,10,167,162,2,0,2,0,3,3,2,2,4,4,4,8,0,0,0,0,4,4,154,154,308,329
20192020,015,BULLITT,071,Bullitt County,016,Bullitt East High School,071016,015071016,210075001409,OVEC,906,11,196,166,1,2,3,0,0,0,3,3,6,5,5,10,0,0,0,3,2,5,154,184,338,362
20192020,015,BULLITT,071,Bullitt County,016,Bullitt East High School,071016,015071016,210075001409,OVEC,906,14,1,4,0,0,0,0,0,0,0,0,0,0,0,0,0,0,0,0,0,0,4,1,5,5
20192020,015,BULLITT,071,Bullitt County,018,Bullitt Lick Middle School,071018,015071018,210075001410,OVEC,906,07,82,89,4,2,6,1,0,1,0,0,0,5,3,8,0,0,0,3,3,6,76,74,150,171
20192020,015,BULLITT,071,Bullitt County,018,Bullitt Lick Middle School,071018,015071018,210075001410,OVEC,906,All Students,280,281,9,5,14,1,1,2,1,1,2,16,8,24,0,0,0,13,10,23,241,255,496,561
20192020,015,BULLITT,071,Bullitt County,018,Bullitt Lick Middle School,071018,015071018,210075001410,OVEC,906,06,112,102,3,3,6,0,0,0,0,1,1,5,4,9,0,0,0,5,5,10,89,99,188,214
20192020,015,BULLITT,071,Bullitt County,018,Bullitt Lick Middle School,071018,015071018,210075001410,OVEC,906,08,86,90,2,0,2,0,1,1,1,0,1,6,1,7,0,0,0,5,2,7,76,82,158,176
20192020,015,BULLITT,071,Bullitt County,020,Cedar Grove Elementary,071020,015071020,210075000146,OVEC,906,04,44,46,0,0,0,0,0,0,1,1,2,1,1,2,0,0,0,0,1,1,44,41,85,90
20192020,015,BULLITT,071,Bullitt County,020,Cedar Grove Elementary,071020,015071020,210075000146,OVEC,906,All Students,210,227,0,0,0,1,0,1,2,3,5,8,3,11,0,0,0,4,11,15,212,193,405,437
20192020,015,BULLITT,071,Bullitt County,020,Cedar Grove Elementary,071020,015071020,210075000146,OVEC,906,PS,25,32,1,0,1,0,0,0,0,1,1,1,2,3,0,0,0,1,1,2,29,21,50,57
20192020,015,BULLITT,071,Bullitt County,020,Cedar Grove Elementary,071020,015071020,210075000146,OVEC,906,KG,37,40,0,0,0,0,0,0,0,0,0,1,0,1,0,0,0,1,1,2,38,36,74,77
20192020,015,BULLITT,071,Bullitt County,020,Cedar Grove Elementary,071020,015071020,210075000146,OVEC,906,01,19,40,0,0,0,1,0,1,0,1,1,1,1,2,0,0,0,1,1,2,37,16,53,59
20192020,015,BULLITT,071,Bullitt County,020,Cedar Grove Elementary,071020,015071020,210075000146,OVEC,906,02,24,30,0,0,0,0,0,0,0,0,0,1,0,1,0,0,0,1,2,3,28,22,50,54
20192020,015,BULLITT,071,Bullitt County,020,Cedar Grove Elementary,071020,015071020,210075000146,OVEC,906,03,36,29,0,0,0,0,0,0,0,1,1,1,1,2,0,0,0,0,4,4,28,30,58,65
20192020,015,BULLITT,071,Bullitt County,020,Cedar Grove Elementary,071020,015071020,210075000146,OVEC,906,05,50,42,0,0,0,0,0,0,1,0,1,3,0,3,0,0,0,1,2,3,37,48,85,92
20192020,015,BULLITT,071,Bullitt County,025,Hebron Middle School,071025,015071025,210075000147,OVEC,906,06,82,96,0,2,2,0,0,0,1,1,2,6,1,7,0,0,0,2,4,6,87,74,161,178
20192020,015,BULLITT,071,Bullitt County,025,Hebron Middle School,071025,015071025,210075000147,OVEC,906,08,77,69,2,1,3,0,0,0,1,1,2,6,3,9,0,0,0,2,2,4,58,70,128,146
20192020,015,BULLITT,071,Bullitt County,025,Hebron Middle School,071025,015071025,210075000147,OVEC,906,All Students,255,247,2,4,6,0,0,0,3,4,7,18,9,27,0,0,0,6,11,17,218,227,445,502
20192020,015,BULLITT,071,Bullitt County,025,Hebron Middle School,071025,015071025,210075000147,OVEC,906,07,96,82,0,1,1,0,0,0,1,2,3,6,5,11,0,0,0,2,5,7,73,83,156,178
20192020,015,BULLITT,071,Bullitt County,030,Lebanon Junction Elementary,071030,015071030,210075000148,OVEC,906,05,42,36,0,0,0,0,0,0,0,0,0,0,2,2,0,0,0,0,2,2,36,38,74,78
20192020,015,BULLITT,071,Bullitt County,030,Lebanon Junction Elementary,071030,015071030,210075000148,OVEC,906,All Students,193,203,1,0,1,1,0,1,0,0,0,7,4,11,0,1,1,9,10,19,185,178,363,396
20192020,015,BULLITT,071,Bullitt County,030,Lebanon Junction Elementary,071030,015071030,210075000148,OVEC,906,PS,8,13,0,0,0,0,0,0,0,0,0,1,0,1,0,1,1,0,0,0,12,7,19,21
20192020,015,BULLITT,071,Bullitt County,030,Lebanon Junction Elementary,071030,015071030,210075000148,OVEC,906,KG,26,39,0,0,0,0,0,0,0,0,0,2,0,2,0,0,0,2,0,2,35,26,61,65
20192020,015,BULLITT,071,Bullitt County,030,Lebanon Junction Elementary,071030,015071030,210075000148,OVEC,906,01,33,38,1,0,1,0,0,0,0,0,0,4,1,5,0,1,1,3,2,5,30,29,59,71
20192020,015,BULLITT,071,Bullitt County,030,Lebanon Junction Elementary,071030,015071030,210075000148,OVEC,906,02,25,26,0,0,0,1,0,1,0,0,0,1,1,2,0,0,0,2,1,3,22,23,45,51
20192020,015,BULLITT,071,Bullitt County,030,Lebanon Junction Elementary,071030,015071030,210075000148,OVEC,906,03,44,33,0,0,0,0,0,0,0,0,0,0,0,0,0,0,0,1,3,4,32,41,73,77
20192020,015,BULLITT,071,Bullitt County,030,Lebanon Junction Elementary,071030,015071030,210075000148,OVEC,906,04,23,31,0,0,0,0,0,0,0,0,0,0,0,0,0,0,0,1,2,3,30,21,51,54
20192020,015,BULLITT,071,Bullitt County,032,Spring Meadows,071032,015071032,210075002169,OVEC,906,All Students,0,14,2,0,2,0,0,0,0,0,0,0,0,0,0,0,0,1,0,1,11,0,11,14
20192020,015,BULLITT,071,Bullitt County,032,Spring Meadows,071032,015071032,210075002169,OVEC,906,06,0,1,0,0,0,0,0,0,0,0,0,0,0,0,0,0,0,1,0,1,0,0,0,1
20192020,015,BULLITT,071,Bullitt County,032,Spring Meadows,071032,015071032,210075002169,OVEC,906,07,0,2,0,0,0,0,0,0,0,0,0,0,0,0,0,0,0,0,0,0,2,0,2,2
20192020,015,BULLITT,071,Bullitt County,032,Spring Meadows,071032,015071032,210075002169,OVEC,906,08,0,1,0,0,0,0,0,0,0,0,0,0,0,0,0,0,0,0,0,0,1,0,1,1
20192020,015,BULLITT,071,Bullitt County,032,Spring Meadows,071032,015071032,210075002169,OVEC,906,09,0,2,1,0,1,0,0,0,0,0,0,0,0,0,0,0,0,0,0,0,1,0,1,2
20192020,015,BULLITT,071,Bullitt County,032,Spring Meadows,071032,015071032,210075002169,OVEC,906,10,0,6,1,0,1,0,0,0,0,0,0,0,0,0,0,0,0,0,0,0,5,0,5,6
20192020,015,BULLITT,071,Bullitt County,032,Spring Meadows,071032,015071032,210075002169,OVEC,906,11,0,2,0,0,0,0,0,0,0,0,0,0,0,0,0,0,0,0,0,0,2,0,2,2
20192020,015,BULLITT,071,Bullitt County,045,Maryville Elementary School,071045,015071045,210075000149,OVEC,906,05,32,30,1,0,1,0,0,0,0,0,0,2,3,5,0,0,0,5,1,6,22,28,50,62
20192020,015,BULLITT,071,Bullitt County,045,Maryville Elementary School,071045,015071045,210075000149,OVEC,906,04,27,28,0,1,1,0,0,0,0,0,0,0,1,1,0,0,0,2,1,3,26,24,50,55
20192020,015,BULLITT,071,Bullitt County,045,Maryville Elementary School,071045,015071045,210075000149,OVEC,906,All Students,148,182,2,1,3,0,0,0,1,0,1,8,7,15,0,0,0,17,7,24,154,133,287,330
20192020,015,BULLITT,071,Bullitt County,045,Maryville Elementary School,071045,015071045,210075000149,OVEC,906,PS,17,23,3,1,4,1,0,1,0,0,0,0,1,1,0,0,0,4,1,5,15,14,29,40
20192020,015,BULLITT,071,Bullitt County,045,Maryville Elementary School,071045,015071045,210075000149,OVEC,906,KG,28,37,0,0,0,0,0,0,0,0,0,1,0,1,0,0,0,4,3,7,32,25,57,65
20192020,015,BULLITT,071,Bullitt County,045,Maryville Elementary School,071045,015071045,210075000149,OVEC,906,01,25,34,0,0,0,0,0,0,1,0,1,1,2,3,0,0,0,1,0,1,31,23,54,59
20192020,015,BULLITT,071,Bullitt County,045,Maryville Elementary School,071045,015071045,210075000149,OVEC,906,02,20,23,1,0,1,0,0,0,0,0,0,1,0,1,0,0,0,2,2,4,19,18,37,43
20192020,015,BULLITT,071,Bullitt County,045,Maryville Elementary School,071045,015071045,210075000149,OVEC,906,03,16,30,0,0,0,0,0,0,0,0,0,3,1,4,0,0,0,3,0,3,24,15,39,46
20192020,015,BULLITT,071,Bullitt County,050,MT. Washington Middle School,071050,015071050,210075000150,OVEC,906,07,77,78,1,0,1,0,0,0,2,1,3,2,5,7,0,0,0,2,5,7,71,66,137,155
20192020,015,BULLITT,071,Bullitt County,050,MT. Washington Middle School,071050,015071050,210075000150,OVEC,906,All Students,231,241,5,3,8,0,0,0,3,1,4,8,10,18,0,0,0,7,10,17,218,207,425,472
20192020,015,BULLITT,071,Bullitt County,050,MT. Washington Middle School,071050,015071050,210075000150,OVEC,906,06,78,83,3,2,5,0,0,0,1,0,1,3,3,6,0,0,0,3,2,5,73,71,144,161
20192020,015,BULLITT,071,Bullitt County,050,MT. Washington Middle School,071050,015071050,210075000150,OVEC,906,08,76,80,1,1,2,0,0,0,0,0,0,3,2,5,0,0,0,2,3,5,74,70,144,156
20192020,015,BULLITT,071,Bullitt County,055,MT. Washington Elementary,071055,015071055,210075000151,OVEC,906,04,49,49,0,0,0,0,0,0,0,0,0,1,0,1,0,0,0,2,2,4,46,47,93,98
20192020,015,BULLITT,071,Bullitt County,055,MT. Washington Elementary,071055,015071055,210075000151,OVEC,906,All Students,265,282,4,2,6,0,0,0,1,1,2,5,8,13,0,0,0,5,11,16,267,243,510,547
20192020,015,BULLITT,071,Bullitt County,055,MT. Washington Elementary,071055,015071055,210075000151,OVEC,906,PS,14,18,1,0,1,0,0,0,0,0,0,1,1,2,0,0,0,0,0,0,16,13,29,32
20192020,015,BULLITT,071,Bullitt County,055,MT. Washington Elementary,071055,015071055,210075000151,OVEC,906,KG,44,46,0,0,0,0,0,0,0,0,0,0,0,0,0,0,0,1,2,3,45,42,87,90
20192020,015,BULLITT,071,Bullitt County,055,MT. Washington Elementary,071055,015071055,210075000151,OVEC,906,01,46,52,1,1,2,0,0,0,0,0,0,1,2,3,0,0,0,1,2,3,49,41,90,98
20192020,015,BULLITT,071,Bullitt County,055,MT. Washington Elementary,071055,015071055,210075000151,OVEC,906,02,38,57,1,1,2,0,0,0,0,1,1,0,2,2,0,0,0,1,1,2,55,33,88,95
20192020,015,BULLITT,071,Bullitt County,055,MT. Washington Elementary,071055,015071055,210075000151,OVEC,906,03,47,37,2,0,2,0,0,0,0,0,0,2,3,5,0,0,0,0,3,3,33,41,74,84
20192020,015,BULLITT,071,Bullitt County,055,MT. Washington Elementary,071055,015071055,210075000151,OVEC,906,05,41,41,0,0,0,0,0,0,1,0,1,1,1,2,0,0,0,0,1,1,39,39,78,82
20192020,015,BULLITT,071,Bullitt County,060,Crossroads Elementary,071060,015071060,210075002286,OVEC,906,05,45,35,0,0,0,1,0,1,0,0,0,3,1,4,0,0,0,1,3,4,30,41,71,80
20192020,015,BULLITT,071,Bullitt County,060,Crossroads Elementary,071060,015071060,210075002286,OVEC,906,All Students,228,229,1,1,2,1,0,1,4,1,5,14,11,25,1,0,1,9,12,21,199,203,402,457
20192020,015,BULLITT,071,Bullitt County,060,Crossroads Elementary,071060,015071060,210075002286,OVEC,906,PS,15,27,0,0,0,0,0,0,1,0,1,0,0,0,0,0,0,2,3,5,24,12,36,42
20192020,015,BULLITT,071,Bullitt County,060,Crossroads Elementary,071060,015071060,210075002286,OVEC,906,KG,41,35,1,0,1,0,0,0,0,0,0,1,4,5,1,0,1,0,3,3,32,34,66,76
20192020,015,BULLITT,071,Bullitt County,060,Crossroads Elementary,071060,015071060,210075002286,OVEC,906,01,43,44,0,0,0,0,0,0,2,0,2,2,4,6,0,0,0,0,1,1,40,38,78,87
20192020,015,BULLITT,071,Bullitt County,060,Crossroads Elementary,071060,015071060,210075002286,OVEC,906,02,28,34,0,1,1,0,0,0,1,0,1,3,0,3,0,0,0,2,1,3,28,26,54,62
20192020,015,BULLITT,071,Bullitt County,060,Crossroads Elementary,071060,015071060,210075002286,OVEC,906,03,38,46,0,0,0,0,0,0,0,0,0,2,1,3,0,0,0,2,0,2,42,37,79,84
20192020,015,BULLITT,071,Bullitt County,060,Crossroads Elementary,071060,015071060,210075002286,OVEC,906,04,33,35,0,0,0,0,0,0,1,1,2,3,1,4,0,0,0,4,4,8,27,27,54,68
20192020,015,BULLITT,071,Bullitt County,065,Pleasant Grove Elementary School,071065,015071065,210075001305,OVEC,906,05,60,60,0,0,0,0,0,0,0,1,1,1,0,1,0,0,0,0,0,0,59,59,118,120
20192020,015,BULLITT,071,Bullitt County,065,Pleasant Grove Elementary School,071065,015071065,210075001305,OVEC,906,All Students,269,333,1,1,2,0,0,0,1,4,5,8,9,17,0,0,0,7,5,12,316,250,566,602
20192020,015,BULLITT,071,Bullitt County,065,Pleasant Grove Elementary School,071065,015071065,210075001305,OVEC,906,PS,8,21,0,0,0,0,0,0,1,0,1,2,0,2,0,0,0,1,0,1,17,8,25,29
20192020,015,BULLITT,071,Bullitt County,065,Pleasant Grove Elementary School,071065,015071065,210075001305,OVEC,906,KG,47,45,0,0,0,0,0,0,0,0,0,1,4,5,0,0,0,2,2,4,42,41,83,92
20192020,015,BULLITT,071,Bullitt County,065,Pleasant Grove Elementary School,071065,015071065,210075001305,OVEC,906,01,44,53,0,1,1,0,0,0,0,1,1,1,2,3,0,0,0,0,2,2,52,38,90,97
20192020,015,BULLITT,071,Bullitt County,065,Pleasant Grove Elementary School,071065,015071065,210075001305,OVEC,906,02,33,54,1,0,1,0,0,0,0,0,0,2,0,2,0,0,0,1,0,1,50,33,83,87
20192020,015,BULLITT,071,Bullitt County,065,Pleasant Grove Elementary School,071065,015071065,210075001305,OVEC,906,03,43,61,0,0,0,0,0,0,1,1,2,2,2,4,0,0,0,2,0,2,56,40,96,104
20192020,015,BULLITT,071,Bullitt County,065,Pleasant Grove Elementary School,071065,015071065,210075001305,OVEC,906,04,42,60,0,0,0,0,0,0,0,1,1,1,1,2,0,0,0,2,1,3,57,39,96,102
20192020,015,BULLITT,071,Bullitt County,070,Nichols Elementary,071070,015071070,210075000153,OVEC,906,01,5,15,0,0,0,0,0,0,0,0,0,1,0,1,0,0,0,0,0,0,14,5,19,20
20192020,015,BULLITT,071,Bullitt County,070,Nichols Elementary,071070,015071070,210075000153,OVEC,906,All Students,52,68,0,0,0,0,0,0,0,0,0,3,4,7,0,0,0,2,2,4,63,46,109,120
20192020,015,BULLITT,071,Bullitt County,070,Nichols Elementary,071070,015071070,210075000153,OVEC,906,KG,11,11,0,0,0,0,0,0,0,0,0,0,0,0,0,0,0,1,2,3,10,9,19,22
20192020,015,BULLITT,071,Bullitt County,070,Nichols Elementary,071070,015071070,210075000153,OVEC,906,02,4,9,0,0,0,0,0,0,0,0,0,0,1,1,0,0,0,0,0,0,9,3,12,13
20192020,015,BULLITT,071,Bullitt County,070,Nichols Elementary,071070,015071070,210075000153,OVEC,906,03,12,13,0,0,0,0,0,0,0,0,0,1,2,3,0,0,0,0,0,0,12,10,22,25
20192020,015,BULLITT,071,Bullitt County,070,Nichols Elementary,071070,015071070,210075000153,OVEC,906,04,10,11,0,0,0,0,0,0,0,0,0,0,0,0,0,0,0,1,0,1,10,10,20,21
20192020,015,BULLITT,071,Bullitt County,070,Nichols Elementary,071070,015071070,210075000153,OVEC,906,05,10,9,0,0,0,0,0,0,0,0,0,1,1,2,0,0,0,0,0,0,8,9,17,19
20192020,015,BULLITT,071,Bullitt County,075,North Bullitt High School,071075,015071075,210075000154,OVEC,906,09,132,141,2,1,3,0,0,0,0,2,2,13,8,21,0,0,0,2,5,7,124,116,240,273
20192020,015,BULLITT,071,Bullitt County,075,North Bullitt High School,071075,015071075,210075000154,OVEC,906,10,137,146,2,1,3,1,0,1,3,1,4,12,6,18,0,0,0,2,4,6,126,125,251,283
20192020,015,BULLITT,071,Bullitt County,075,North Bullitt High School,071075,015071075,210075000154,OVEC,906,11,146,149,1,4,5,0,0,0,2,0,2,6,8,14,0,0,0,5,5,10,135,129,264,295
20192020,015,BULLITT,071,Bullitt County,075,North Bullitt High School,071075,015071075,210075000154,OVEC,906,12,103,148,3,0,3,0,0,0,1,1,2,8,3,11,0,0,0,3,3,6,133,96,229,251
20192020,015,BULLITT,071,Bullitt County,075,North Bullitt High School,071075,015071075,210075000154,OVEC,906,14,0,2,0,0,0,0,0,0,0,0,0,0,0,0,0,0,0,0,0,0,2,0,2,2
20192020,015,BULLITT,071,Bullitt County,075,North Bullitt High School,071075,015071075,210075000154,OVEC,906,All Students,518,586,8,6,14,1,0,1,6,4,10,39,25,64,0,0,0,12,17,29,520,466,986,1104
20192020,015,BULLITT,071,Bullitt County,078,Old Mill Elementary School,071078,015071078,210075001578,OVEC,906,03,41,50,0,1,1,0,0,0,1,2,3,1,1,2,0,0,0,3,0,3,45,37,82,91
20192020,015,BULLITT,071,Bullitt County,078,Old Mill Elementary School,071078,015071078,210075001578,OVEC,906,05,34,53,0,0,0,0,0,0,3,1,4,1,0,1,0,0,0,1,0,1,48,33,81,87
20192020,015,BULLITT,071,Bullitt County,078,Old Mill Elementary School,071078,015071078,210075001578,OVEC,906,04,40,45,0,0,0,0,0,0,0,1,1,1,2,3,0,0,0,1,2,3,43,35,78,85
20192020,015,BULLITT,071,Bullitt County,078,Old Mill Elementary School,071078,015071078,210075001578,OVEC,906,All Students,235,267,1,1,2,0,0,0,5,4,9,7,9,16,0,0,0,8,5,13,246,216,462,502
20192020,015,BULLITT,071,Bullitt County,078,Old Mill Elementary School,071078,015071078,210075001578,OVEC,906,PS,4,12,0,0,0,0,0,0,1,0,1,0,0,0,0,0,0,1,0,1,10,4,14,16
20192020,015,BULLITT,071,Bullitt County,078,Old Mill Elementary School,071078,015071078,210075001578,OVEC,906,KG,39,45,0,0,0,0,0,0,0,0,0,2,2,4,0,0,0,1,1,2,42,36,78,84
20192020,015,BULLITT,071,Bullitt County,078,Old Mill Elementary School,071078,015071078,210075001578,OVEC,906,01,43,37,0,0,0,0,0,0,1,0,1,1,1,2,0,0,0,1,1,2,34,41,75,80
20192020,015,BULLITT,071,Bullitt County,078,Old Mill Elementary School,071078,015071078,210075001578,OVEC,906,02,38,37,1,0,1,0,0,0,0,0,0,1,3,4,0,0,0,1,1,2,34,34,68,75
20192020,015,BULLITT,071,Bullitt County,080,Overdale Elementary School,071080,015071080,210075000155,OVEC,906,PS,6,17,0,0,0,0,0,0,1,0,1,0,0,0,0,0,0,1,0,1,15,6,21,23
20192020,015,BULLITT,071,Bullitt County,080,Overdale Elementary School,071080,015071080,210075000155,OVEC,906,All Students,165,172,5,3,8,0,1,1,1,2,3,15,7,22,0,0,0,12,10,22,139,142,281,337
20192020,015,BULLITT,071,Bullitt County,080,Overdale Elementary School,071080,015071080,210075000155,OVEC,906,KG,27,29,3,0,3,0,0,0,0,0,0,2,1,3,0,0,0,3,1,4,21,25,46,56
20192020,015,BULLITT,071,Bullitt County,080,Overdale Elementary School,071080,015071080,210075000155,OVEC,906,01,21,27,0,0,0,0,0,0,0,0,0,4,3,7,0,0,0,2,1,3,21,17,38,48
20192020,015,BULLITT,071,Bullitt County,080,Overdale Elementary School,071080,015071080,210075000155,OVEC,906,02,24,19,1,0,1,0,0,0,0,0,0,0,0,0,0,0,0,1,3,4,17,21,38,43
20192020,015,BULLITT,071,Bullitt County,080,Overdale Elementary School,071080,015071080,210075000155,OVEC,906,03,27,33,0,1,1,0,1,1,0,1,1,3,1,4,0,0,0,1,4,5,29,19,48,60
20192020,015,BULLITT,071,Bullitt County,080,Overdale Elementary School,071080,015071080,210075000155,OVEC,906,04,37,30,0,2,2,0,0,0,0,1,1,1,2,3,0,0,0,0,0,0,29,32,61,67
20192020,015,BULLITT,071,Bullitt County,080,Overdale Elementary School,071080,015071080,210075000155,OVEC,906,05,29,34,1,0,1,0,0,0,1,0,1,5,0,5,0,0,0,5,1,6,22,28,50,63
20192020,015,BULLITT,071,Bullitt County,090,Roby Elementary School,071090,015071090,210075000156,OVEC,906,05,49,40,2,1,3,0,0,0,0,1,1,2,1,3,0,0,0,1,2,3,35,44,79,89
20192020,015,BULLITT,071,Bullitt County,090,Roby Elementary School,071090,015071090,210075000156,OVEC,906,All Students,233,225,7,8,15,0,0,0,1,1,2,10,7,17,0,1,1,17,14,31,190,202,392,458
20192020,015,BULLITT,071,Bullitt County,090,Roby Elementary School,071090,015071090,210075000156,OVEC,906,PS,16,27,1,1,2,0,0,0,0,0,0,1,0,1,0,0,0,1,0,1,24,15,39,43
20192020,015,BULLITT,071,Bullitt County,090,Roby Elementary School,071090,015071090,210075000156,OVEC,906,KG,49,49,1,3,4,0,0,0,0,0,0,1,1,2,0,1,1,8,4,12,39,40,79,98
20192020,015,BULLITT,071,Bullitt County,090,Roby Elementary School,071090,015071090,210075000156,OVEC,906,01,32,41,0,1,1,0,0,0,0,0,0,3,1,4,0,0,0,1,0,1,37,30,67,73
20192020,015,BULLITT,071,Bullitt County,090,Roby Elementary School,071090,015071090,210075000156,OVEC,906,02,33,32,0,2,2,0,0,0,0,0,0,1,1,2,0,0,0,5,3,8,26,27,53,65
20192020,015,BULLITT,071,Bullitt County,090,Roby Elementary School,071090,015071090,210075000156,OVEC,906,03,34,28,2,0,2,0,0,0,1,0,1,1,2,3,0,0,0,1,3,4,23,29,52,62
20192020,015,BULLITT,071,Bullitt County,090,Roby Elementary School,071090,015071090,210075000156,OVEC,906,04,36,35,2,1,3,0,0,0,0,0,0,2,1,3,0,0,0,1,2,3,30,32,62,71
20192020,015,BULLITT,071,Bullitt County,110,Riverview Opportunity Center,071110,015071110,210075000157,OVEC,906,11,19,31,0,1,1,1,0,1,0,1,1,1,1,2,0,0,0,0,0,0,29,16,45,50
20192020,015,BULLITT,071,Bullitt County,110,Riverview Opportunity Center,071110,015071110,210075000157,OVEC,906,All Students,72,100,0,1,1,1,0,1,2,2,4,3,1,4,1,0,1,0,2,2,93,66,159,172
20192020,015,BULLITT,071,Bullitt County,110,Riverview Opportunity Center,071110,015071110,210075000157,OVEC,906,09,17,22,0,0,0,0,0,0,2,0,2,0,0,0,0,0,0,0,1,1,20,16,36,39
20192020,015,BULLITT,071,Bullitt County,110,Riverview Opportunity Center,071110,015071110,210075000157,OVEC,906,10,22,23,0,0,0,0,0,0,0,0,0,1,0,1,1,0,1,0,1,1,21,21,42,45
20192020,015,BULLITT,071,Bullitt County,110,Riverview Opportunity Center,071110,015071110,210075000157,OVEC,906,12,14,24,0,0,0,0,0,0,0,1,1,1,0,1,0,0,0,0,0,0,23,13,36,38
20192020,015,BULLITT,071,Bullitt County,120,Bullitt Alternative Center,071120,015071120,210075000929,OVEC,906,12,0,12,0,0,0,0,0,0,0,0,0,1,0,1,0,0,0,1,0,1,10,0,10,12
20192020,015,BULLITT,071,Bullitt County,120,Bullitt Alternative Center,071120,015071120,210075000929,OVEC,906,All Students,8,36,2,0,2,0,0,0,0,0,0,2,0,2,0,0,0,3,0,3,29,8,37,44
20192020,015,BULLITT,071,Bullitt County,120,Bullitt Alternative Center,071120,015071120,210075000929,OVEC,906,09,3,3,1,0,1,0,0,0,0,0,0,0,0,0,0,0,0,0,0,0,2,3,5,6
20192020,015,BULLITT,071,Bullitt County,120,Bullitt Alternative Center,071120,015071120,210075000929,OVEC,906,06,0,1,0,0,0,0,0,0,0,0,0,0,0,0,0,0,0,1,0,1,0,0,0,1
20192020,015,BULLITT,071,Bullitt County,120,Bullitt Alternative Center,071120,015071120,210075000929,OVEC,906,07,1,2,0,0,0,0,0,0,0,0,0,0,0,0,0,0,0,0,0,0,2,1,3,3
20192020,015,BULLITT,071,Bullitt County,120,Bullitt Alternative Center,071120,015071120,210075000929,OVEC,906,10,1,6,0,0,0,0,0,0,0,0,0,1,0,1,0,0,0,0,0,0,5,1,6,7
20192020,015,BULLITT,071,Bullitt County,120,Bullitt Alternative Center,071120,015071120,210075000929,OVEC,906,08,3,5,1,0,1,0,0,0,0,0,0,0,0,0,0,0,0,0,0,0,4,3,7,8
20192020,015,BULLITT,071,Bullitt County,120,Bullitt Alternative Center,071120,015071120,210075000929,OVEC,906,11,0,7,0,0,0,0,0,0,0,0,0,0,0,0,0,0,0,1,0,1,6,0,6,7
20192020,084,MERCER,072,Burgin Independent,"",---District Total---,072,"","",CKEC,901,05,20,26,1,0,1,0,0,0,0,0,0,1,1,2,0,0,0,1,0,1,23,19,42,46
20192020,084,MERCER,072,Burgin Independent,"",---District Total---,072,"","",CKEC,901,All Students,241,253,3,2,5,1,0,1,1,2,3,3,7,10,0,0,0,13,9,22,232,221,453,494
20192020,084,MERCER,072,Burgin Independent,"",---District Total---,072,"","",CKEC,901,PS,11,13,0,0,0,0,0,0,0,0,0,2,0,2,0,0,0,2,0,2,9,11,20,24
20192020,084,MERCER,072,Burgin Independent,"",---District Total---,072,"","",CKEC,901,KG,16,20,0,0,0,0,0,0,0,0,0,0,0,0,0,0,0,0,1,1,20,15,35,36
20192020,084,MERCER,072,Burgin Independent,"",---District Total---,072,"","",CKEC,901,01,14,20,0,0,0,0,0,0,0,0,0,0,1,1,0,0,0,1,0,1,19,13,32,34
20192020,084,MERCER,072,Burgin Independent,"",---District Total---,072,"","",CKEC,901,02,19,19,0,1,1,0,0,0,0,0,0,0,0,0,0,0,0,0,2,2,19,16,35,38
20192020,084,MERCER,072,Burgin Independent,"",---District Total---,072,"","",CKEC,901,03,17,19,0,0,0,0,0,0,0,0,0,0,0,0,0,0,0,2,0,2,17,17,34,36
20192020,084,MERCER,072,Burgin Independent,"",---District Total---,072,"","",CKEC,901,04,19,23,0,0,0,1,0,1,0,0,0,0,2,2,0,0,0,2,1,3,20,16,36,42
20192020,084,MERCER,072,Burgin Independent,"",---District Total---,072,"","",CKEC,901,06,28,24,1,0,1,0,0,0,0,0,0,0,1,1,0,0,0,0,1,1,23,26,49,52
20192020,084,MERCER,072,Burgin Independent,"",---District Total---,072,"","",CKEC,901,07,23,10,0,0,0,0,0,0,0,0,0,1,0,1,0,0,0,0,0,0,9,23,32,33
20192020,084,MERCER,072,Burgin Independent,"",---District Total---,072,"","",CKEC,901,08,15,16,0,1,1,0,0,0,0,0,0,0,0,0,0,0,0,2,1,3,14,13,27,31
20192020,084,MERCER,072,Burgin Independent,"",---District Total---,072,"","",CKEC,901,09,21,27,0,0,0,0,0,0,0,1,1,1,1,2,0,0,0,3,1,4,23,18,41,48
20192020,084,MERCER,072,Burgin Independent,"",---District Total---,072,"","",CKEC,901,10,25,16,1,0,1,0,0,0,1,0,1,0,0,0,0,0,0,0,2,2,14,23,37,41
20192020,084,MERCER,072,Burgin Independent,"",---District Total---,072,"","",CKEC,901,11,11,19,0,0,0,0,0,0,0,1,1,0,1,1,0,0,0,1,0,1,18,9,27,30
20192020,084,MERCER,072,Burgin Independent,"",---District Total---,072,"","",CKEC,901,12,13,14,0,0,0,0,0,0,0,0,0,0,0,0,0,0,0,1,0,1,13,13,26,27
20192020,084,MERCER,072,Burgin Independent,030,Burgin Independent School,072030,084072030,210078002407,CKEC,901,All Students,241,253,3,2,5,1,0,1,1,2,3,3,7,10,0,0,0,13,9,22,232,221,453,494
20192020,084,MERCER,072,Burgin Independent,030,Burgin Independent School,072030,084072030,210078002407,CKEC,901,PS,11,13,0,0,0,0,0,0,0,0,0,2,0,2,0,0,0,2,0,2,9,11,20,24
20192020,084,MERCER,072,Burgin Independent,030,Burgin Independent School,072030,084072030,210078002407,CKEC,901,KG,16,20,0,0,0,0,0,0,0,0,0,0,0,0,0,0,0,0,1,1,20,15,35,36
20192020,084,MERCER,072,Burgin Independent,030,Burgin Independent School,072030,084072030,210078002407,CKEC,901,01,14,20,0,0,0,0,0,0,0,0,0,0,1,1,0,0,0,1,0,1,19,13,32,34
20192020,084,MERCER,072,Burgin Independent,030,Burgin Independent School,072030,084072030,210078002407,CKEC,901,02,19,19,0,1,1,0,0,0,0,0,0,0,0,0,0,0,0,0,2,2,19,16,35,38
20192020,084,MERCER,072,Burgin Independent,030,Burgin Independent School,072030,084072030,210078002407,CKEC,901,03,17,19,0,0,0,0,0,0,0,0,0,0,0,0,0,0,0,2,0,2,17,17,34,36
20192020,084,MERCER,072,Burgin Independent,030,Burgin Independent School,072030,084072030,210078002407,CKEC,901,04,19,23,0,0,0,1,0,1,0,0,0,0,2,2,0,0,0,2,1,3,20,16,36,42
20192020,084,MERCER,072,Burgin Independent,030,Burgin Independent School,072030,084072030,210078002407,CKEC,901,05,20,26,1,0,1,0,0,0,0,0,0,1,1,2,0,0,0,1,0,1,23,19,42,46
20192020,084,MERCER,072,Burgin Independent,030,Burgin Independent School,072030,084072030,210078002407,CKEC,901,06,28,24,1,0,1,0,0,0,0,0,0,0,1,1,0,0,0,0,1,1,23,26,49,52
20192020,084,MERCER,072,Burgin Independent,030,Burgin Independent School,072030,084072030,210078002407,CKEC,901,07,23,10,0,0,0,0,0,0,0,0,0,1,0,1,0,0,0,0,0,0,9,23,32,33
20192020,084,MERCER,072,Burgin Independent,030,Burgin Independent School,072030,084072030,210078002407,CKEC,901,08,15,16,0,1,1,0,0,0,0,0,0,0,0,0,0,0,0,2,1,3,14,13,27,31
20192020,084,MERCER,072,Burgin Independent,030,Burgin Independent School,072030,084072030,210078002407,CKEC,901,09,21,27,0,0,0,0,0,0,0,1,1,1,1,2,0,0,0,3,1,4,23,18,41,48
20192020,084,MERCER,072,Burgin Independent,030,Burgin Independent School,072030,084072030,210078002407,CKEC,901,10,25,16,1,0,1,0,0,0,1,0,1,0,0,0,0,0,0,0,2,2,14,23,37,41
20192020,084,MERCER,072,Burgin Independent,030,Burgin Independent School,072030,084072030,210078002407,CKEC,901,11,11,19,0,0,0,0,0,0,0,1,1,0,1,1,0,0,0,1,0,1,18,9,27,30
20192020,084,MERCER,072,Burgin Independent,030,Burgin Independent School,072030,084072030,210078002407,CKEC,901,12,13,14,0,0,0,0,0,0,0,0,0,0,0,0,0,0,0,1,0,1,13,13,26,27
20192020,016,BUTLER,075,Butler County,"",---District Total---,075,"","",GRREC,902,14,1,1,0,0,0,0,0,0,0,0,0,0,0,0,0,0,0,0,0,0,1,1,2,2
20192020,016,BUTLER,075,Butler County,"",---District Total---,075,"","",GRREC,902,12,82,81,0,1,1,0,0,0,0,0,0,5,2,7,0,0,0,3,2,5,73,77,150,163
20192020,016,BUTLER,075,Butler County,"",---District Total---,075,"","",GRREC,902,All Students,1008,1154,2,7,9,1,0,1,5,2,7,124,91,215,1,0,1,13,22,35,1008,886,1894,2162
20192020,016,BUTLER,075,Butler County,"",---District Total---,075,"","",GRREC,902,PS,70,73,0,1,1,0,0,0,0,0,0,7,9,16,0,0,0,0,1,1,66,59,125,143
20192020,016,BUTLER,075,Butler County,"",---District Total---,075,"","",GRREC,902,KG,74,91,0,0,0,0,0,0,0,0,0,11,8,19,0,0,0,0,3,3,80,63,143,165
20192020,016,BUTLER,075,Butler County,"",---District Total---,075,"","",GRREC,902,01,89,89,0,1,1,0,0,0,0,0,0,11,7,18,0,0,0,0,1,1,78,80,158,178
20192020,016,BUTLER,075,Butler County,"",---District Total---,075,"","",GRREC,902,02,71,91,1,0,1,0,0,0,0,0,0,9,11,20,0,0,0,2,5,7,79,55,134,162
20192020,016,BUTLER,075,Butler County,"",---District Total---,075,"","",GRREC,902,03,70,66,0,0,0,0,0,0,0,0,0,3,8,11,0,0,0,0,0,0,63,62,125,136
20192020,016,BUTLER,075,Butler County,"",---District Total---,075,"","",GRREC,902,04,71,82,0,1,1,0,0,0,2,0,2,11,10,21,0,0,0,0,2,2,69,58,127,153
20192020,016,BUTLER,075,Butler County,"",---District Total---,075,"","",GRREC,902,05,81,104,0,2,2,0,0,0,0,0,0,12,9,21,0,0,0,2,2,4,90,68,158,185
20192020,016,BUTLER,075,Butler County,"",---District Total---,075,"","",GRREC,902,06,87,82,0,1,1,0,0,0,0,0,0,10,8,18,0,0,0,2,0,2,70,78,148,169
20192020,016,BUTLER,075,Butler County,"",---District Total---,075,"","",GRREC,902,07,77,103,0,0,0,0,0,0,0,1,1,7,8,15,0,0,0,2,0,2,94,68,162,180
20192020,016,BUTLER,075,Butler County,"",---District Total---,075,"","",GRREC,902,08,65,81,0,0,0,0,0,0,2,0,2,11,6,17,0,0,0,0,3,3,68,56,124,146
20192020,016,BUTLER,075,Butler County,"",---District Total---,075,"","",GRREC,902,09,70,100,0,0,0,0,0,0,0,1,1,13,6,19,1,0,1,0,1,1,86,62,148,170
20192020,016,BUTLER,075,Butler County,"",---District Total---,075,"","",GRREC,902,10,89,91,0,1,1,1,0,1,0,0,0,13,5,18,0,0,0,2,2,4,75,81,156,180
20192020,016,BUTLER,075,Butler County,"",---District Total---,075,"","",GRREC,902,11,81,92,1,0,1,0,0,0,1,0,1,8,3,11,0,0,0,0,1,1,82,77,159,173
20192020,016,BUTLER,075,Butler County,030,Butler County High School,075030,016075030,210081000160,GRREC,902,12,82,76,0,1,1,0,0,0,0,0,0,5,2,7,0,0,0,2,2,4,69,77,146,158
20192020,016,BUTLER,075,Butler County,030,Butler County High School,075030,016075030,210081000160,GRREC,902,All Students,323,344,0,2,2,1,0,1,0,1,1,38,16,54,1,0,1,4,6,10,300,298,598,667
20192020,016,BUTLER,075,Butler County,030,Butler County High School,075030,016075030,210081000160,GRREC,902,09,70,93,0,0,0,0,0,0,0,1,1,13,6,19,1,0,1,0,1,1,79,62,141,163
20192020,016,BUTLER,075,Butler County,030,Butler County High School,075030,016075030,210081000160,GRREC,902,10,89,89,0,1,1,1,0,1,0,0,0,13,5,18,0,0,0,2,2,4,73,81,154,178
20192020,016,BUTLER,075,Butler County,030,Butler County High School,075030,016075030,210081000160,GRREC,902,11,81,85,0,0,0,0,0,0,0,0,0,7,3,10,0,0,0,0,1,1,78,77,155,166
20192020,016,BUTLER,075,Butler County,030,Butler County High School,075030,016075030,210081000160,GRREC,902,14,1,1,0,0,0,0,0,0,0,0,0,0,0,0,0,0,0,0,0,0,1,1,2,2
20192020,016,BUTLER,075,Butler County,031,North Butler Elementary,075031,016075031,210081001976,GRREC,902,02,26,34,1,0,1,0,0,0,0,0,0,1,0,1,0,0,0,1,1,2,31,25,56,60
20192020,016,BUTLER,075,Butler County,031,North Butler Elementary,075031,016075031,210081001976,GRREC,902,All Students,171,198,1,0,1,0,0,0,1,0,1,4,2,6,0,0,0,1,6,7,191,163,354,369
20192020,016,BUTLER,075,Butler County,031,North Butler Elementary,075031,016075031,210081001976,GRREC,902,PS,11,26,0,1,1,0,0,0,0,0,0,0,1,1,0,0,0,0,1,1,26,8,34,37
20192020,016,BUTLER,075,Butler County,031,North Butler Elementary,075031,016075031,210081001976,GRREC,902,KG,27,42,0,0,0,0,0,0,0,0,0,3,1,4,0,0,0,0,2,2,39,24,63,69
20192020,016,BUTLER,075,Butler County,031,North Butler Elementary,075031,016075031,210081001976,GRREC,902,01,36,31,0,0,0,0,0,0,0,0,0,0,0,0,0,0,0,0,1,1,31,35,66,67
20192020,016,BUTLER,075,Butler County,031,North Butler Elementary,075031,016075031,210081001976,GRREC,902,03,28,25,0,0,0,0,0,0,0,0,0,0,0,0,0,0,0,0,0,0,25,28,53,53
20192020,016,BUTLER,075,Butler County,031,North Butler Elementary,075031,016075031,210081001976,GRREC,902,04,26,31,0,0,0,0,0,0,1,0,1,0,1,1,0,0,0,0,1,1,30,24,54,57
20192020,016,BUTLER,075,Butler County,031,North Butler Elementary,075031,016075031,210081001976,GRREC,902,05,28,35,0,0,0,0,0,0,0,0,0,0,0,0,0,0,0,0,1,1,35,27,62,63
20192020,016,BUTLER,075,Butler County,032,Butler County Learning Center,075032,016075032,210081001977,GRREC,902,11,0,1,0,0,0,0,0,0,0,0,0,0,0,0,0,0,0,0,0,0,1,0,1,1
20192020,016,BUTLER,075,Butler County,032,Butler County Learning Center,075032,016075032,210081001977,GRREC,902,01,0,1,0,0,0,0,0,0,0,0,0,1,0,1,0,0,0,0,0,0,0,0,0,1
20192020,016,BUTLER,075,Butler County,032,Butler County Learning Center,075032,016075032,210081001977,GRREC,902,06,1,3,0,0,0,0,0,0,0,0,0,0,0,0,0,0,0,0,0,0,3,1,4,4
20192020,016,BUTLER,075,Butler County,032,Butler County Learning Center,075032,016075032,210081001977,GRREC,902,07,1,4,0,0,0,0,0,0,0,0,0,0,0,0,0,0,0,1,0,1,3,1,4,5
20192020,016,BUTLER,075,Butler County,032,Butler County Learning Center,075032,016075032,210081001977,GRREC,902,08,1,2,0,0,0,0,0,0,0,0,0,0,0,0,0,0,0,0,0,0,2,1,3,3
20192020,016,BUTLER,075,Butler County,032,Butler County Learning Center,075032,016075032,210081001977,GRREC,902,09,0,5,0,0,0,0,0,0,0,0,0,0,0,0,0,0,0,0,0,0,5,0,5,5
20192020,016,BUTLER,075,Butler County,032,Butler County Learning Center,075032,016075032,210081001977,GRREC,902,All Students,3,18,0,0,0,0,0,0,0,0,0,1,0,1,0,0,0,1,0,1,16,3,19,21
20192020,016,BUTLER,075,Butler County,032,Butler County Learning Center,075032,016075032,210081001977,GRREC,902,10,0,2,0,0,0,0,0,0,0,0,0,0,0,0,0,0,0,0,0,0,2,0,2,2
20192020,016,BUTLER,075,Butler County,035,Butler County Middle School,075035,016075035,210081001697,GRREC,902,07,76,99,0,0,0,0,0,0,0,1,1,7,8,15,0,0,0,1,0,1,91,67,158,175
20192020,016,BUTLER,075,Butler County,035,Butler County Middle School,075035,016075035,210081001697,GRREC,902,All Students,226,257,0,1,1,0,0,0,2,1,3,28,22,50,0,0,0,3,3,6,224,199,423,483
20192020,016,BUTLER,075,Butler County,035,Butler County Middle School,075035,016075035,210081001697,GRREC,902,06,86,79,0,1,1,0,0,0,0,0,0,10,8,18,0,0,0,2,0,2,67,77,144,165
20192020,016,BUTLER,075,Butler County,035,Butler County Middle School,075035,016075035,210081001697,GRREC,902,08,64,79,0,0,0,0,0,0,2,0,2,11,6,17,0,0,0,0,3,3,66,55,121,143
20192020,016,BUTLER,075,Butler County,110,Green River School,075110,016075110,210081000163,GRREC,902,11,0,6,1,0,1,0,0,0,1,0,1,1,0,1,0,0,0,0,0,0,3,0,3,6
20192020,016,BUTLER,075,Butler County,110,Green River School,075110,016075110,210081000163,GRREC,902,All Students,0,13,1,0,1,0,0,0,1,0,1,1,0,1,0,0,0,1,0,1,9,0,9,13
20192020,016,BUTLER,075,Butler County,110,Green River School,075110,016075110,210081000163,GRREC,902,09,0,2,0,0,0,0,0,0,0,0,0,0,0,0,0,0,0,0,0,0,2,0,2,2
20192020,016,BUTLER,075,Butler County,110,Green River School,075110,016075110,210081000163,GRREC,902,12,0,5,0,0,0,0,0,0,0,0,0,0,0,0,0,0,0,1,0,1,4,0,4,5
20192020,016,BUTLER,075,Butler County,120,Morgantown Elementary School,075120,016075120,210081000164,GRREC,902,03,42,41,0,0,0,0,0,0,0,0,0,3,8,11,0,0,0,0,0,0,38,34,72,83
20192020,016,BUTLER,075,Butler County,120,Morgantown Elementary School,075120,016075120,210081000164,GRREC,902,05,53,69,0,2,2,0,0,0,0,0,0,12,9,21,0,0,0,2,1,3,55,41,96,122
20192020,016,BUTLER,075,Butler County,120,Morgantown Elementary School,075120,016075120,210081000164,GRREC,902,All Students,285,324,0,4,4,0,0,0,1,0,1,52,51,103,0,0,0,3,7,10,268,223,491,609
20192020,016,BUTLER,075,Butler County,120,Morgantown Elementary School,075120,016075120,210081000164,GRREC,902,PS,59,47,0,0,0,0,0,0,0,0,0,7,8,15,0,0,0,0,0,0,40,51,91,106
20192020,016,BUTLER,075,Butler County,120,Morgantown Elementary School,075120,016075120,210081000164,GRREC,902,KG,47,49,0,0,0,0,0,0,0,0,0,8,7,15,0,0,0,0,1,1,41,39,80,96
20192020,016,BUTLER,075,Butler County,120,Morgantown Elementary School,075120,016075120,210081000164,GRREC,902,01,53,57,0,1,1,0,0,0,0,0,0,10,7,17,0,0,0,0,0,0,47,45,92,110
20192020,016,BUTLER,075,Butler County,120,Morgantown Elementary School,075120,016075120,210081000164,GRREC,902,02,45,57,0,0,0,0,0,0,0,0,0,8,11,19,0,0,0,1,4,5,48,30,78,102
20192020,016,BUTLER,075,Butler County,120,Morgantown Elementary School,075120,016075120,210081000164,GRREC,902,04,45,51,0,1,1,0,0,0,1,0,1,11,9,20,0,0,0,0,1,1,39,34,73,96
20192020,017,CALDWELL,081,Caldwell County,"",---District Total---,081,"","",WKEC,908,10,61,65,8,6,14,0,0,0,1,0,1,3,0,3,0,0,0,0,5,5,53,50,103,126
20192020,017,CALDWELL,081,Caldwell County,"",---District Total---,081,"","",WKEC,908,14,1,2,0,0,0,0,0,0,0,0,0,0,0,0,0,0,0,0,0,0,2,1,3,3
20192020,017,CALDWELL,081,Caldwell County,"",---District Total---,081,"","",WKEC,908,All Students,923,925,64,59,123,0,0,0,3,2,5,23,15,38,0,0,0,50,57,107,785,790,1575,1848
20192020,017,CALDWELL,081,Caldwell County,"",---District Total---,081,"","",WKEC,908,PS,55,67,5,4,9,0,0,0,0,0,0,1,1,2,0,0,0,10,5,15,51,45,96,122
20192020,017,CALDWELL,081,Caldwell County,"",---District Total---,081,"","",WKEC,908,KG,76,60,3,0,3,0,0,0,0,0,0,0,0,0,0,0,0,6,10,16,51,66,117,136
20192020,017,CALDWELL,081,Caldwell County,"",---District Total---,081,"","",WKEC,908,01,70,80,4,5,9,0,0,0,0,1,1,2,1,3,0,0,0,7,4,11,67,59,126,150
20192020,017,CALDWELL,081,Caldwell County,"",---District Total---,081,"","",WKEC,908,02,65,72,5,3,8,0,0,0,0,0,0,2,0,2,0,0,0,3,2,5,62,60,122,137
20192020,017,CALDWELL,081,Caldwell County,"",---District Total---,081,"","",WKEC,908,03,72,69,5,3,8,0,0,0,0,1,1,1,1,2,0,0,0,2,9,11,61,58,119,141
20192020,017,CALDWELL,081,Caldwell County,"",---District Total---,081,"","",WKEC,908,04,75,75,3,4,7,0,0,0,0,0,0,2,3,5,0,0,0,7,4,11,63,64,127,150
20192020,017,CALDWELL,081,Caldwell County,"",---District Total---,081,"","",WKEC,908,05,73,69,5,8,13,0,0,0,0,0,0,0,4,4,0,0,0,8,4,12,56,57,113,142
20192020,017,CALDWELL,081,Caldwell County,"",---District Total---,081,"","",WKEC,908,06,83,76,5,7,12,0,0,0,0,0,0,2,2,4,0,0,0,4,5,9,65,69,134,159
20192020,017,CALDWELL,081,Caldwell County,"",---District Total---,081,"","",WKEC,908,07,77,91,5,2,7,0,0,0,0,0,0,3,1,4,0,0,0,3,5,8,80,69,149,168
20192020,017,CALDWELL,081,Caldwell County,"",---District Total---,081,"","",WKEC,908,08,65,66,5,5,10,0,0,0,1,0,1,3,0,3,0,0,0,3,3,6,54,57,111,131
20192020,017,CALDWELL,081,Caldwell County,"",---District Total---,081,"","",WKEC,908,12,76,59,5,6,11,0,0,0,1,0,1,2,0,2,0,0,0,4,2,6,47,68,115,135
20192020,017,CALDWELL,081,Caldwell County,"",---District Total---,081,"","",WKEC,908,09,56,85,7,1,8,0,0,0,0,0,0,2,0,2,0,0,0,2,1,3,74,54,128,141
20192020,017,CALDWELL,081,Caldwell County,"",---District Total---,081,"","",WKEC,908,11,73,56,4,9,13,0,0,0,0,0,0,1,3,4,0,0,0,1,3,4,50,58,108,129
20192020,017,CALDWELL,081,Caldwell County,010,Caldwell County High School,081010,017081010,210084000166,WKEC,908,12,76,59,5,6,11,0,0,0,1,0,1,2,0,2,0,0,0,4,2,6,47,68,115,135
20192020,017,CALDWELL,081,Caldwell County,010,Caldwell County High School,081010,017081010,210084000166,WKEC,908,All Students,267,267,24,22,46,0,0,0,2,0,2,8,3,11,0,0,0,7,11,18,226,231,457,534
20192020,017,CALDWELL,081,Caldwell County,010,Caldwell County High School,081010,017081010,210084000166,WKEC,908,09,56,85,7,1,8,0,0,0,0,0,0,2,0,2,0,0,0,2,1,3,74,54,128,141
20192020,017,CALDWELL,081,Caldwell County,010,Caldwell County High School,081010,017081010,210084000166,WKEC,908,10,61,65,8,6,14,0,0,0,1,0,1,3,0,3,0,0,0,0,5,5,53,50,103,126
20192020,017,CALDWELL,081,Caldwell County,010,Caldwell County High School,081010,017081010,210084000166,WKEC,908,11,73,56,4,9,13,0,0,0,0,0,0,1,3,4,0,0,0,1,3,4,50,58,108,129
20192020,017,CALDWELL,081,Caldwell County,010,Caldwell County High School,081010,017081010,210084000166,WKEC,908,14,1,2,0,0,0,0,0,0,0,0,0,0,0,0,0,0,0,0,0,0,2,1,3,3
20192020,017,CALDWELL,081,Caldwell County,020,Caldwell County Middle School,081020,017081020,210084000167,WKEC,908,08,65,66,5,5,10,0,0,0,1,0,1,3,0,3,0,0,0,3,3,6,54,57,111,131
20192020,017,CALDWELL,081,Caldwell County,020,Caldwell County Middle School,081020,017081020,210084000167,WKEC,908,All Students,225,233,15,14,29,0,0,0,1,0,1,8,3,11,0,0,0,10,13,23,199,195,394,458
20192020,017,CALDWELL,081,Caldwell County,020,Caldwell County Middle School,081020,017081020,210084000167,WKEC,908,06,83,76,5,7,12,0,0,0,0,0,0,2,2,4,0,0,0,4,5,9,65,69,134,159
20192020,017,CALDWELL,081,Caldwell County,020,Caldwell County Middle School,081020,017081020,210084000167,WKEC,908,07,77,91,5,2,7,0,0,0,0,0,0,3,1,4,0,0,0,3,5,8,80,69,149,168
20192020,017,CALDWELL,081,Caldwell County,030,Caldwell County Primary School,081030,017081030,210084001660,WKEC,908,01,70,80,4,5,9,0,0,0,0,1,1,2,1,3,0,0,0,7,4,11,67,59,126,150
20192020,017,CALDWELL,081,Caldwell County,030,Caldwell County Primary School,081030,017081030,210084001660,WKEC,908,KG,76,60,3,0,3,0,0,0,0,0,0,0,0,0,0,0,0,6,10,16,51,66,117,136
20192020,017,CALDWELL,081,Caldwell County,030,Caldwell County Primary School,081030,017081030,210084001660,WKEC,908,02,65,72,5,3,8,0,0,0,0,0,0,2,0,2,0,0,0,3,2,5,62,60,122,137
20192020,017,CALDWELL,081,Caldwell County,030,Caldwell County Primary School,081030,017081030,210084001660,WKEC,908,All Students,211,212,12,8,20,0,0,0,0,1,1,4,1,5,0,0,0,16,16,32,180,185,365,423
20192020,017,CALDWELL,081,Caldwell County,030,Caldwell County Primary School,081030,017081030,210084001660,WKEC,908,PS,55,67,5,4,9,0,0,0,0,0,0,1,1,2,0,0,0,10,5,15,51,45,96,122
20192020,017,CALDWELL,081,Caldwell County,070,Caldwell County Elementary School,081070,017081070,210084000170,WKEC,908,03,72,69,5,3,8,0,0,0,0,1,1,1,1,2,0,0,0,2,9,11,61,58,119,141
20192020,017,CALDWELL,081,Caldwell County,070,Caldwell County Elementary School,081070,017081070,210084000170,WKEC,908,05,73,69,5,8,13,0,0,0,0,0,0,0,4,4,0,0,0,8,4,12,56,57,113,142
20192020,017,CALDWELL,081,Caldwell County,070,Caldwell County Elementary School,081070,017081070,210084000170,WKEC,908,All Students,220,213,13,15,28,0,0,0,0,1,1,3,8,11,0,0,0,17,17,34,180,179,359,433
20192020,017,CALDWELL,081,Caldwell County,070,Caldwell County Elementary School,081070,017081070,210084000170,WKEC,908,04,75,75,3,4,7,0,0,0,0,0,0,2,3,5,0,0,0,7,4,11,63,64,127,150
20192020,018,CALLOWAY,085,Calloway County,"",---District Total---,085,"","",WKEC,908,09,126,114,2,1,3,0,0,0,0,1,1,2,7,9,0,0,0,3,4,7,107,113,220,240
20192020,018,CALLOWAY,085,Calloway County,"",---District Total---,085,"","",WKEC,908,KG,102,112,1,2,3,0,0,0,2,0,2,8,12,20,0,0,0,3,5,8,98,83,181,214
20192020,018,CALLOWAY,085,Calloway County,"",---District Total---,085,"","",WKEC,908,01,97,113,0,1,1,0,0,0,1,0,1,10,13,23,0,0,0,4,5,9,98,78,176,210
20192020,018,CALLOWAY,085,Calloway County,"",---District Total---,085,"","",WKEC,908,02,103,87,0,3,3,0,0,0,0,2,2,3,1,4,0,0,0,9,4,13,75,93,168,190
20192020,018,CALLOWAY,085,Calloway County,"",---District Total---,085,"","",WKEC,908,03,100,118,1,1,2,0,0,0,1,0,1,5,6,11,0,0,0,6,2,8,105,91,196,218
20192020,018,CALLOWAY,085,Calloway County,"",---District Total---,085,"","",WKEC,908,04,107,99,0,0,0,0,0,0,0,3,3,5,9,14,0,0,0,5,3,8,89,92,181,206
20192020,018,CALLOWAY,085,Calloway County,"",---District Total---,085,"","",WKEC,908,05,122,103,1,3,4,0,1,1,0,2,2,7,10,17,0,0,0,2,8,10,93,98,191,225
20192020,018,CALLOWAY,085,Calloway County,"",---District Total---,085,"","",WKEC,908,06,93,123,2,0,2,0,0,0,0,0,0,14,10,24,0,0,0,10,4,14,97,79,176,216
20192020,018,CALLOWAY,085,Calloway County,"",---District Total---,085,"","",WKEC,908,07,115,123,5,1,6,0,0,0,1,0,1,7,4,11,1,0,1,7,8,15,102,102,204,238
20192020,018,CALLOWAY,085,Calloway County,"",---District Total---,085,"","",WKEC,908,08,106,118,0,2,2,0,0,0,2,0,2,9,7,16,0,0,0,7,7,14,100,90,190,224
20192020,018,CALLOWAY,085,Calloway County,"",---District Total---,085,"","",WKEC,908,10,87,125,2,2,4,0,0,0,1,0,1,10,5,15,0,0,0,4,3,7,108,77,185,212
20192020,018,CALLOWAY,085,Calloway County,"",---District Total---,085,"","",WKEC,908,11,99,121,1,2,3,1,0,1,1,0,1,3,4,7,0,0,0,6,3,9,109,90,199,220
20192020,018,CALLOWAY,085,Calloway County,"",---District Total---,085,"","",WKEC,908,12,108,115,1,1,2,0,0,0,1,0,1,6,9,15,0,0,0,4,7,11,103,91,194,223
20192020,018,CALLOWAY,085,Calloway County,"",---District Total---,085,"","",WKEC,908,14,1,2,0,0,0,0,0,0,0,0,0,0,0,0,0,0,0,0,0,0,2,1,3,3
20192020,018,CALLOWAY,085,Calloway County,"",---District Total---,085,"","",WKEC,908,All Students,1366,1473,16,19,35,1,1,2,10,8,18,89,97,186,1,0,1,70,63,133,1286,1178,2464,2839
20192020,018,CALLOWAY,085,Calloway County,"",---District Total---,085,"","",WKEC,908,PS,96,101,3,3,6,0,0,0,1,0,1,8,7,15,0,0,0,9,3,12,80,83,163,197
20192020,018,CALLOWAY,085,Calloway County,020,Calloway County High School,085020,018085020,210087000171,WKEC,908,14,1,2,0,0,0,0,0,0,0,0,0,0,0,0,0,0,0,0,0,0,2,1,3,3
20192020,018,CALLOWAY,085,Calloway County,020,Calloway County High School,085020,018085020,210087000171,WKEC,908,All Students,397,454,6,5,11,0,0,0,3,1,4,21,24,45,0,0,0,15,14,29,409,353,762,851
20192020,018,CALLOWAY,085,Calloway County,020,Calloway County High School,085020,018085020,210087000171,WKEC,908,09,125,112,2,1,3,0,0,0,0,1,1,2,6,8,0,0,0,3,4,7,105,113,218,237
20192020,018,CALLOWAY,085,Calloway County,020,Calloway County High School,085020,018085020,210087000171,WKEC,908,10,85,123,2,1,3,0,0,0,1,0,1,10,5,15,0,0,0,4,2,6,106,77,183,208
20192020,018,CALLOWAY,085,Calloway County,020,Calloway County High School,085020,018085020,210087000171,WKEC,908,11,90,113,1,2,3,0,0,0,1,0,1,3,4,7,0,0,0,5,3,8,103,81,184,203
20192020,018,CALLOWAY,085,Calloway County,020,Calloway County High School,085020,018085020,210087000171,WKEC,908,12,96,104,1,1,2,0,0,0,1,0,1,6,9,15,0,0,0,3,5,8,93,81,174,200
20192020,018,CALLOWAY,085,Calloway County,025,East Calloway Elementary School,085025,018085025,210087000172,WKEC,908,05,34,22,0,0,0,0,0,0,0,0,0,1,4,5,0,0,0,1,2,3,20,28,48,56
20192020,018,CALLOWAY,085,Calloway County,025,East Calloway Elementary School,085025,018085025,210087000172,WKEC,908,All Students,146,145,0,0,0,0,0,0,1,0,1,10,16,26,0,0,0,10,5,15,124,125,249,291
20192020,018,CALLOWAY,085,Calloway County,025,East Calloway Elementary School,085025,018085025,210087000172,WKEC,908,01,21,23,0,0,0,0,0,0,1,0,1,3,5,8,0,0,0,0,1,1,19,15,34,44
20192020,018,CALLOWAY,085,Calloway County,025,East Calloway Elementary School,085025,018085025,210087000172,WKEC,908,02,28,24,0,0,0,0,0,0,0,0,0,1,0,1,0,0,0,3,1,4,20,27,47,52
20192020,018,CALLOWAY,085,Calloway County,025,East Calloway Elementary School,085025,018085025,210087000172,WKEC,908,03,22,36,0,0,0,0,0,0,0,0,0,3,0,3,0,0,0,4,0,4,29,22,51,58
20192020,018,CALLOWAY,085,Calloway County,025,East Calloway Elementary School,085025,018085025,210087000172,WKEC,908,04,19,17,0,0,0,0,0,0,0,0,0,1,4,5,0,0,0,2,1,3,14,14,28,36
20192020,018,CALLOWAY,085,Calloway County,025,East Calloway Elementary School,085025,018085025,210087000172,WKEC,908,KG,22,23,0,0,0,0,0,0,0,0,0,1,3,4,0,0,0,0,0,0,22,19,41,45
20192020,018,CALLOWAY,085,Calloway County,035,North Calloway Elementary School,085035,018085035,210087000173,WKEC,908,02,35,29,0,2,2,0,0,0,0,1,1,1,1,2,0,0,0,3,3,6,25,28,53,64
20192020,018,CALLOWAY,085,Calloway County,035,North Calloway Elementary School,085035,018085035,210087000173,WKEC,908,All Students,257,269,3,8,11,0,0,0,2,5,7,24,26,50,0,0,0,12,14,26,228,204,432,526
20192020,018,CALLOWAY,085,Calloway County,035,North Calloway Elementary School,085035,018085035,210087000173,WKEC,908,KG,48,43,1,1,2,0,0,0,2,0,2,6,7,13,0,0,0,2,3,5,32,37,69,91
20192020,018,CALLOWAY,085,Calloway County,035,North Calloway Elementary School,085035,018085035,210087000173,WKEC,908,01,32,55,0,1,1,0,0,0,0,0,0,7,6,13,0,0,0,2,1,3,46,24,70,87
20192020,018,CALLOWAY,085,Calloway County,035,North Calloway Elementary School,085035,018085035,210087000173,WKEC,908,03,41,40,1,1,2,0,0,0,0,0,0,0,5,5,0,0,0,2,2,4,37,33,70,81
20192020,018,CALLOWAY,085,Calloway County,035,North Calloway Elementary School,085035,018085035,210087000173,WKEC,908,04,53,52,0,0,0,0,0,0,0,3,3,4,4,8,0,0,0,2,2,4,46,44,90,105
20192020,018,CALLOWAY,085,Calloway County,035,North Calloway Elementary School,085035,018085035,210087000173,WKEC,908,05,48,50,1,3,4,0,0,0,0,1,1,6,3,9,0,0,0,1,3,4,42,38,80,98
20192020,018,CALLOWAY,085,Calloway County,045,Southwest Calloway Elementary School,085045,018085045,210087000174,WKEC,908,05,40,31,0,0,0,0,1,1,0,1,1,0,3,3,0,0,0,0,3,3,31,32,63,71
20192020,018,CALLOWAY,085,Calloway County,045,Southwest Calloway Elementary School,085045,018085045,210087000174,WKEC,908,All Students,228,218,0,2,2,0,1,1,1,2,3,4,9,13,0,0,0,7,8,15,206,206,412,446
20192020,018,CALLOWAY,085,Calloway County,045,Southwest Calloway Elementary School,085045,018085045,210087000174,WKEC,908,KG,32,46,0,1,1,0,0,0,0,0,0,1,2,3,0,0,0,1,2,3,44,27,71,78
20192020,018,CALLOWAY,085,Calloway County,045,Southwest Calloway Elementary School,085045,018085045,210087000174,WKEC,908,01,44,35,0,0,0,0,0,0,0,0,0,0,2,2,0,0,0,2,3,5,33,39,72,79
20192020,018,CALLOWAY,085,Calloway County,045,Southwest Calloway Elementary School,085045,018085045,210087000174,WKEC,908,02,40,34,0,1,1,0,0,0,0,1,1,1,0,1,0,0,0,3,0,3,30,38,68,74
20192020,018,CALLOWAY,085,Calloway County,045,Southwest Calloway Elementary School,085045,018085045,210087000174,WKEC,908,03,37,42,0,0,0,0,0,0,1,0,1,2,1,3,0,0,0,0,0,0,39,36,75,79
20192020,018,CALLOWAY,085,Calloway County,045,Southwest Calloway Elementary School,085045,018085045,210087000174,WKEC,908,04,35,30,0,0,0,0,0,0,0,0,0,0,1,1,0,0,0,1,0,1,29,34,63,65
20192020,018,CALLOWAY,085,Calloway County,055,Calloway County Middle School,085055,018085055,210087001411,WKEC,908,07,115,120,4,1,5,0,0,0,1,0,1,7,4,11,1,0,1,7,8,15,100,102,202,235
20192020,018,CALLOWAY,085,Calloway County,055,Calloway County Middle School,085055,018085055,210087001411,WKEC,908,All Students,313,357,6,3,9,0,0,0,3,0,3,30,21,51,1,0,1,23,19,42,294,270,564,670
20192020,018,CALLOWAY,085,Calloway County,055,Calloway County Middle School,085055,018085055,210087001411,WKEC,908,06,93,122,2,0,2,0,0,0,0,0,0,14,10,24,0,0,0,9,4,13,97,79,176,215
20192020,018,CALLOWAY,085,Calloway County,055,Calloway County Middle School,085055,018085055,210087001411,WKEC,908,08,105,115,0,2,2,0,0,0,2,0,2,9,7,16,0,0,0,7,7,14,97,89,186,220
20192020,018,CALLOWAY,085,Calloway County,075,Calloway County Preschool Center,085075,018085075,210087000931,WKEC,908,All Students,0,0,0,0,0,0,0,0,0,0,0,0,0,0,0,0,0,0,0,0,0,0,0,0
20192020,018,CALLOWAY,085,Calloway County,075,Calloway County Preschool Center,085075,018085075,210087000931,WKEC,908,PS,96,101,3,3,6,0,0,0,1,0,1,8,7,15,0,0,0,9,3,12,80,83,163,197
20192020,018,CALLOWAY,085,Calloway County,095,Calloway County Day Treatment,085095,018085095,210087002366,WKEC,908,10,1,2,0,1,1,0,0,0,0,0,0,0,0,0,0,0,0,0,0,0,2,0,2,3
20192020,018,CALLOWAY,085,Calloway County,095,Calloway County Day Treatment,085095,018085095,210087002366,WKEC,908,All Students,3,9,1,1,2,0,0,0,0,0,0,0,1,1,0,0,0,1,0,1,7,1,8,12
20192020,018,CALLOWAY,085,Calloway County,095,Calloway County Day Treatment,085095,018085095,210087002366,WKEC,908,07,0,2,1,0,1,0,0,0,0,0,0,0,0,0,0,0,0,0,0,0,1,0,1,2
20192020,018,CALLOWAY,085,Calloway County,095,Calloway County Day Treatment,085095,018085095,210087002366,WKEC,908,08,1,2,0,0,0,0,0,0,0,0,0,0,0,0,0,0,0,0,0,0,2,1,3,3
20192020,018,CALLOWAY,085,Calloway County,095,Calloway County Day Treatment,085095,018085095,210087002366,WKEC,908,09,1,0,0,0,0,0,0,0,0,0,0,0,1,1,0,0,0,0,0,0,0,0,0,1
20192020,018,CALLOWAY,085,Calloway County,095,Calloway County Day Treatment,085095,018085095,210087002366,WKEC,908,11,0,3,0,0,0,0,0,0,0,0,0,0,0,0,0,0,0,1,0,1,2,0,2,3
20192020,018,CALLOWAY,085,Calloway County,096,Calloway County Alternative Program,085096,018085096,210087002370,WKEC,908,11,9,5,0,0,0,1,0,1,0,0,0,0,0,0,0,0,0,0,0,0,4,9,13,14
20192020,018,CALLOWAY,085,Calloway County,096,Calloway County Alternative Program,085096,018085096,210087002370,WKEC,908,All Students,22,21,0,0,0,1,0,1,0,0,0,0,0,0,0,0,0,2,3,5,18,19,37,43
20192020,018,CALLOWAY,085,Calloway County,096,Calloway County Alternative Program,085096,018085096,210087002370,WKEC,908,06,0,1,0,0,0,0,0,0,0,0,0,0,0,0,0,0,0,1,0,1,0,0,0,1
20192020,018,CALLOWAY,085,Calloway County,096,Calloway County Alternative Program,085096,018085096,210087002370,WKEC,908,07,0,1,0,0,0,0,0,0,0,0,0,0,0,0,0,0,0,0,0,0,1,0,1,1
20192020,018,CALLOWAY,085,Calloway County,096,Calloway County Alternative Program,085096,018085096,210087002370,WKEC,908,08,0,1,0,0,0,0,0,0,0,0,0,0,0,0,0,0,0,0,0,0,1,0,1,1
20192020,018,CALLOWAY,085,Calloway County,096,Calloway County Alternative Program,085096,018085096,210087002370,WKEC,908,09,0,2,0,0,0,0,0,0,0,0,0,0,0,0,0,0,0,0,0,0,2,0,2,2
20192020,018,CALLOWAY,085,Calloway County,096,Calloway County Alternative Program,085096,018085096,210087002370,WKEC,908,10,1,0,0,0,0,0,0,0,0,0,0,0,0,0,0,0,0,0,1,1,0,0,0,1
20192020,018,CALLOWAY,085,Calloway County,096,Calloway County Alternative Program,085096,018085096,210087002370,WKEC,908,12,12,11,0,0,0,0,0,0,0,0,0,0,0,0,0,0,0,1,2,3,10,10,20,23
20192020,019,CAMPBELL,091,Campbell County,"",---District Total---,091,"","",NKCES,905,10,185,191,5,6,11,0,0,0,3,2,5,2,2,4,1,0,1,3,6,9,177,169,346,376
20192020,019,CAMPBELL,091,Campbell County,"",---District Total---,091,"","",NKCES,905,All Students,2452,2521,54,61,115,3,1,4,35,25,60,44,51,95,2,2,4,90,113,203,2293,2199,4492,4973
20192020,019,CAMPBELL,091,Campbell County,"",---District Total---,091,"","",NKCES,905,PS,69,94,1,1,2,0,0,0,1,1,2,2,2,4,0,0,0,2,1,3,88,64,152,163
20192020,019,CAMPBELL,091,Campbell County,"",---District Total---,091,"","",NKCES,905,KG,189,202,0,4,4,0,0,0,5,1,6,2,6,8,0,1,1,10,8,18,185,169,354,391
20192020,019,CAMPBELL,091,Campbell County,"",---District Total---,091,"","",NKCES,905,01,179,184,4,4,8,0,0,0,1,2,3,2,3,5,0,0,0,8,15,23,169,155,324,363
20192020,019,CAMPBELL,091,Campbell County,"",---District Total---,091,"","",NKCES,905,02,196,178,3,5,8,1,0,1,3,2,5,3,1,4,0,0,0,9,6,15,159,182,341,374
20192020,019,CAMPBELL,091,Campbell County,"",---District Total---,091,"","",NKCES,905,03,198,192,3,4,7,0,0,0,4,4,8,2,6,8,0,0,0,11,8,19,172,176,348,390
20192020,019,CAMPBELL,091,Campbell County,"",---District Total---,091,"","",NKCES,905,04,194,218,7,2,9,1,0,1,4,1,5,6,6,12,0,0,0,8,12,20,192,173,365,412
20192020,019,CAMPBELL,091,Campbell County,"",---District Total---,091,"","",NKCES,905,05,198,200,5,8,13,1,0,1,1,2,3,6,6,12,0,0,0,9,9,18,178,173,351,398
20192020,019,CAMPBELL,091,Campbell County,"",---District Total---,091,"","",NKCES,905,06,219,199,4,4,8,0,0,0,0,0,0,3,4,7,1,1,2,7,12,19,184,198,382,418
20192020,019,CAMPBELL,091,Campbell County,"",---District Total---,091,"","",NKCES,905,07,196,208,7,5,12,0,1,1,2,3,5,3,7,10,0,0,0,10,10,20,186,170,356,404
20192020,019,CAMPBELL,091,Campbell County,"",---District Total---,091,"","",NKCES,905,12,148,195,4,3,7,0,0,0,5,2,7,3,1,4,0,0,0,4,3,7,179,139,318,343
20192020,019,CAMPBELL,091,Campbell County,"",---District Total---,091,"","",NKCES,905,08,201,194,5,5,10,0,0,0,1,3,4,6,4,10,0,0,0,5,14,19,177,175,352,395
20192020,019,CAMPBELL,091,Campbell County,"",---District Total---,091,"","",NKCES,905,14,4,3,0,0,0,0,0,0,0,0,0,0,0,0,0,0,0,0,0,0,3,4,7,7
20192020,019,CAMPBELL,091,Campbell County,"",---District Total---,091,"","",NKCES,905,09,187,189,3,6,9,0,0,0,5,1,6,4,2,6,0,0,0,4,5,9,173,173,346,376
20192020,019,CAMPBELL,091,Campbell County,"",---District Total---,091,"","",NKCES,905,11,158,168,4,5,9,0,0,0,1,2,3,2,3,5,0,0,0,2,5,7,159,143,302,326
20192020,019,CAMPBELL,091,Campbell County,011,Campbell County Middle School,091011,019091011,210090001306,NKCES,905,06,219,196,4,4,8,0,0,0,0,0,0,3,4,7,1,1,2,7,12,19,181,198,379,415
20192020,019,CAMPBELL,091,Campbell County,011,Campbell County Middle School,091011,019091011,210090001306,NKCES,905,All Students,612,591,15,14,29,0,1,1,3,6,9,12,15,27,1,1,2,21,35,56,539,540,1079,1203
20192020,019,CAMPBELL,091,Campbell County,011,Campbell County Middle School,091011,019091011,210090001306,NKCES,905,07,193,205,7,5,12,0,1,1,2,3,5,3,7,10,0,0,0,10,9,19,183,168,351,398
20192020,019,CAMPBELL,091,Campbell County,011,Campbell County Middle School,091011,019091011,210090001306,NKCES,905,08,200,190,4,5,9,0,0,0,1,3,4,6,4,10,0,0,0,4,14,18,175,174,349,390
20192020,019,CAMPBELL,091,Campbell County,012,John W. Reiley Elementary School,091012,019091012,210090001320,NKCES,905,05,45,43,0,1,1,0,0,0,0,0,0,1,2,3,0,0,0,1,2,3,41,40,81,88
20192020,019,CAMPBELL,091,Campbell County,012,John W. Reiley Elementary School,091012,019091012,210090001320,NKCES,905,All Students,221,247,3,2,5,0,0,0,2,1,3,3,4,7,0,0,0,6,6,12,233,208,441,468
20192020,019,CAMPBELL,091,Campbell County,012,John W. Reiley Elementary School,091012,019091012,210090001320,NKCES,905,PS,16,22,0,0,0,0,0,0,1,0,1,0,0,0,0,0,0,1,1,2,20,15,35,38
20192020,019,CAMPBELL,091,Campbell County,012,John W. Reiley Elementary School,091012,019091012,210090001320,NKCES,905,KG,38,36,0,0,0,0,0,0,0,0,0,0,2,2,0,0,0,1,1,2,35,35,70,74
20192020,019,CAMPBELL,091,Campbell County,012,John W. Reiley Elementary School,091012,019091012,210090001320,NKCES,905,01,31,41,2,0,2,0,0,0,0,0,0,0,0,0,0,0,0,0,1,1,39,30,69,72
20192020,019,CAMPBELL,091,Campbell County,012,John W. Reiley Elementary School,091012,019091012,210090001320,NKCES,905,02,30,38,0,0,0,0,0,0,0,0,0,1,0,1,0,0,0,2,0,2,35,30,65,68
20192020,019,CAMPBELL,091,Campbell County,012,John W. Reiley Elementary School,091012,019091012,210090001320,NKCES,905,03,43,49,0,1,1,0,0,0,1,1,2,1,0,1,0,0,0,1,1,2,46,40,86,92
20192020,019,CAMPBELL,091,Campbell County,012,John W. Reiley Elementary School,091012,019091012,210090001320,NKCES,905,04,34,40,1,0,1,0,0,0,1,0,1,0,0,0,0,0,0,1,1,2,37,33,70,74
20192020,019,CAMPBELL,091,Campbell County,013,Donald E. Cline Elementary School,091013,019091013,210090001335,NKCES,905,04,31,31,1,1,2,0,0,0,2,0,2,2,1,3,0,0,0,0,3,3,26,26,52,62
20192020,019,CAMPBELL,091,Campbell County,013,Donald E. Cline Elementary School,091013,019091013,210090001335,NKCES,905,All Students,174,179,7,8,15,0,0,0,6,5,11,7,5,12,0,0,0,13,8,21,146,148,294,353
20192020,019,CAMPBELL,091,Campbell County,013,Donald E. Cline Elementary School,091013,019091013,210090001335,NKCES,905,PS,9,17,0,1,1,0,0,0,0,1,1,2,0,2,0,0,0,1,0,1,14,7,21,26
20192020,019,CAMPBELL,091,Campbell County,013,Donald E. Cline Elementary School,091013,019091013,210090001335,NKCES,905,KG,29,35,0,1,1,0,0,0,3,0,3,1,1,2,0,0,0,3,1,4,28,26,54,64
20192020,019,CAMPBELL,091,Campbell County,013,Donald E. Cline Elementary School,091013,019091013,210090001335,NKCES,905,01,25,27,1,1,2,0,0,0,0,1,1,0,0,0,0,0,0,4,3,7,22,20,42,52
20192020,019,CAMPBELL,091,Campbell County,013,Donald E. Cline Elementary School,091013,019091013,210090001335,NKCES,905,02,39,30,1,3,4,0,0,0,1,1,2,1,1,2,0,0,0,2,1,3,25,33,58,69
20192020,019,CAMPBELL,091,Campbell County,013,Donald E. Cline Elementary School,091013,019091013,210090001335,NKCES,905,03,25,27,3,0,3,0,0,0,0,3,3,0,1,1,0,0,0,2,0,2,22,21,43,52
20192020,019,CAMPBELL,091,Campbell County,013,Donald E. Cline Elementary School,091013,019091013,210090001335,NKCES,905,05,25,29,1,2,3,0,0,0,0,0,0,3,1,4,0,0,0,2,0,2,23,22,45,54
20192020,019,CAMPBELL,091,Campbell County,016,Alexandria Educational Center,091016,019091016,210090001398,NKCES,905,11,3,6,0,1,1,0,0,0,0,0,0,0,0,0,0,0,0,0,0,0,6,2,8,9
20192020,019,CAMPBELL,091,Campbell County,016,Alexandria Educational Center,091016,019091016,210090001398,NKCES,905,All Students,15,30,2,1,3,0,0,0,0,0,0,0,1,1,0,0,0,4,3,7,24,10,34,45
20192020,019,CAMPBELL,091,Campbell County,016,Alexandria Educational Center,091016,019091016,210090001398,NKCES,905,06,0,3,0,0,0,0,0,0,0,0,0,0,0,0,0,0,0,0,0,0,3,0,3,3
20192020,019,CAMPBELL,091,Campbell County,016,Alexandria Educational Center,091016,019091016,210090001398,NKCES,905,07,3,3,0,0,0,0,0,0,0,0,0,0,0,0,0,0,0,0,1,1,3,2,5,6
20192020,019,CAMPBELL,091,Campbell County,016,Alexandria Educational Center,091016,019091016,210090001398,NKCES,905,08,1,4,1,0,1,0,0,0,0,0,0,0,0,0,0,0,0,1,0,1,2,1,3,5
20192020,019,CAMPBELL,091,Campbell County,016,Alexandria Educational Center,091016,019091016,210090001398,NKCES,905,09,3,5,0,0,0,0,0,0,0,0,0,0,0,0,0,0,0,1,0,1,4,3,7,8
20192020,019,CAMPBELL,091,Campbell County,016,Alexandria Educational Center,091016,019091016,210090001398,NKCES,905,10,4,5,1,0,1,0,0,0,0,0,0,0,1,1,0,0,0,1,2,3,3,1,4,9
20192020,019,CAMPBELL,091,Campbell County,016,Alexandria Educational Center,091016,019091016,210090001398,NKCES,905,12,1,4,0,0,0,0,0,0,0,0,0,0,0,0,0,0,0,1,0,1,3,1,4,5
20192020,019,CAMPBELL,091,Campbell County,019,Campbell Ridge Elementary,091019,019091019,210090001978,NKCES,905,04,57,53,1,0,1,1,0,1,1,0,1,2,2,4,0,0,0,1,3,4,47,52,99,110
20192020,019,CAMPBELL,091,Campbell County,019,Campbell Ridge Elementary,091019,019091019,210090001978,NKCES,905,All Students,304,291,2,4,6,1,0,1,6,1,7,2,6,8,0,0,0,9,14,23,271,279,550,595
20192020,019,CAMPBELL,091,Campbell County,019,Campbell Ridge Elementary,091019,019091019,210090001978,NKCES,905,PS,19,24,0,0,0,0,0,0,0,0,0,0,1,1,0,0,0,0,0,0,24,18,42,43
20192020,019,CAMPBELL,091,Campbell County,019,Campbell Ridge Elementary,091019,019091019,210090001978,NKCES,905,KG,45,55,0,0,0,0,0,0,1,0,1,0,2,2,0,0,0,1,3,4,53,40,93,100
20192020,019,CAMPBELL,091,Campbell County,019,Campbell Ridge Elementary,091019,019091019,210090001978,NKCES,905,01,42,45,0,1,1,0,0,0,1,0,1,0,0,0,0,0,0,1,1,2,43,40,83,87
20192020,019,CAMPBELL,091,Campbell County,019,Campbell Ridge Elementary,091019,019091019,210090001978,NKCES,905,02,52,44,1,1,2,0,0,0,1,0,1,0,0,0,0,0,0,1,1,2,41,50,91,96
20192020,019,CAMPBELL,091,Campbell County,019,Campbell Ridge Elementary,091019,019091019,210090001978,NKCES,905,03,58,40,0,1,1,0,0,0,1,0,1,0,1,1,0,0,0,3,2,5,36,54,90,98
20192020,019,CAMPBELL,091,Campbell County,019,Campbell Ridge Elementary,091019,019091019,210090001978,NKCES,905,05,50,54,0,1,1,0,0,0,1,1,2,0,1,1,0,0,0,2,4,6,51,43,94,104
20192020,019,CAMPBELL,091,Campbell County,035,Crossroads Elementary School,091035,019091035,210090002198,NKCES,905,04,49,61,4,1,5,0,0,0,0,1,1,2,2,4,0,0,0,6,5,11,49,40,89,110
20192020,019,CAMPBELL,091,Campbell County,035,Crossroads Elementary School,091035,019091035,210090002198,NKCES,905,All Students,301,297,10,13,23,2,0,2,2,4,6,6,11,17,0,1,1,25,29,54,252,243,495,598
20192020,019,CAMPBELL,091,Campbell County,035,Crossroads Elementary School,091035,019091035,210090002198,NKCES,905,PS,25,31,1,0,1,0,0,0,0,0,0,0,1,1,0,0,0,0,0,0,30,24,54,56
20192020,019,CAMPBELL,091,Campbell County,035,Crossroads Elementary School,091035,019091035,210090002198,NKCES,905,KG,60,53,0,3,3,0,0,0,1,1,2,1,1,2,0,1,1,5,3,8,46,51,97,113
20192020,019,CAMPBELL,091,Campbell County,035,Crossroads Elementary School,091035,019091035,210090002198,NKCES,905,01,53,41,1,2,3,0,0,0,0,1,1,0,3,3,0,0,0,3,9,12,37,38,75,94
20192020,019,CAMPBELL,091,Campbell County,035,Crossroads Elementary School,091035,019091035,210090002198,NKCES,905,02,42,40,1,1,2,1,0,1,0,1,1,1,0,1,0,0,0,4,4,8,33,36,69,82
20192020,019,CAMPBELL,091,Campbell County,035,Crossroads Elementary School,091035,019091035,210090002198,NKCES,905,03,45,56,0,2,2,0,0,0,1,0,1,1,3,4,0,0,0,5,5,10,49,35,84,101
20192020,019,CAMPBELL,091,Campbell County,035,Crossroads Elementary School,091035,019091035,210090002198,NKCES,905,05,52,46,4,4,8,1,0,1,0,0,0,1,2,3,0,0,0,2,3,5,38,43,81,98
20192020,019,CAMPBELL,091,Campbell County,050,Grant's Lick Elementary School,091050,019091050,210090000180,NKCES,905,03,27,20,0,0,0,0,0,0,1,0,1,0,1,1,0,0,0,0,0,0,19,26,45,47
20192020,019,CAMPBELL,091,Campbell County,050,Grant's Lick Elementary School,091050,019091050,210090000180,NKCES,905,All Students,154,160,0,0,0,0,0,0,2,1,3,3,2,5,0,0,0,2,1,3,153,150,303,314
20192020,019,CAMPBELL,091,Campbell County,050,Grant's Lick Elementary School,091050,019091050,210090000180,NKCES,905,KG,17,23,0,0,0,0,0,0,0,0,0,0,0,0,0,0,0,0,0,0,23,17,40,40
20192020,019,CAMPBELL,091,Campbell County,050,Grant's Lick Elementary School,091050,019091050,210090000180,NKCES,905,01,28,30,0,0,0,0,0,0,0,0,0,2,0,2,0,0,0,0,1,1,28,27,55,58
20192020,019,CAMPBELL,091,Campbell County,050,Grant's Lick Elementary School,091050,019091050,210090000180,NKCES,905,02,33,26,0,0,0,0,0,0,1,0,1,0,0,0,0,0,0,0,0,0,25,33,58,59
20192020,019,CAMPBELL,091,Campbell County,050,Grant's Lick Elementary School,091050,019091050,210090000180,NKCES,905,04,23,33,0,0,0,0,0,0,0,0,0,0,1,1,0,0,0,0,0,0,33,22,55,56
20192020,019,CAMPBELL,091,Campbell County,050,Grant's Lick Elementary School,091050,019091050,210090000180,NKCES,905,05,26,28,0,0,0,0,0,0,0,1,1,1,0,1,0,0,0,2,0,2,25,25,50,54
20192020,019,CAMPBELL,091,Campbell County,100,Campbell County High School,091100,019091100,210090000941,NKCES,905,14,4,3,0,0,0,0,0,0,0,0,0,0,0,0,0,0,0,0,0,0,3,4,7,7
20192020,019,CAMPBELL,091,Campbell County,100,Campbell County High School,091100,019091100,210090000941,NKCES,905,All Students,671,726,15,19,34,0,0,0,14,7,21,11,7,18,1,0,1,10,17,27,675,621,1296,1397
20192020,019,CAMPBELL,091,Campbell County,100,Campbell County High School,091100,019091100,210090000941,NKCES,905,09,184,184,3,6,9,0,0,0,5,1,6,4,2,6,0,0,0,3,5,8,169,170,339,368
20192020,019,CAMPBELL,091,Campbell County,100,Campbell County High School,091100,019091100,210090000941,NKCES,905,10,181,186,4,6,10,0,0,0,3,2,5,2,1,3,1,0,1,2,4,6,174,168,342,367
20192020,019,CAMPBELL,091,Campbell County,100,Campbell County High School,091100,019091100,210090000941,NKCES,905,11,155,162,4,4,8,0,0,0,1,2,3,2,3,5,0,0,0,2,5,7,153,141,294,317
20192020,019,CAMPBELL,091,Campbell County,100,Campbell County High School,091100,019091100,210090000941,NKCES,905,12,147,191,4,3,7,0,0,0,5,2,7,3,1,4,0,0,0,3,3,6,176,138,314,338
20192020,109,TAYLOR,092,Campbellsville Independent,"",---District Total---,092,"","",GRREC,902,01,53,50,6,5,11,1,0,1,0,1,1,4,0,4,0,0,0,6,8,14,33,39,72,103
20192020,109,TAYLOR,092,Campbellsville Independent,"",---District Total---,092,"","",GRREC,902,All Students,568,597,60,47,107,2,1,3,9,6,15,32,21,53,0,1,1,75,65,140,419,427,846,1165
20192020,109,TAYLOR,092,Campbellsville Independent,"",---District Total---,092,"","",GRREC,902,PS,20,39,5,0,5,0,0,0,0,1,1,1,1,2,0,0,0,5,2,7,28,16,44,59
20192020,109,TAYLOR,092,Campbellsville Independent,"",---District Total---,092,"","",GRREC,902,KG,59,66,9,5,14,0,0,0,1,0,1,3,2,5,0,0,0,9,4,13,44,48,92,125
20192020,109,TAYLOR,092,Campbellsville Independent,"",---District Total---,092,"","",GRREC,902,02,41,50,6,1,7,0,0,0,2,0,2,3,3,6,0,0,0,7,6,13,32,31,63,91
20192020,109,TAYLOR,092,Campbellsville Independent,"",---District Total---,092,"","",GRREC,902,03,51,42,4,3,7,0,0,0,0,1,1,0,2,2,0,0,0,5,4,9,33,41,74,93
20192020,109,TAYLOR,092,Campbellsville Independent,"",---District Total---,092,"","",GRREC,902,04,49,64,3,8,11,0,0,0,1,1,2,7,3,10,0,0,0,14,7,21,39,30,69,113
20192020,109,TAYLOR,092,Campbellsville Independent,"",---District Total---,092,"","",GRREC,902,05,38,52,9,1,10,0,1,1,0,0,0,0,2,2,0,1,1,6,5,11,37,28,65,90
20192020,109,TAYLOR,092,Campbellsville Independent,"",---District Total---,092,"","",GRREC,902,06,46,47,6,4,10,0,0,0,0,0,0,3,2,5,0,0,0,8,9,17,30,31,61,93
20192020,109,TAYLOR,092,Campbellsville Independent,"",---District Total---,092,"","",GRREC,902,07,39,46,4,5,9,0,0,0,0,0,0,3,1,4,0,0,0,3,6,9,36,27,63,85
20192020,109,TAYLOR,092,Campbellsville Independent,"",---District Total---,092,"","",GRREC,902,08,43,46,3,3,6,0,0,0,0,1,1,4,1,5,0,0,0,2,6,8,37,32,69,89
20192020,109,TAYLOR,092,Campbellsville Independent,"",---District Total---,092,"","",GRREC,902,09,38,34,1,3,4,1,0,1,0,1,1,2,1,3,0,0,0,3,1,4,27,32,59,72
20192020,109,TAYLOR,092,Campbellsville Independent,"",---District Total---,092,"","",GRREC,902,10,36,33,1,4,5,0,0,0,2,0,2,1,1,2,0,0,0,5,2,7,24,29,53,69
20192020,109,TAYLOR,092,Campbellsville Independent,"",---District Total---,092,"","",GRREC,902,11,36,33,2,2,4,0,0,0,2,1,3,1,2,3,0,0,0,5,3,8,23,28,51,69
20192020,109,TAYLOR,092,Campbellsville Independent,"",---District Total---,092,"","",GRREC,902,12,38,32,4,3,7,0,0,0,1,0,1,1,1,2,0,0,0,2,4,6,24,30,54,70
20192020,109,TAYLOR,092,Campbellsville Independent,"",---District Total---,092,"","",GRREC,902,14,1,2,2,0,2,0,0,0,0,0,0,0,0,0,0,0,0,0,0,0,0,1,1,3
20192020,109,TAYLOR,092,Campbellsville Independent,010,Campbellsville Elementary School,092010,109092010,210093000182,GRREC,902,07,0,1,0,0,0,0,0,0,0,0,0,0,0,0,0,0,0,0,0,0,1,0,1,1
20192020,109,TAYLOR,092,Campbellsville Independent,010,Campbellsville Elementary School,092010,109092010,210093000182,GRREC,902,All Students,291,325,37,23,60,1,1,2,4,3,7,17,12,29,0,1,1,47,34,81,219,217,436,616
20192020,109,TAYLOR,092,Campbellsville Independent,010,Campbellsville Elementary School,092010,109092010,210093000182,GRREC,902,PS,20,39,5,0,5,0,0,0,0,1,1,1,1,2,0,0,0,5,2,7,28,16,44,59
20192020,109,TAYLOR,092,Campbellsville Independent,010,Campbellsville Elementary School,092010,109092010,210093000182,GRREC,902,KG,59,66,9,5,14,0,0,0,1,0,1,3,2,5,0,0,0,9,4,13,44,48,92,125
20192020,109,TAYLOR,092,Campbellsville Independent,010,Campbellsville Elementary School,092010,109092010,210093000182,GRREC,902,01,53,50,6,5,11,1,0,1,0,1,1,4,0,4,0,0,0,6,8,14,33,39,72,103
20192020,109,TAYLOR,092,Campbellsville Independent,010,Campbellsville Elementary School,092010,109092010,210093000182,GRREC,902,02,41,50,6,1,7,0,0,0,2,0,2,3,3,6,0,0,0,7,6,13,32,31,63,91
20192020,109,TAYLOR,092,Campbellsville Independent,010,Campbellsville Elementary School,092010,109092010,210093000182,GRREC,902,03,51,42,4,3,7,0,0,0,0,1,1,0,2,2,0,0,0,5,4,9,33,41,74,93
20192020,109,TAYLOR,092,Campbellsville Independent,010,Campbellsville Elementary School,092010,109092010,210093000182,GRREC,902,04,49,64,3,8,11,0,0,0,1,1,2,7,3,10,0,0,0,14,7,21,39,30,69,113
20192020,109,TAYLOR,092,Campbellsville Independent,010,Campbellsville Elementary School,092010,109092010,210093000182,GRREC,902,05,38,52,9,1,10,0,1,1,0,0,0,0,2,2,0,1,1,6,5,11,37,28,65,90
20192020,109,TAYLOR,092,Campbellsville Independent,011,Campbellsville Eagle Academy,092011,109092011,210093001653,GRREC,902,10,0,3,0,0,0,0,0,0,0,0,0,1,0,1,0,0,0,0,0,0,2,0,2,3
20192020,109,TAYLOR,092,Campbellsville Independent,011,Campbellsville Eagle Academy,092011,109092011,210093001653,GRREC,902,12,2,0,0,0,0,0,0,0,0,0,0,0,0,0,0,0,0,0,0,0,0,2,2,2
20192020,109,TAYLOR,092,Campbellsville Independent,011,Campbellsville Eagle Academy,092011,109092011,210093001653,GRREC,902,All Students,5,8,0,1,1,0,0,0,0,0,0,1,0,1,0,0,0,0,0,0,7,4,11,13
20192020,109,TAYLOR,092,Campbellsville Independent,011,Campbellsville Eagle Academy,092011,109092011,210093001653,GRREC,902,07,0,2,0,0,0,0,0,0,0,0,0,0,0,0,0,0,0,0,0,0,2,0,2,2
20192020,109,TAYLOR,092,Campbellsville Independent,011,Campbellsville Eagle Academy,092011,109092011,210093001653,GRREC,902,08,1,0,0,0,0,0,0,0,0,0,0,0,0,0,0,0,0,0,0,0,0,1,1,1
20192020,109,TAYLOR,092,Campbellsville Independent,011,Campbellsville Eagle Academy,092011,109092011,210093001653,GRREC,902,09,1,2,0,0,0,0,0,0,0,0,0,0,0,0,0,0,0,0,0,0,2,1,3,3
20192020,109,TAYLOR,092,Campbellsville Independent,011,Campbellsville Eagle Academy,092011,109092011,210093001653,GRREC,902,11,1,1,0,1,1,0,0,0,0,0,0,0,0,0,0,0,0,0,0,0,1,0,1,2
20192020,109,TAYLOR,092,Campbellsville Independent,020,Campbellsville High School,092020,109092020,210093000183,GRREC,902,14,1,2,2,0,2,0,0,0,0,0,0,0,0,0,0,0,0,0,0,0,0,1,1,3
20192020,109,TAYLOR,092,Campbellsville Independent,020,Campbellsville High School,092020,109092020,210093000183,GRREC,902,12,36,32,4,3,7,0,0,0,1,0,1,1,1,2,0,0,0,2,4,6,24,28,52,68
20192020,109,TAYLOR,092,Campbellsville Independent,020,Campbellsville High School,092020,109092020,210093000183,GRREC,902,All Students,145,128,10,11,21,1,0,1,5,2,7,4,5,9,0,0,0,15,10,25,93,117,210,273
20192020,109,TAYLOR,092,Campbellsville Independent,020,Campbellsville High School,092020,109092020,210093000183,GRREC,902,09,37,32,1,3,4,1,0,1,0,1,1,2,1,3,0,0,0,3,1,4,25,31,56,69
20192020,109,TAYLOR,092,Campbellsville Independent,020,Campbellsville High School,092020,109092020,210093000183,GRREC,902,10,36,30,1,4,5,0,0,0,2,0,2,0,1,1,0,0,0,5,2,7,22,29,51,66
20192020,109,TAYLOR,092,Campbellsville Independent,020,Campbellsville High School,092020,109092020,210093000183,GRREC,902,11,35,32,2,1,3,0,0,0,2,1,3,1,2,3,0,0,0,5,3,8,22,28,50,67
20192020,109,TAYLOR,092,Campbellsville Independent,025,Campbellsville Middle School,092025,109092025,210093000184,GRREC,902,All Students,127,136,13,12,25,0,0,0,0,1,1,10,4,14,0,0,0,13,21,34,100,89,189,263
20192020,109,TAYLOR,092,Campbellsville Independent,025,Campbellsville Middle School,092025,109092025,210093000184,GRREC,902,06,46,47,6,4,10,0,0,0,0,0,0,3,2,5,0,0,0,8,9,17,30,31,61,93
20192020,109,TAYLOR,092,Campbellsville Independent,025,Campbellsville Middle School,092025,109092025,210093000184,GRREC,902,07,39,43,4,5,9,0,0,0,0,0,0,3,1,4,0,0,0,3,6,9,33,27,60,82
20192020,109,TAYLOR,092,Campbellsville Independent,025,Campbellsville Middle School,092025,109092025,210093000184,GRREC,902,08,42,46,3,3,6,0,0,0,0,1,1,4,1,5,0,0,0,2,6,8,37,31,68,88
20192020,020,CARLISLE,095,Carlisle County,"",---District Total---,095,"","",WKEC,908,12,11,25,0,0,0,0,0,0,0,0,0,1,0,1,0,0,0,0,0,0,24,11,35,36
20192020,020,CARLISLE,095,Carlisle County,"",---District Total---,095,"","",WKEC,908,All Students,325,349,2,6,8,0,0,0,1,0,1,30,16,46,0,1,1,6,8,14,310,294,604,674
20192020,020,CARLISLE,095,Carlisle County,"",---District Total---,095,"","",WKEC,908,PS,39,53,1,0,1,0,0,0,0,0,0,1,6,7,0,0,0,3,2,5,48,31,79,92
20192020,020,CARLISLE,095,Carlisle County,"",---District Total---,095,"","",WKEC,908,KG,35,24,0,0,0,0,0,0,0,0,0,4,1,5,0,0,0,0,1,1,20,33,53,59
20192020,020,CARLISLE,095,Carlisle County,"",---District Total---,095,"","",WKEC,908,01,31,34,0,0,0,0,0,0,0,0,0,5,0,5,0,0,0,0,1,1,29,30,59,65
20192020,020,CARLISLE,095,Carlisle County,"",---District Total---,095,"","",WKEC,908,02,27,25,0,1,1,0,0,0,0,0,0,1,1,2,0,0,0,0,0,0,24,25,49,52
20192020,020,CARLISLE,095,Carlisle County,"",---District Total---,095,"","",WKEC,908,03,20,24,0,1,1,0,0,0,0,0,0,2,0,2,0,0,0,0,0,0,22,19,41,44
20192020,020,CARLISLE,095,Carlisle County,"",---District Total---,095,"","",WKEC,908,04,23,14,0,0,0,0,0,0,0,0,0,1,2,3,0,0,0,0,1,1,13,20,33,37
20192020,020,CARLISLE,095,Carlisle County,"",---District Total---,095,"","",WKEC,908,05,32,31,0,0,0,0,0,0,0,0,0,6,3,9,0,0,0,2,1,3,23,28,51,63
20192020,020,CARLISLE,095,Carlisle County,"",---District Total---,095,"","",WKEC,908,06,19,30,0,0,0,0,0,0,0,0,0,2,1,3,0,0,0,1,1,2,27,17,44,49
20192020,020,CARLISLE,095,Carlisle County,"",---District Total---,095,"","",WKEC,908,07,25,28,0,0,0,0,0,0,0,0,0,3,2,5,0,1,1,1,1,2,24,21,45,53
20192020,020,CARLISLE,095,Carlisle County,"",---District Total---,095,"","",WKEC,908,08,24,38,1,3,4,0,0,0,1,0,1,4,1,5,0,0,0,0,1,1,32,19,51,62
20192020,020,CARLISLE,095,Carlisle County,"",---District Total---,095,"","",WKEC,908,09,36,25,1,0,1,0,0,0,0,0,0,0,2,2,0,0,0,2,0,2,22,34,56,61
20192020,020,CARLISLE,095,Carlisle County,"",---District Total---,095,"","",WKEC,908,10,20,26,0,0,0,0,0,0,0,0,0,0,2,2,0,0,0,0,0,0,26,18,44,46
20192020,020,CARLISLE,095,Carlisle County,"",---District Total---,095,"","",WKEC,908,11,22,25,0,1,1,0,0,0,0,0,0,1,1,2,0,0,0,0,1,1,24,19,43,47
20192020,020,CARLISLE,095,Carlisle County,020,Carlisle County Middle School,095020,020095020,210096000185,WKEC,908,07,25,28,0,0,0,0,0,0,0,0,0,3,2,5,0,1,1,1,1,2,24,21,45,53
20192020,020,CARLISLE,095,Carlisle County,020,Carlisle County Middle School,095020,020095020,210096000185,WKEC,908,All Students,68,96,1,3,4,0,0,0,1,0,1,9,4,13,0,1,1,2,3,5,83,57,140,164
20192020,020,CARLISLE,095,Carlisle County,020,Carlisle County Middle School,095020,020095020,210096000185,WKEC,908,06,19,30,0,0,0,0,0,0,0,0,0,2,1,3,0,0,0,1,1,2,27,17,44,49
20192020,020,CARLISLE,095,Carlisle County,020,Carlisle County Middle School,095020,020095020,210096000185,WKEC,908,08,24,38,1,3,4,0,0,0,1,0,1,4,1,5,0,0,0,0,1,1,32,19,51,62
20192020,020,CARLISLE,095,Carlisle County,040,Carlisle County High School,095040,020095040,210096000186,WKEC,908,11,22,25,0,1,1,0,0,0,0,0,0,1,1,2,0,0,0,0,1,1,24,19,43,47
20192020,020,CARLISLE,095,Carlisle County,040,Carlisle County High School,095040,020095040,210096000186,WKEC,908,All Students,89,101,1,1,2,0,0,0,0,0,0,2,5,7,0,0,0,2,1,3,96,82,178,190
20192020,020,CARLISLE,095,Carlisle County,040,Carlisle County High School,095040,020095040,210096000186,WKEC,908,09,36,25,1,0,1,0,0,0,0,0,0,0,2,2,0,0,0,2,0,2,22,34,56,61
20192020,020,CARLISLE,095,Carlisle County,040,Carlisle County High School,095040,020095040,210096000186,WKEC,908,10,20,26,0,0,0,0,0,0,0,0,0,0,2,2,0,0,0,0,0,0,26,18,44,46
20192020,020,CARLISLE,095,Carlisle County,040,Carlisle County High School,095040,020095040,210096000186,WKEC,908,12,11,25,0,0,0,0,0,0,0,0,0,1,0,1,0,0,0,0,0,0,24,11,35,36
20192020,020,CARLISLE,095,Carlisle County,060,Carlisle County Elementary School,095060,020095060,210096000187,WKEC,908,04,23,14,0,0,0,0,0,0,0,0,0,1,2,3,0,0,0,0,1,1,13,20,33,37
20192020,020,CARLISLE,095,Carlisle County,060,Carlisle County Elementary School,095060,020095060,210096000187,WKEC,908,All Students,168,152,0,2,2,0,0,0,0,0,0,19,7,26,0,0,0,2,4,6,131,155,286,320
20192020,020,CARLISLE,095,Carlisle County,060,Carlisle County Elementary School,095060,020095060,210096000187,WKEC,908,PS,39,53,1,0,1,0,0,0,0,0,0,1,6,7,0,0,0,3,2,5,48,31,79,92
20192020,020,CARLISLE,095,Carlisle County,060,Carlisle County Elementary School,095060,020095060,210096000187,WKEC,908,KG,35,24,0,0,0,0,0,0,0,0,0,4,1,5,0,0,0,0,1,1,20,33,53,59
20192020,020,CARLISLE,095,Carlisle County,060,Carlisle County Elementary School,095060,020095060,210096000187,WKEC,908,01,31,34,0,0,0,0,0,0,0,0,0,5,0,5,0,0,0,0,1,1,29,30,59,65
20192020,020,CARLISLE,095,Carlisle County,060,Carlisle County Elementary School,095060,020095060,210096000187,WKEC,908,02,27,25,0,1,1,0,0,0,0,0,0,1,1,2,0,0,0,0,0,0,24,25,49,52
20192020,020,CARLISLE,095,Carlisle County,060,Carlisle County Elementary School,095060,020095060,210096000187,WKEC,908,03,20,24,0,1,1,0,0,0,0,0,0,2,0,2,0,0,0,0,0,0,22,19,41,44
20192020,020,CARLISLE,095,Carlisle County,060,Carlisle County Elementary School,095060,020095060,210096000187,WKEC,908,05,32,31,0,0,0,0,0,0,0,0,0,6,3,9,0,0,0,2,1,3,23,28,51,63
20192020,021,CARROLL,101,Carroll County,"",---District Total---,101,"","",OVEC,906,All Students,915,968,12,7,19,1,0,1,3,2,5,154,128,282,0,0,0,49,37,86,749,741,1490,1883
20192020,021,CARROLL,101,Carroll County,"",---District Total---,101,"","",OVEC,906,PS,0,0,0,0,0,0,0,0,0,0,0,0,0,0,0,0,0,0,0,0,0,0,0,0
20192020,021,CARROLL,101,Carroll County,"",---District Total---,101,"","",OVEC,906,KG,75,51,1,0,1,0,0,0,0,1,1,7,9,16,0,0,0,4,3,7,39,62,101,126
20192020,021,CARROLL,101,Carroll County,"",---District Total---,101,"","",OVEC,906,01,63,71,0,0,0,0,0,0,0,0,0,16,14,30,0,0,0,2,3,5,53,46,99,134
20192020,021,CARROLL,101,Carroll County,"",---District Total---,101,"","",OVEC,906,02,77,80,0,0,0,0,0,0,0,0,0,17,11,28,0,0,0,3,3,6,60,63,123,157
20192020,021,CARROLL,101,Carroll County,"",---District Total---,101,"","",OVEC,906,03,70,91,1,0,1,0,0,0,0,0,0,14,10,24,0,0,0,4,3,7,72,57,129,161
20192020,021,CARROLL,101,Carroll County,"",---District Total---,101,"","",OVEC,906,04,72,79,1,0,1,0,0,0,0,0,0,12,10,22,0,0,0,3,3,6,63,59,122,151
20192020,021,CARROLL,101,Carroll County,"",---District Total---,101,"","",OVEC,906,05,64,87,1,2,3,0,0,0,0,0,0,16,9,25,0,0,0,4,2,6,66,51,117,151
20192020,021,CARROLL,101,Carroll County,"",---District Total---,101,"","",OVEC,906,06,84,76,1,1,2,0,0,0,1,0,1,16,13,29,0,0,0,3,5,8,55,65,120,160
20192020,021,CARROLL,101,Carroll County,"",---District Total---,101,"","",OVEC,906,07,74,79,0,1,1,0,0,0,0,0,0,8,9,17,0,0,0,5,5,10,66,59,125,153
20192020,021,CARROLL,101,Carroll County,"",---District Total---,101,"","",OVEC,906,08,64,77,0,0,0,0,0,0,0,0,0,11,9,20,0,0,0,5,4,9,61,51,112,141
20192020,021,CARROLL,101,Carroll County,"",---District Total---,101,"","",OVEC,906,09,70,81,3,1,4,1,0,1,0,0,0,11,8,19,0,0,0,2,0,2,64,61,125,151
20192020,021,CARROLL,101,Carroll County,"",---District Total---,101,"","",OVEC,906,10,64,77,1,2,3,0,0,0,1,1,2,14,12,26,0,0,0,8,3,11,53,46,99,141
20192020,021,CARROLL,101,Carroll County,"",---District Total---,101,"","",OVEC,906,11,76,56,0,0,0,0,0,0,0,0,0,6,5,11,0,0,0,2,2,4,48,69,117,132
20192020,021,CARROLL,101,Carroll County,"",---District Total---,101,"","",OVEC,906,12,62,61,3,0,3,0,0,0,1,0,1,6,9,15,0,0,0,3,1,4,48,52,100,123
20192020,021,CARROLL,101,Carroll County,"",---District Total---,101,"","",OVEC,906,14,0,2,0,0,0,0,0,0,0,0,0,0,0,0,0,0,0,1,0,1,1,0,1,2
20192020,021,CARROLL,101,Carroll County,005,Cartmell Elementary,101005,021101005,210099000188,OVEC,906,All Students,219,249,2,0,2,0,0,0,0,0,0,42,31,73,0,0,0,10,9,19,195,179,374,468
20192020,021,CARROLL,101,Carroll County,005,Cartmell Elementary,101005,021101005,210099000188,OVEC,906,02,77,79,0,0,0,0,0,0,0,0,0,16,11,27,0,0,0,3,3,6,60,63,123,156
20192020,021,CARROLL,101,Carroll County,005,Cartmell Elementary,101005,021101005,210099000188,OVEC,906,03,70,91,1,0,1,0,0,0,0,0,0,14,10,24,0,0,0,4,3,7,72,57,129,161
20192020,021,CARROLL,101,Carroll County,005,Cartmell Elementary,101005,021101005,210099000188,OVEC,906,04,72,79,1,0,1,0,0,0,0,0,0,12,10,22,0,0,0,3,3,6,63,59,122,151
20192020,021,CARROLL,101,Carroll County,007,Carroll Co Childhood Development Center,101007,021101007,210099002293,OVEC,906,PS,0,0,0,0,0,0,0,0,0,0,0,0,0,0,0,0,0,0,0,0,0,0,0,0
20192020,021,CARROLL,101,Carroll County,007,Carroll Co Childhood Development Center,101007,021101007,210099002293,OVEC,906,All Students,0,0,0,0,0,0,0,0,0,0,0,0,0,0,0,0,0,0,0,0,0,0,0,0
20192020,021,CARROLL,101,Carroll County,010,Kathryn Winn Primary,101010,021101010,210099000189,OVEC,906,01,63,71,0,0,0,0,0,0,0,0,0,16,14,30,0,0,0,2,3,5,53,46,99,134
20192020,021,CARROLL,101,Carroll County,010,Kathryn Winn Primary,101010,021101010,210099000189,OVEC,906,All Students,138,123,1,0,1,0,0,0,0,1,1,24,23,47,0,0,0,6,6,12,92,108,200,261
20192020,021,CARROLL,101,Carroll County,010,Kathryn Winn Primary,101010,021101010,210099000189,OVEC,906,KG,75,51,1,0,1,0,0,0,0,1,1,7,9,16,0,0,0,4,3,7,39,62,101,126
20192020,021,CARROLL,101,Carroll County,010,Kathryn Winn Primary,101010,021101010,210099000189,OVEC,906,02,0,1,0,0,0,0,0,0,0,0,0,1,0,1,0,0,0,0,0,0,0,0,0,1
20192020,021,CARROLL,101,Carroll County,018,Carroll County High School,101018,021101018,210099000190,OVEC,906,12,62,61,3,0,3,0,0,0,1,0,1,6,9,15,0,0,0,3,1,4,48,52,100,123
20192020,021,CARROLL,101,Carroll County,018,Carroll County High School,101018,021101018,210099000190,OVEC,906,All Students,272,277,7,3,10,1,0,1,2,1,3,37,34,71,0,0,0,16,6,22,214,228,442,549
20192020,021,CARROLL,101,Carroll County,018,Carroll County High School,101018,021101018,210099000190,OVEC,906,09,70,81,3,1,4,1,0,1,0,0,0,11,8,19,0,0,0,2,0,2,64,61,125,151
20192020,021,CARROLL,101,Carroll County,018,Carroll County High School,101018,021101018,210099000190,OVEC,906,10,64,77,1,2,3,0,0,0,1,1,2,14,12,26,0,0,0,8,3,11,53,46,99,141
20192020,021,CARROLL,101,Carroll County,018,Carroll County High School,101018,021101018,210099000190,OVEC,906,11,76,56,0,0,0,0,0,0,0,0,0,6,5,11,0,0,0,2,2,4,48,69,117,132
20192020,021,CARROLL,101,Carroll County,018,Carroll County High School,101018,021101018,210099000190,OVEC,906,14,0,2,0,0,0,0,0,0,0,0,0,0,0,0,0,0,0,1,0,1,1,0,1,2
20192020,021,CARROLL,101,Carroll County,019,Carroll County Middle School,101019,021101019,210099000191,OVEC,906,07,74,79,0,1,1,0,0,0,0,0,0,8,9,17,0,0,0,5,5,10,66,59,125,153
20192020,021,CARROLL,101,Carroll County,019,Carroll County Middle School,101019,021101019,210099000191,OVEC,906,All Students,286,319,2,4,6,0,0,0,1,0,1,51,40,91,0,0,0,17,16,33,248,226,474,605
20192020,021,CARROLL,101,Carroll County,019,Carroll County Middle School,101019,021101019,210099000191,OVEC,906,05,64,87,1,2,3,0,0,0,0,0,0,16,9,25,0,0,0,4,2,6,66,51,117,151
20192020,021,CARROLL,101,Carroll County,019,Carroll County Middle School,101019,021101019,210099000191,OVEC,906,06,84,76,1,1,2,0,0,0,1,0,1,16,13,29,0,0,0,3,5,8,55,65,120,160
20192020,021,CARROLL,101,Carroll County,019,Carroll County Middle School,101019,021101019,210099000191,OVEC,906,08,64,77,0,0,0,0,0,0,0,0,0,11,9,20,0,0,0,5,4,9,61,51,112,141
20192020,022,CARTER,105,Carter County,"",---District Total---,105,"","",KEDC,903,12,147,155,1,0,1,0,0,0,1,0,1,1,3,4,1,0,1,0,1,1,151,143,294,302
20192020,022,CARTER,105,Carter County,"",---District Total---,105,"","",KEDC,903,14,0,1,0,0,0,0,0,0,0,0,0,0,0,0,0,0,0,0,0,0,1,0,1,1
20192020,022,CARTER,105,Carter County,"",---District Total---,105,"","",KEDC,903,PS,86,91,3,0,3,0,0,0,0,1,1,1,0,1,0,0,0,1,2,3,86,83,169,177
20192020,022,CARTER,105,Carter County,"",---District Total---,105,"","",KEDC,903,KG,152,168,2,1,3,0,0,0,0,0,0,6,2,8,0,0,0,2,3,5,158,146,304,320
20192020,022,CARTER,105,Carter County,"",---District Total---,105,"","",KEDC,903,01,165,173,0,0,0,0,1,1,1,0,1,3,9,12,0,0,0,1,1,2,168,154,322,338
20192020,022,CARTER,105,Carter County,"",---District Total---,105,"","",KEDC,903,All Students,1951,2157,9,7,16,2,1,3,4,6,10,44,47,91,1,2,3,11,19,30,2086,1869,3955,4108
20192020,022,CARTER,105,Carter County,"",---District Total---,105,"","",KEDC,903,02,152,162,2,0,2,0,0,0,0,0,0,6,4,10,0,1,1,1,1,2,153,146,299,314
20192020,022,CARTER,105,Carter County,"",---District Total---,105,"","",KEDC,903,03,134,138,0,0,0,0,0,0,1,0,1,4,2,6,0,1,1,1,1,2,132,130,262,272
20192020,022,CARTER,105,Carter County,"",---District Total---,105,"","",KEDC,903,04,151,165,0,0,0,0,0,0,0,0,0,4,3,7,0,0,0,0,3,3,161,145,306,316
20192020,022,CARTER,105,Carter County,"",---District Total---,105,"","",KEDC,903,05,162,157,1,2,3,0,0,0,0,0,0,3,6,9,0,0,0,2,2,4,151,152,303,319
20192020,022,CARTER,105,Carter County,"",---District Total---,105,"","",KEDC,903,06,171,178,0,1,1,0,0,0,0,1,1,2,5,7,0,0,0,0,3,3,176,161,337,349
20192020,022,CARTER,105,Carter County,"",---District Total---,105,"","",KEDC,903,07,182,160,0,2,2,1,0,1,0,2,2,0,8,8,0,0,0,0,2,2,159,168,327,342
20192020,022,CARTER,105,Carter County,"",---District Total---,105,"","",KEDC,903,08,132,182,0,0,0,1,0,1,1,1,2,3,0,3,0,0,0,2,0,2,175,131,306,314
20192020,022,CARTER,105,Carter County,"",---District Total---,105,"","",KEDC,903,09,149,195,2,0,2,0,0,0,0,0,0,4,3,7,0,0,0,2,0,2,187,146,333,344
20192020,022,CARTER,105,Carter County,"",---District Total---,105,"","",KEDC,903,10,123,181,0,1,1,0,0,0,0,0,0,4,0,4,0,0,0,0,2,2,177,120,297,304
20192020,022,CARTER,105,Carter County,"",---District Total---,105,"","",KEDC,903,11,131,142,1,0,1,0,0,0,0,2,2,4,2,6,0,0,0,0,0,0,137,127,264,273
20192020,022,CARTER,105,Carter County,040,Carter Virtual Academy,105040,022105040,210102002294,KEDC,903,12,7,1,0,0,0,0,0,0,0,0,0,0,0,0,0,0,0,0,0,0,1,7,8,8
20192020,022,CARTER,105,Carter County,040,Carter Virtual Academy,105040,022105040,210102002294,KEDC,903,09,1,0,0,0,0,0,0,0,0,0,0,0,0,0,0,0,0,0,0,0,0,1,1,1
20192020,022,CARTER,105,Carter County,040,Carter Virtual Academy,105040,022105040,210102002294,KEDC,903,11,0,2,0,0,0,0,0,0,0,0,0,0,0,0,0,0,0,0,0,0,2,0,2,2
20192020,022,CARTER,105,Carter County,040,Carter Virtual Academy,105040,022105040,210102002294,KEDC,903,All Students,8,3,0,0,0,0,0,0,0,0,0,0,0,0,0,0,0,0,0,0,3,8,11,11
20192020,022,CARTER,105,Carter County,052,Heritage Elementary School,105052,022105052,210102001884,KEDC,903,01,27,32,0,0,0,0,0,0,0,0,0,0,2,2,0,0,0,0,1,1,32,24,56,59
20192020,022,CARTER,105,Carter County,052,Heritage Elementary School,105052,022105052,210102001884,KEDC,903,All Students,155,165,0,0,0,0,0,0,0,0,0,0,4,4,0,0,0,2,4,6,163,147,310,320
20192020,022,CARTER,105,Carter County,052,Heritage Elementary School,105052,022105052,210102001884,KEDC,903,PS,14,27,1,0,1,0,0,0,0,0,0,0,0,0,0,0,0,0,0,0,26,14,40,41
20192020,022,CARTER,105,Carter County,052,Heritage Elementary School,105052,022105052,210102001884,KEDC,903,KG,32,26,0,0,0,0,0,0,0,0,0,0,0,0,0,0,0,1,1,2,25,31,56,58
20192020,022,CARTER,105,Carter County,052,Heritage Elementary School,105052,022105052,210102001884,KEDC,903,02,22,23,0,0,0,0,0,0,0,0,0,0,1,1,0,0,0,1,1,2,22,20,42,45
20192020,022,CARTER,105,Carter County,052,Heritage Elementary School,105052,022105052,210102001884,KEDC,903,03,18,23,0,0,0,0,0,0,0,0,0,0,0,0,0,0,0,0,0,0,23,18,41,41
20192020,022,CARTER,105,Carter County,052,Heritage Elementary School,105052,022105052,210102001884,KEDC,903,04,25,31,0,0,0,0,0,0,0,0,0,0,0,0,0,0,0,0,1,1,31,24,55,56
20192020,022,CARTER,105,Carter County,052,Heritage Elementary School,105052,022105052,210102001884,KEDC,903,05,31,30,0,0,0,0,0,0,0,0,0,0,1,1,0,0,0,0,0,0,30,30,60,61
20192020,022,CARTER,105,Carter County,053,Tygart Creek Elementary School,105053,022105053,210102002340,KEDC,903,05,30,21,0,1,1,0,0,0,0,0,0,0,1,1,0,0,0,1,0,1,20,28,48,51
20192020,022,CARTER,105,Carter County,053,Tygart Creek Elementary School,105053,022105053,210102002340,KEDC,903,All Students,168,155,2,1,3,0,1,1,0,0,0,4,2,6,0,0,0,1,1,2,148,163,311,323
20192020,022,CARTER,105,Carter County,053,Tygart Creek Elementary School,105053,022105053,210102002340,KEDC,903,PS,10,9,0,0,0,0,0,0,0,0,0,0,0,0,0,0,0,0,2,2,9,8,17,19
20192020,022,CARTER,105,Carter County,053,Tygart Creek Elementary School,105053,022105053,210102002340,KEDC,903,KG,23,28,1,0,1,0,0,0,0,0,0,1,0,1,0,0,0,0,0,0,26,23,49,51
20192020,022,CARTER,105,Carter County,053,Tygart Creek Elementary School,105053,022105053,210102002340,KEDC,903,01,24,23,0,0,0,0,1,1,0,0,0,0,0,0,0,0,0,0,0,0,23,23,46,47
20192020,022,CARTER,105,Carter County,053,Tygart Creek Elementary School,105053,022105053,210102002340,KEDC,903,02,30,31,1,0,1,0,0,0,0,0,0,1,1,2,0,0,0,0,0,0,29,29,58,61
20192020,022,CARTER,105,Carter County,053,Tygart Creek Elementary School,105053,022105053,210102002340,KEDC,903,03,23,22,0,0,0,0,0,0,0,0,0,1,0,1,0,0,0,0,0,0,21,23,44,45
20192020,022,CARTER,105,Carter County,053,Tygart Creek Elementary School,105053,022105053,210102002340,KEDC,903,04,38,30,0,0,0,0,0,0,0,0,0,1,0,1,0,0,0,0,1,1,29,37,66,68
20192020,022,CARTER,105,Carter County,060,Carter City Elementary School,105060,022105060,210102002356,KEDC,903,04,6,8,0,0,0,0,0,0,0,0,0,0,1,1,0,0,0,0,0,0,8,5,13,14
20192020,022,CARTER,105,Carter County,060,Carter City Elementary School,105060,022105060,210102002356,KEDC,903,All Students,49,65,0,0,0,0,0,0,0,0,0,1,2,3,0,0,0,0,0,0,64,47,111,114
20192020,022,CARTER,105,Carter County,060,Carter City Elementary School,105060,022105060,210102002356,KEDC,903,PS,9,3,0,0,0,0,0,0,0,0,0,0,0,0,0,0,0,0,0,0,3,9,12,12
20192020,022,CARTER,105,Carter County,060,Carter City Elementary School,105060,022105060,210102002356,KEDC,903,KG,10,12,0,0,0,0,0,0,0,0,0,0,0,0,0,0,0,0,0,0,12,10,22,22
20192020,022,CARTER,105,Carter County,060,Carter City Elementary School,105060,022105060,210102002356,KEDC,903,01,11,15,0,0,0,0,0,0,0,0,0,1,0,1,0,0,0,0,0,0,14,11,25,26
20192020,022,CARTER,105,Carter County,060,Carter City Elementary School,105060,022105060,210102002356,KEDC,903,02,10,8,0,0,0,0,0,0,0,0,0,0,1,1,0,0,0,0,0,0,8,9,17,18
20192020,022,CARTER,105,Carter County,060,Carter City Elementary School,105060,022105060,210102002356,KEDC,903,03,7,10,0,0,0,0,0,0,0,0,0,0,0,0,0,0,0,0,0,0,10,7,17,17
20192020,022,CARTER,105,Carter County,060,Carter City Elementary School,105060,022105060,210102002356,KEDC,903,05,5,12,0,0,0,0,0,0,0,0,0,0,0,0,0,0,0,0,0,0,12,5,17,17
20192020,022,CARTER,105,Carter County,120,East Carter County High School,105120,022105120,210102000194,KEDC,903,11,77,76,0,0,0,0,0,0,0,2,2,4,1,5,0,0,0,0,0,0,72,74,146,153
20192020,022,CARTER,105,Carter County,120,East Carter County High School,105120,022105120,210102000194,KEDC,903,All Students,324,372,1,1,2,0,0,0,1,2,3,11,7,18,1,0,1,2,2,4,356,312,668,696
20192020,022,CARTER,105,Carter County,120,East Carter County High School,105120,022105120,210102000194,KEDC,903,09,89,112,0,0,0,0,0,0,0,0,0,4,3,7,0,0,0,2,0,2,106,86,192,201
20192020,022,CARTER,105,Carter County,120,East Carter County High School,105120,022105120,210102000194,KEDC,903,10,71,101,0,1,1,0,0,0,0,0,0,3,0,3,0,0,0,0,1,1,98,69,167,172
20192020,022,CARTER,105,Carter County,120,East Carter County High School,105120,022105120,210102000194,KEDC,903,12,87,83,1,0,1,0,0,0,1,0,1,0,3,3,1,0,1,0,1,1,80,83,163,170
20192020,022,CARTER,105,Carter County,130,East Carter Middle School,105130,022105130,210102001698,KEDC,903,08,71,104,0,0,0,0,0,0,1,1,2,3,0,3,0,0,0,2,0,2,98,70,168,175
20192020,022,CARTER,105,Carter County,130,East Carter Middle School,105130,022105130,210102001698,KEDC,903,All Students,278,287,0,0,0,0,0,0,1,4,5,4,11,15,0,0,0,2,2,4,280,261,541,565
20192020,022,CARTER,105,Carter County,130,East Carter Middle School,105130,022105130,210102001698,KEDC,903,06,99,95,0,0,0,0,0,0,0,1,1,1,4,5,0,0,0,0,1,1,94,93,187,194
20192020,022,CARTER,105,Carter County,130,East Carter Middle School,105130,022105130,210102001698,KEDC,903,07,108,88,0,0,0,0,0,0,0,2,2,0,7,7,0,0,0,0,1,1,88,98,186,196
20192020,022,CARTER,105,Carter County,250,Olive Hill Elementary School,105250,022105250,210102000198,KEDC,903,01,41,32,0,0,0,0,0,0,0,0,0,0,4,4,0,0,0,0,0,0,32,37,69,73
20192020,022,CARTER,105,Carter County,250,Olive Hill Elementary School,105250,022105250,210102000198,KEDC,903,02,33,32,1,0,1,0,0,0,0,0,0,0,0,0,0,0,0,0,0,0,31,33,64,65
20192020,022,CARTER,105,Carter County,250,Olive Hill Elementary School,105250,022105250,210102000198,KEDC,903,03,35,25,0,0,0,0,0,0,0,0,0,1,1,2,0,0,0,0,1,1,24,33,57,60
20192020,022,CARTER,105,Carter County,250,Olive Hill Elementary School,105250,022105250,210102000198,KEDC,903,05,32,32,0,1,1,0,0,0,0,0,0,1,0,1,0,0,0,1,0,1,30,31,61,64
20192020,022,CARTER,105,Carter County,250,Olive Hill Elementary School,105250,022105250,210102000198,KEDC,903,04,30,26,0,0,0,0,0,0,0,0,0,0,0,0,0,0,0,0,0,0,26,30,56,56
20192020,022,CARTER,105,Carter County,250,Olive Hill Elementary School,105250,022105250,210102000198,KEDC,903,All Students,207,183,1,1,2,0,0,0,0,0,0,2,5,7,0,0,0,1,2,3,179,199,378,390
20192020,022,CARTER,105,Carter County,250,Olive Hill Elementary School,105250,022105250,210102000198,KEDC,903,PS,13,17,1,0,1,0,0,0,0,0,0,1,0,1,0,0,0,0,0,0,15,13,28,30
20192020,022,CARTER,105,Carter County,250,Olive Hill Elementary School,105250,022105250,210102000198,KEDC,903,KG,36,36,0,0,0,0,0,0,0,0,0,0,0,0,0,0,0,0,1,1,36,35,71,72
20192020,022,CARTER,105,Carter County,340,Prichard Elementary School,105340,022105340,210102000199,KEDC,903,05,55,50,0,0,0,0,0,0,0,0,0,2,4,6,0,0,0,0,1,1,48,50,98,105
20192020,022,CARTER,105,Carter County,340,Prichard Elementary School,105340,022105340,210102000199,KEDC,903,All Students,283,330,0,0,0,0,0,0,2,0,2,17,13,30,0,2,2,2,3,5,309,265,574,613
20192020,022,CARTER,105,Carter County,340,Prichard Elementary School,105340,022105340,210102000199,KEDC,903,PS,32,27,0,0,0,0,0,0,0,1,1,0,0,0,0,0,0,1,0,1,26,31,57,59
20192020,022,CARTER,105,Carter County,340,Prichard Elementary School,105340,022105340,210102000199,KEDC,903,KG,40,56,0,0,0,0,0,0,0,0,0,4,2,6,0,0,0,1,1,2,51,37,88,96
20192020,022,CARTER,105,Carter County,340,Prichard Elementary School,105340,022105340,210102000199,KEDC,903,01,56,56,0,0,0,0,0,0,1,0,1,2,3,5,0,0,0,0,0,0,53,53,106,112
20192020,022,CARTER,105,Carter County,340,Prichard Elementary School,105340,022105340,210102000199,KEDC,903,02,44,56,0,0,0,0,0,0,0,0,0,4,1,5,0,1,1,0,0,0,52,42,94,100
20192020,022,CARTER,105,Carter County,340,Prichard Elementary School,105340,022105340,210102000199,KEDC,903,03,43,48,0,0,0,0,0,0,1,0,1,2,1,3,0,1,1,1,0,1,44,41,85,91
20192020,022,CARTER,105,Carter County,340,Prichard Elementary School,105340,022105340,210102000199,KEDC,903,04,45,64,0,0,0,0,0,0,0,0,0,3,2,5,0,0,0,0,1,1,61,42,103,109
20192020,022,CARTER,105,Carter County,450,Star Elementary School,105450,022105450,210102000200,KEDC,903,KG,11,10,1,1,2,0,0,0,0,0,0,1,0,1,0,0,0,0,0,0,8,10,18,21
20192020,022,CARTER,105,Carter County,450,Star Elementary School,105450,022105450,210102000200,KEDC,903,All Students,54,65,2,1,3,0,0,0,0,0,0,2,0,2,0,0,0,1,1,2,60,52,112,119
20192020,022,CARTER,105,Carter County,450,Star Elementary School,105450,022105450,210102000200,KEDC,903,PS,8,8,1,0,1,0,0,0,0,0,0,0,0,0,0,0,0,0,0,0,7,8,15,16
20192020,022,CARTER,105,Carter County,450,Star Elementary School,105450,022105450,210102000200,KEDC,903,01,6,15,0,0,0,0,0,0,0,0,0,0,0,0,0,0,0,1,0,1,14,6,20,21
20192020,022,CARTER,105,Carter County,450,Star Elementary School,105450,022105450,210102000200,KEDC,903,02,13,12,0,0,0,0,0,0,0,0,0,1,0,1,0,0,0,0,0,0,11,13,24,25
20192020,022,CARTER,105,Carter County,450,Star Elementary School,105450,022105450,210102000200,KEDC,903,03,8,10,0,0,0,0,0,0,0,0,0,0,0,0,0,0,0,0,0,0,10,8,18,18
20192020,022,CARTER,105,Carter County,450,Star Elementary School,105450,022105450,210102000200,KEDC,903,04,7,6,0,0,0,0,0,0,0,0,0,0,0,0,0,0,0,0,0,0,6,7,13,13
20192020,022,CARTER,105,Carter County,450,Star Elementary School,105450,022105450,210102000200,KEDC,903,05,9,12,1,0,1,0,0,0,0,0,0,0,0,0,0,0,0,0,1,1,11,8,19,21
20192020,022,CARTER,105,Carter County,500,West Carter County High School,105500,022105500,210102000202,KEDC,903,14,0,1,0,0,0,0,0,0,0,0,0,0,0,0,0,0,0,0,0,0,1,0,1,1
20192020,022,CARTER,105,Carter County,500,West Carter County High School,105500,022105500,210102000202,KEDC,903,All Students,218,299,3,0,3,0,0,0,0,0,0,2,1,3,0,0,0,0,1,1,294,216,510,517
20192020,022,CARTER,105,Carter County,500,West Carter County High School,105500,022105500,210102000202,KEDC,903,09,59,83,2,0,2,0,0,0,0,0,0,0,0,0,0,0,0,0,0,0,81,59,140,142
20192020,022,CARTER,105,Carter County,500,West Carter County High School,105500,022105500,210102000202,KEDC,903,10,52,80,0,0,0,0,0,0,0,0,0,1,0,1,0,0,0,0,1,1,79,51,130,132
20192020,022,CARTER,105,Carter County,500,West Carter County High School,105500,022105500,210102000202,KEDC,903,11,54,64,1,0,1,0,0,0,0,0,0,0,1,1,0,0,0,0,0,0,63,53,116,118
20192020,022,CARTER,105,Carter County,500,West Carter County High School,105500,022105500,210102000202,KEDC,903,12,53,71,0,0,0,0,0,0,0,0,0,1,0,1,0,0,0,0,0,0,70,53,123,124
20192020,022,CARTER,105,Carter County,505,West Carter Middle School,105505,022105505,210102001661,KEDC,903,07,74,72,0,2,2,1,0,1,0,0,0,0,1,1,0,0,0,0,1,1,71,70,141,146
20192020,022,CARTER,105,Carter County,505,West Carter Middle School,105505,022105505,210102001661,KEDC,903,All Students,207,233,0,3,3,2,0,2,0,0,0,1,2,3,0,0,0,0,3,3,230,199,429,440
20192020,022,CARTER,105,Carter County,505,West Carter Middle School,105505,022105505,210102001661,KEDC,903,06,72,83,0,1,1,0,0,0,0,0,0,1,1,2,0,0,0,0,2,2,82,68,150,155
20192020,022,CARTER,105,Carter County,505,West Carter Middle School,105505,022105505,210102001661,KEDC,903,08,61,78,0,0,0,1,0,1,0,0,0,0,0,0,0,0,0,0,0,0,77,61,138,139
20192020,022,CARTER,105,Carter County,905,Carter County Career and Technical Center,105905,022105905,210102001439,KEDC,903,11,0,0,0,0,0,0,0,0,0,0,0,0,0,0,0,0,0,0,0,0,0,0,0,0
20192020,022,CARTER,105,Carter County,905,Carter County Career and Technical Center,105905,022105905,210102001439,KEDC,903,All Students,0,0,0,0,0,0,0,0,0,0,0,0,0,0,0,0,0,0,0,0,0,0,0,0
20192020,022,CARTER,105,Carter County,905,Carter County Career and Technical Center,105905,022105905,210102001439,KEDC,903,09,0,0,0,0,0,0,0,0,0,0,0,0,0,0,0,0,0,0,0,0,0,0,0,0
20192020,022,CARTER,105,Carter County,905,Carter County Career and Technical Center,105905,022105905,210102001439,KEDC,903,10,0,0,0,0,0,0,0,0,0,0,0,0,0,0,0,0,0,0,0,0,0,0,0,0
20192020,022,CARTER,105,Carter County,905,Carter County Career and Technical Center,105905,022105905,210102001439,KEDC,903,12,0,0,0,0,0,0,0,0,0,0,0,0,0,0,0,0,0,0,0,0,0,0,0,0
20192020,023,CASEY,111,Casey County,"",---District Total---,111,"","",SESC,907,11,88,74,0,0,0,0,0,0,0,1,1,5,4,9,0,1,1,3,2,5,66,80,146,162
20192020,023,CASEY,111,Casey County,"",---District Total---,111,"","",SESC,907,All Students,1101,1169,4,4,8,2,0,2,5,6,11,79,83,162,2,2,4,31,26,57,1046,980,2026,2270
20192020,023,CASEY,111,Casey County,"",---District Total---,111,"","",SESC,907,PS,31,59,0,0,0,0,0,0,0,0,0,2,3,5,0,0,0,1,0,1,56,28,84,90
20192020,023,CASEY,111,Casey County,"",---District Total---,111,"","",SESC,907,KG,80,94,0,1,1,0,0,0,0,0,0,8,5,13,0,0,0,2,3,5,84,71,155,174
20192020,023,CASEY,111,Casey County,"",---District Total---,111,"","",SESC,907,01,99,133,0,0,0,0,0,0,0,1,1,13,7,20,0,0,0,4,4,8,116,87,203,232
20192020,023,CASEY,111,Casey County,"",---District Total---,111,"","",SESC,907,02,82,92,1,0,1,0,0,0,0,0,0,7,9,16,1,0,1,4,2,6,79,71,150,174
20192020,023,CASEY,111,Casey County,"",---District Total---,111,"","",SESC,907,03,80,81,2,1,3,0,0,0,0,0,0,7,7,14,0,0,0,2,3,5,70,69,139,161
20192020,023,CASEY,111,Casey County,"",---District Total---,111,"","",SESC,907,04,106,76,0,0,0,1,0,1,0,0,0,3,8,11,0,0,0,2,1,3,70,97,167,182
20192020,023,CASEY,111,Casey County,"",---District Total---,111,"","",SESC,907,05,97,98,0,1,1,0,0,0,0,0,0,9,6,15,0,1,1,2,3,5,87,86,173,195
20192020,023,CASEY,111,Casey County,"",---District Total---,111,"","",SESC,907,06,79,88,1,0,1,0,0,0,3,0,3,5,11,16,1,0,1,2,1,3,76,67,143,167
20192020,023,CASEY,111,Casey County,"",---District Total---,111,"","",SESC,907,07,96,88,0,0,0,1,0,1,1,0,1,6,9,15,0,0,0,2,4,6,78,83,161,184
20192020,023,CASEY,111,Casey County,"",---District Total---,111,"","",SESC,907,08,83,95,0,1,1,0,0,0,0,1,1,6,6,12,0,0,0,2,1,3,87,74,161,178
20192020,023,CASEY,111,Casey County,"",---District Total---,111,"","",SESC,907,09,67,87,0,0,0,0,0,0,0,3,3,3,5,8,0,0,0,2,1,3,82,58,140,154
20192020,023,CASEY,111,Casey County,"",---District Total---,111,"","",SESC,907,10,77,86,0,0,0,0,0,0,0,0,0,4,4,8,0,0,0,1,0,1,81,73,154,163
20192020,023,CASEY,111,Casey County,"",---District Total---,111,"","",SESC,907,12,67,77,0,0,0,0,0,0,1,0,1,3,2,5,0,0,0,3,1,4,70,64,134,144
20192020,023,CASEY,111,Casey County,015,Walnut Hill Elementary School,111015,023111015,210105002211,SESC,907,04,40,33,0,0,0,1,0,1,0,0,0,1,5,6,0,0,0,0,0,0,31,35,66,73
20192020,023,CASEY,111,Casey County,015,Walnut Hill Elementary School,111015,023111015,210105002211,SESC,907,All Students,222,265,4,1,5,1,0,1,0,0,0,20,20,40,0,0,0,6,4,10,234,197,431,487
20192020,023,CASEY,111,Casey County,015,Walnut Hill Elementary School,111015,023111015,210105002211,SESC,907,PS,3,17,0,0,0,0,0,0,0,0,0,0,0,0,0,0,0,0,0,0,17,3,20,20
20192020,023,CASEY,111,Casey County,015,Walnut Hill Elementary School,111015,023111015,210105002211,SESC,907,KG,30,38,0,0,0,0,0,0,0,0,0,5,2,7,0,0,0,0,0,0,33,28,61,68
20192020,023,CASEY,111,Casey County,015,Walnut Hill Elementary School,111015,023111015,210105002211,SESC,907,06,29,31,1,0,1,0,0,0,0,0,0,1,2,3,0,0,0,1,0,1,28,27,55,60
20192020,023,CASEY,111,Casey County,015,Walnut Hill Elementary School,111015,023111015,210105002211,SESC,907,01,30,42,0,0,0,0,0,0,0,0,0,3,4,7,0,0,0,1,1,2,38,25,63,72
20192020,023,CASEY,111,Casey County,015,Walnut Hill Elementary School,111015,023111015,210105002211,SESC,907,02,33,40,1,0,1,0,0,0,0,0,0,5,3,8,0,0,0,2,0,2,32,30,62,73
20192020,023,CASEY,111,Casey County,015,Walnut Hill Elementary School,111015,023111015,210105002211,SESC,907,03,25,40,2,1,3,0,0,0,0,0,0,4,1,5,0,0,0,2,2,4,32,21,53,65
20192020,023,CASEY,111,Casey County,015,Walnut Hill Elementary School,111015,023111015,210105002211,SESC,907,05,35,41,0,0,0,0,0,0,0,0,0,1,3,4,0,0,0,0,1,1,40,31,71,76
20192020,023,CASEY,111,Casey County,026,Jones Park Elementary,111026,023111026,210105001981,SESC,907,01,29,40,0,0,0,0,0,0,0,0,0,3,0,3,0,0,0,1,2,3,36,27,63,69
20192020,023,CASEY,111,Casey County,026,Jones Park Elementary,111026,023111026,210105001981,SESC,907,All Students,171,186,0,1,1,0,0,0,1,0,1,8,4,12,0,0,0,6,7,13,171,159,330,357
20192020,023,CASEY,111,Casey County,026,Jones Park Elementary,111026,023111026,210105001981,SESC,907,PS,19,31,0,0,0,0,0,0,0,0,0,2,2,4,0,0,0,1,0,1,28,17,45,50
20192020,023,CASEY,111,Casey County,026,Jones Park Elementary,111026,023111026,210105001981,SESC,907,KG,24,27,0,0,0,0,0,0,0,0,0,0,0,0,0,0,0,1,1,2,26,23,49,51
20192020,023,CASEY,111,Casey County,026,Jones Park Elementary,111026,023111026,210105001981,SESC,907,02,15,22,0,0,0,0,0,0,0,0,0,0,0,0,0,0,0,1,0,1,21,15,36,37
20192020,023,CASEY,111,Casey County,026,Jones Park Elementary,111026,023111026,210105001981,SESC,907,03,23,20,0,0,0,0,0,0,0,0,0,0,0,0,0,0,0,0,0,0,20,23,43,43
20192020,023,CASEY,111,Casey County,026,Jones Park Elementary,111026,023111026,210105001981,SESC,907,04,34,19,0,0,0,0,0,0,0,0,0,1,2,3,0,0,0,2,1,3,16,31,47,53
20192020,023,CASEY,111,Casey County,026,Jones Park Elementary,111026,023111026,210105001981,SESC,907,05,29,29,0,1,1,0,0,0,0,0,0,3,1,4,0,0,0,1,2,3,25,25,50,58
20192020,023,CASEY,111,Casey County,026,Jones Park Elementary,111026,023111026,210105001981,SESC,907,06,17,29,0,0,0,0,0,0,1,0,1,1,1,2,0,0,0,0,1,1,27,15,42,46
20192020,023,CASEY,111,Casey County,045,Casey County High School,111045,023111045,210105000204,SESC,907,All Students,299,324,0,0,0,0,0,0,1,4,5,15,15,30,0,1,1,9,4,13,299,275,574,623
20192020,023,CASEY,111,Casey County,045,Casey County High School,111045,023111045,210105000204,SESC,907,09,67,87,0,0,0,0,0,0,0,3,3,3,5,8,0,0,0,2,1,3,82,58,140,154
20192020,023,CASEY,111,Casey County,045,Casey County High School,111045,023111045,210105000204,SESC,907,10,77,86,0,0,0,0,0,0,0,0,0,4,4,8,0,0,0,1,0,1,81,73,154,163
20192020,023,CASEY,111,Casey County,045,Casey County High School,111045,023111045,210105000204,SESC,907,11,88,74,0,0,0,0,0,0,0,1,1,5,4,9,0,1,1,3,2,5,66,80,146,162
20192020,023,CASEY,111,Casey County,045,Casey County High School,111045,023111045,210105000204,SESC,907,12,67,77,0,0,0,0,0,0,1,0,1,3,2,5,0,0,0,3,1,4,70,64,134,144
20192020,023,CASEY,111,Casey County,070,Casey County Middle School,111070,023111070,210105001579,SESC,907,All Students,179,183,0,1,1,1,0,1,1,1,2,12,15,27,0,0,0,4,5,9,165,157,322,362
20192020,023,CASEY,111,Casey County,070,Casey County Middle School,111070,023111070,210105001579,SESC,907,07,96,88,0,0,0,1,0,1,1,0,1,6,9,15,0,0,0,2,4,6,78,83,161,184
20192020,023,CASEY,111,Casey County,070,Casey County Middle School,111070,023111070,210105001579,SESC,907,08,83,95,0,1,1,0,0,0,0,1,1,6,6,12,0,0,0,2,1,3,87,74,161,178
20192020,023,CASEY,111,Casey County,190,Liberty Elementary School,111190,023111190,210105000208,SESC,907,06,33,28,0,0,0,0,0,0,2,0,2,3,8,11,1,0,1,1,0,1,21,25,46,61
20192020,023,CASEY,111,Casey County,190,Liberty Elementary School,111190,023111190,210105000208,SESC,907,05,33,28,0,0,0,0,0,0,0,0,0,5,2,7,0,1,1,1,0,1,22,30,52,61
20192020,023,CASEY,111,Casey County,190,Liberty Elementary School,111190,023111190,210105000208,SESC,907,All Students,230,211,0,1,1,0,0,0,2,1,3,24,29,53,2,1,3,6,6,12,177,192,369,441
20192020,023,CASEY,111,Casey County,190,Liberty Elementary School,111190,023111190,210105000208,SESC,907,PS,9,11,0,0,0,0,0,0,0,0,0,0,1,1,0,0,0,0,0,0,11,8,19,20
20192020,023,CASEY,111,Casey County,190,Liberty Elementary School,111190,023111190,210105000208,SESC,907,KG,26,29,0,1,1,0,0,0,0,0,0,3,3,6,0,0,0,1,2,3,25,20,45,55
20192020,023,CASEY,111,Casey County,190,Liberty Elementary School,111190,023111190,210105000208,SESC,907,01,40,51,0,0,0,0,0,0,0,1,1,7,3,10,0,0,0,2,1,3,42,35,77,91
20192020,023,CASEY,111,Casey County,190,Liberty Elementary School,111190,023111190,210105000208,SESC,907,02,34,30,0,0,0,0,0,0,0,0,0,2,6,8,1,0,1,1,2,3,26,26,52,64
20192020,023,CASEY,111,Casey County,190,Liberty Elementary School,111190,023111190,210105000208,SESC,907,03,32,21,0,0,0,0,0,0,0,0,0,3,6,9,0,0,0,0,1,1,18,25,43,53
20192020,023,CASEY,111,Casey County,190,Liberty Elementary School,111190,023111190,210105000208,SESC,907,04,32,24,0,0,0,0,0,0,0,0,0,1,1,2,0,0,0,0,0,0,23,31,54,56
20192020,005,BARREN,113,Caverna Independent,"",---District Total---,113,"","",GRREC,902,05,28,31,0,5,5,0,0,0,0,0,0,6,1,7,0,0,0,6,3,9,19,19,38,59
20192020,005,BARREN,113,Caverna Independent,"",---District Total---,113,"","",GRREC,902,All Students,301,344,33,39,72,1,0,1,1,0,1,23,19,42,0,0,0,39,36,75,247,207,454,645
20192020,005,BARREN,113,Caverna Independent,"",---District Total---,113,"","",GRREC,902,PS,26,29,1,6,7,0,0,0,0,0,0,0,2,2,0,0,0,2,2,4,26,16,42,55
20192020,005,BARREN,113,Caverna Independent,"",---District Total---,113,"","",GRREC,902,KG,32,28,0,4,4,0,0,0,0,0,0,1,1,2,0,0,0,4,4,8,23,23,46,60
20192020,005,BARREN,113,Caverna Independent,"",---District Total---,113,"","",GRREC,902,01,23,23,1,2,3,0,0,0,0,0,0,3,2,5,0,0,0,3,2,5,16,17,33,46
20192020,005,BARREN,113,Caverna Independent,"",---District Total---,113,"","",GRREC,902,02,17,27,2,3,5,0,0,0,0,0,0,3,2,5,0,0,0,0,1,1,22,11,33,44
20192020,005,BARREN,113,Caverna Independent,"",---District Total---,113,"","",GRREC,902,03,13,20,2,0,2,0,0,0,0,0,0,2,1,3,0,0,0,3,1,4,13,11,24,33
20192020,005,BARREN,113,Caverna Independent,"",---District Total---,113,"","",GRREC,902,04,22,22,1,3,4,0,0,0,0,0,0,1,3,4,0,0,0,4,3,7,16,13,29,44
20192020,005,BARREN,113,Caverna Independent,"",---District Total---,113,"","",GRREC,902,06,27,31,8,4,12,0,0,0,0,0,0,2,2,4,0,0,0,5,1,6,16,20,36,58
20192020,005,BARREN,113,Caverna Independent,"",---District Total---,113,"","",GRREC,902,07,30,33,3,4,7,1,0,1,0,0,0,2,3,5,0,0,0,3,6,9,24,17,41,63
20192020,005,BARREN,113,Caverna Independent,"",---District Total---,113,"","",GRREC,902,08,22,28,4,3,7,0,0,0,0,0,0,1,0,1,0,0,0,1,3,4,22,16,38,50
20192020,005,BARREN,113,Caverna Independent,"",---District Total---,113,"","",GRREC,902,09,25,24,3,4,7,0,0,0,0,0,0,1,1,2,0,0,0,3,2,5,17,18,35,49
20192020,005,BARREN,113,Caverna Independent,"",---District Total---,113,"","",GRREC,902,10,22,25,2,3,5,0,0,0,0,0,0,0,1,1,0,0,0,2,3,5,21,15,36,47
20192020,005,BARREN,113,Caverna Independent,"",---District Total---,113,"","",GRREC,902,11,14,23,3,2,5,0,0,0,1,0,1,1,0,1,0,0,0,2,1,3,16,11,27,37
20192020,005,BARREN,113,Caverna Independent,"",---District Total---,113,"","",GRREC,902,12,26,28,4,2,6,0,0,0,0,0,0,0,2,2,0,0,0,3,6,9,21,16,37,54
20192020,005,BARREN,113,Caverna Independent,"",---District Total---,113,"","",GRREC,902,14,0,1,0,0,0,0,0,0,0,0,0,0,0,0,0,0,0,0,0,0,1,0,1,1
20192020,005,BARREN,113,Caverna Independent,025,Caverna Elementary School,113025,005113025,210111000213,GRREC,902,05,28,31,0,5,5,0,0,0,0,0,0,6,1,7,0,0,0,6,3,9,19,19,38,59
20192020,005,BARREN,113,Caverna Independent,025,Caverna Elementary School,113025,005113025,210111000213,GRREC,902,04,22,22,1,3,4,0,0,0,0,0,0,1,3,4,0,0,0,4,3,7,16,13,29,44
20192020,005,BARREN,113,Caverna Independent,025,Caverna Elementary School,113025,005113025,210111000213,GRREC,902,All Students,135,151,6,17,23,0,0,0,0,0,0,16,10,26,0,0,0,20,14,34,109,94,203,286
20192020,005,BARREN,113,Caverna Independent,025,Caverna Elementary School,113025,005113025,210111000213,GRREC,902,PS,26,29,1,6,7,0,0,0,0,0,0,0,2,2,0,0,0,2,2,4,26,16,42,55
20192020,005,BARREN,113,Caverna Independent,025,Caverna Elementary School,113025,005113025,210111000213,GRREC,902,KG,32,28,0,4,4,0,0,0,0,0,0,1,1,2,0,0,0,4,4,8,23,23,46,60
20192020,005,BARREN,113,Caverna Independent,025,Caverna Elementary School,113025,005113025,210111000213,GRREC,902,01,23,23,1,2,3,0,0,0,0,0,0,3,2,5,0,0,0,3,2,5,16,17,33,46
20192020,005,BARREN,113,Caverna Independent,025,Caverna Elementary School,113025,005113025,210111000213,GRREC,902,02,17,27,2,3,5,0,0,0,0,0,0,3,2,5,0,0,0,0,1,1,22,11,33,44
20192020,005,BARREN,113,Caverna Independent,025,Caverna Elementary School,113025,005113025,210111000213,GRREC,902,03,13,20,2,0,2,0,0,0,0,0,0,2,1,3,0,0,0,3,1,4,13,11,24,33
20192020,005,BARREN,113,Caverna Independent,026,Caverna Middle School,113026,005113026,210111001914,GRREC,902,06,27,31,8,4,12,0,0,0,0,0,0,2,2,4,0,0,0,5,1,6,16,20,36,58
20192020,005,BARREN,113,Caverna Independent,026,Caverna Middle School,113026,005113026,210111001914,GRREC,902,All Students,79,92,15,11,26,1,0,1,0,0,0,5,5,10,0,0,0,9,10,19,62,53,115,171
20192020,005,BARREN,113,Caverna Independent,026,Caverna Middle School,113026,005113026,210111001914,GRREC,902,07,30,33,3,4,7,1,0,1,0,0,0,2,3,5,0,0,0,3,6,9,24,17,41,63
20192020,005,BARREN,113,Caverna Independent,026,Caverna Middle School,113026,005113026,210111001914,GRREC,902,08,22,28,4,3,7,0,0,0,0,0,0,1,0,1,0,0,0,1,3,4,22,16,38,50
20192020,005,BARREN,113,Caverna Independent,030,Caverna High School,113030,005113030,210111000214,GRREC,902,14,0,1,0,0,0,0,0,0,0,0,0,0,0,0,0,0,0,0,0,0,1,0,1,1
20192020,005,BARREN,113,Caverna Independent,030,Caverna High School,113030,005113030,210111000214,GRREC,902,All Students,87,101,12,11,23,0,0,0,1,0,1,2,4,6,0,0,0,10,12,22,76,60,136,188
20192020,005,BARREN,113,Caverna Independent,030,Caverna High School,113030,005113030,210111000214,GRREC,902,09,25,24,3,4,7,0,0,0,0,0,0,1,1,2,0,0,0,3,2,5,17,18,35,49
20192020,005,BARREN,113,Caverna Independent,030,Caverna High School,113030,005113030,210111000214,GRREC,902,10,22,25,2,3,5,0,0,0,0,0,0,0,1,1,0,0,0,2,3,5,21,15,36,47
20192020,005,BARREN,113,Caverna Independent,030,Caverna High School,113030,005113030,210111000214,GRREC,902,11,14,23,3,2,5,0,0,0,1,0,1,1,0,1,0,0,0,2,1,3,16,11,27,37
20192020,005,BARREN,113,Caverna Independent,030,Caverna High School,113030,005113030,210111000214,GRREC,902,12,26,28,4,2,6,0,0,0,0,0,0,0,2,2,0,0,0,3,6,9,21,16,37,54
20192020,024,CHRISTIAN,115,Christian County,"",---District Total---,115,"","",WKEC,908,01,297,349,109,97,206,1,1,2,1,2,3,16,22,38,0,0,0,35,24,59,187,151,338,646
20192020,024,CHRISTIAN,115,Christian County,"",---District Total---,115,"","",WKEC,908,All Students,3935,4331,1458,1366,2824,13,14,27,25,27,52,321,300,621,10,10,20,295,270,565,2209,1948,4157,8266
20192020,024,CHRISTIAN,115,Christian County,"",---District Total---,115,"","",WKEC,908,PS,164,197,72,58,130,1,0,1,1,1,2,13,10,23,0,0,0,15,20,35,95,75,170,361
20192020,024,CHRISTIAN,115,Christian County,"",---District Total---,115,"","",WKEC,908,KG,313,350,108,102,210,2,0,2,2,3,5,21,19,40,2,1,3,34,24,58,181,164,345,663
20192020,024,CHRISTIAN,115,Christian County,"",---District Total---,115,"","",WKEC,908,02,298,299,95,103,198,1,1,2,1,1,2,32,23,55,0,1,1,22,18,40,148,151,299,597
20192020,024,CHRISTIAN,115,Christian County,"",---District Total---,115,"","",WKEC,908,03,290,342,111,93,204,2,3,5,0,3,3,26,26,52,0,0,0,22,25,47,181,140,321,632
20192020,024,CHRISTIAN,115,Christian County,"",---District Total---,115,"","",WKEC,908,04,281,367,117,110,227,1,2,3,2,0,2,28,19,47,2,3,5,27,27,54,190,120,310,648
20192020,024,CHRISTIAN,115,Christian County,"",---District Total---,115,"","",WKEC,908,05,340,347,116,124,240,0,0,0,3,2,5,27,27,54,0,2,2,27,24,51,174,161,335,687
20192020,024,CHRISTIAN,115,Christian County,"",---District Total---,115,"","",WKEC,908,06,316,328,99,112,211,0,0,0,0,4,4,38,29,67,1,1,2,18,30,48,172,140,312,644
20192020,024,CHRISTIAN,115,Christian County,"",---District Total---,115,"","",WKEC,908,07,301,356,129,115,244,1,0,1,3,1,4,31,19,50,1,0,1,27,19,46,164,147,311,657
20192020,024,CHRISTIAN,115,Christian County,"",---District Total---,115,"","",WKEC,908,08,309,309,113,97,210,2,0,2,2,2,4,18,22,40,1,0,1,13,26,39,160,162,322,618
20192020,024,CHRISTIAN,115,Christian County,"",---District Total---,115,"","",WKEC,908,09,305,355,138,107,245,1,1,2,2,3,5,28,32,60,1,0,1,22,14,36,163,148,311,660
20192020,024,CHRISTIAN,115,Christian County,"",---District Total---,115,"","",WKEC,908,10,313,332,113,102,215,1,4,5,4,1,5,19,25,44,2,2,4,19,16,35,174,163,337,645
20192020,024,CHRISTIAN,115,Christian County,"",---District Total---,115,"","",WKEC,908,11,278,293,96,103,199,1,1,2,2,2,4,17,13,30,0,0,0,14,14,28,163,145,308,571
20192020,024,CHRISTIAN,115,Christian County,"",---District Total---,115,"","",WKEC,908,12,291,297,112,100,212,0,1,1,2,3,5,20,24,44,0,0,0,14,9,23,149,154,303,588
20192020,024,CHRISTIAN,115,Christian County,"",---District Total---,115,"","",WKEC,908,14,3,7,2,1,3,0,0,0,1,0,1,0,0,0,0,0,0,1,0,1,3,2,5,10
20192020,024,CHRISTIAN,115,Christian County,017,Martin Luther King Jr. Elementary School,115017,024115017,210115002024,WKEC,908,PS,34,37,18,13,31,0,0,0,0,0,0,2,1,3,0,0,0,2,4,6,15,16,31,71
20192020,024,CHRISTIAN,115,Christian County,017,Martin Luther King Jr. Elementary School,115017,024115017,210115002024,WKEC,908,KG,38,47,23,22,45,0,0,0,0,1,1,3,4,7,0,0,0,2,2,4,19,9,28,85
20192020,024,CHRISTIAN,115,Christian County,017,Martin Luther King Jr. Elementary School,115017,024115017,210115002024,WKEC,908,01,41,42,21,23,44,0,0,0,0,0,0,2,4,6,0,0,0,7,2,9,12,12,24,83
20192020,024,CHRISTIAN,115,Christian County,017,Martin Luther King Jr. Elementary School,115017,024115017,210115002024,WKEC,908,02,29,32,18,13,31,0,0,0,1,0,1,2,2,4,0,0,0,3,2,5,8,12,20,61
20192020,024,CHRISTIAN,115,Christian County,017,Martin Luther King Jr. Elementary School,115017,024115017,210115002024,WKEC,908,03,38,45,16,16,32,0,0,0,0,1,1,5,2,7,0,0,0,2,1,3,22,18,40,83
20192020,024,CHRISTIAN,115,Christian County,017,Martin Luther King Jr. Elementary School,115017,024115017,210115002024,WKEC,908,04,38,36,22,20,42,0,0,0,0,0,0,3,3,6,0,1,1,2,2,4,9,12,21,74
20192020,024,CHRISTIAN,115,Christian County,017,Martin Luther King Jr. Elementary School,115017,024115017,210115002024,WKEC,908,All Students,282,287,142,141,283,0,0,0,1,2,3,20,25,45,1,2,3,22,13,35,101,99,200,569
20192020,024,CHRISTIAN,115,Christian County,017,Martin Luther King Jr. Elementary School,115017,024115017,210115002024,WKEC,908,05,59,48,25,28,53,0,0,0,0,0,0,1,7,8,0,1,1,5,2,7,17,21,38,107
20192020,024,CHRISTIAN,115,Christian County,017,Martin Luther King Jr. Elementary School,115017,024115017,210115002024,WKEC,908,06,39,37,17,19,36,0,0,0,0,0,0,4,3,7,1,0,1,1,2,3,14,15,29,76
20192020,024,CHRISTIAN,115,Christian County,023,Cumberland Hall School,115023,024115023,210115001912,WKEC,908,06,2,1,0,0,0,0,0,0,0,0,0,0,0,0,0,0,0,0,0,0,1,2,3,3
20192020,024,CHRISTIAN,115,Christian County,023,Cumberland Hall School,115023,024115023,210115001912,WKEC,908,07,0,3,2,0,2,0,0,0,0,0,0,0,0,0,0,0,0,0,0,0,1,0,1,3
20192020,024,CHRISTIAN,115,Christian County,023,Cumberland Hall School,115023,024115023,210115001912,WKEC,908,10,1,0,0,0,0,0,0,0,0,0,0,0,0,0,0,0,0,0,0,0,0,1,1,1
20192020,024,CHRISTIAN,115,Christian County,023,Cumberland Hall School,115023,024115023,210115001912,WKEC,908,08,2,4,0,0,0,0,0,0,0,0,0,0,0,0,0,0,0,0,0,0,4,2,6,6
20192020,024,CHRISTIAN,115,Christian County,023,Cumberland Hall School,115023,024115023,210115001912,WKEC,908,All Students,8,12,2,0,2,0,0,0,0,0,0,0,0,0,0,0,0,0,0,0,10,8,18,20
20192020,024,CHRISTIAN,115,Christian County,023,Cumberland Hall School,115023,024115023,210115001912,WKEC,908,KG,0,1,0,0,0,0,0,0,0,0,0,0,0,0,0,0,0,0,0,0,1,0,1,1
20192020,024,CHRISTIAN,115,Christian County,023,Cumberland Hall School,115023,024115023,210115001912,WKEC,908,01,0,1,0,0,0,0,0,0,0,0,0,0,0,0,0,0,0,0,0,0,1,0,1,1
20192020,024,CHRISTIAN,115,Christian County,023,Cumberland Hall School,115023,024115023,210115001912,WKEC,908,02,0,1,0,0,0,0,0,0,0,0,0,0,0,0,0,0,0,0,0,0,1,0,1,1
20192020,024,CHRISTIAN,115,Christian County,023,Cumberland Hall School,115023,024115023,210115001912,WKEC,908,04,1,0,0,0,0,0,0,0,0,0,0,0,0,0,0,0,0,0,0,0,0,1,1,1
20192020,024,CHRISTIAN,115,Christian County,023,Cumberland Hall School,115023,024115023,210115001912,WKEC,908,11,2,0,0,0,0,0,0,0,0,0,0,0,0,0,0,0,0,0,0,0,0,2,2,2
20192020,024,CHRISTIAN,115,Christian County,023,Cumberland Hall School,115023,024115023,210115001912,WKEC,908,05,0,1,0,0,0,0,0,0,0,0,0,0,0,0,0,0,0,0,0,0,1,0,1,1
20192020,024,CHRISTIAN,115,Christian County,026,Freedom Elementary School,115026,024115026,210115002415,WKEC,908,PS,42,37,20,19,39,0,0,0,0,1,1,2,3,5,0,0,0,2,4,6,13,15,28,79
20192020,024,CHRISTIAN,115,Christian County,026,Freedom Elementary School,115026,024115026,210115002415,WKEC,908,All Students,301,309,172,157,329,0,0,0,0,0,0,14,23,37,0,0,0,29,29,58,94,92,186,610
20192020,024,CHRISTIAN,115,Christian County,026,Freedom Elementary School,115026,024115026,210115002415,WKEC,908,KG,51,41,22,29,51,0,0,0,0,0,0,1,3,4,0,0,0,7,3,10,11,16,27,92
20192020,024,CHRISTIAN,115,Christian County,026,Freedom Elementary School,115026,024115026,210115002415,WKEC,908,01,45,49,25,24,49,0,0,0,0,0,0,0,1,1,0,0,0,6,3,9,18,17,35,94
20192020,024,CHRISTIAN,115,Christian County,026,Freedom Elementary School,115026,024115026,210115002415,WKEC,908,02,44,32,18,21,39,0,0,0,0,0,0,0,3,3,0,0,0,5,3,8,9,17,26,76
20192020,024,CHRISTIAN,115,Christian County,026,Freedom Elementary School,115026,024115026,210115002415,WKEC,908,03,37,47,26,19,45,0,0,0,0,0,0,3,2,5,0,0,0,3,7,10,15,9,24,84
20192020,024,CHRISTIAN,115,Christian County,026,Freedom Elementary School,115026,024115026,210115002415,WKEC,908,04,41,50,29,18,47,0,0,0,0,0,0,3,3,6,0,0,0,1,6,7,17,14,31,91
20192020,024,CHRISTIAN,115,Christian County,026,Freedom Elementary School,115026,024115026,210115002415,WKEC,908,05,43,42,24,24,48,0,0,0,0,0,0,4,4,8,0,0,0,4,4,8,10,11,21,85
20192020,024,CHRISTIAN,115,Christian County,026,Freedom Elementary School,115026,024115026,210115002415,WKEC,908,06,40,48,28,22,50,0,0,0,0,0,0,3,7,10,0,0,0,3,3,6,14,8,22,88
20192020,024,CHRISTIAN,115,Christian County,030,Christian County High School,115030,024115030,210115000220,WKEC,908,14,3,4,1,1,2,0,0,0,0,0,0,0,0,0,0,0,0,1,0,1,2,2,4,7
20192020,024,CHRISTIAN,115,Christian County,030,Christian County High School,115030,024115030,210115000220,WKEC,908,All Students,449,494,214,170,384,0,2,2,4,1,5,24,22,46,3,1,4,33,23,56,216,230,446,943
20192020,024,CHRISTIAN,115,Christian County,030,Christian County High School,115030,024115030,210115000220,WKEC,908,09,98,137,58,41,99,0,0,0,1,0,1,9,7,16,1,0,1,9,5,14,59,45,104,235
20192020,024,CHRISTIAN,115,Christian County,030,Christian County High School,115030,024115030,210115000220,WKEC,908,10,119,110,51,42,93,0,2,2,2,0,2,5,5,10,2,1,3,7,8,15,43,61,104,229
20192020,024,CHRISTIAN,115,Christian County,030,Christian County High School,115030,024115030,210115000220,WKEC,908,11,99,117,47,46,93,0,0,0,0,0,0,4,3,7,0,0,0,10,4,14,56,46,102,216
20192020,024,CHRISTIAN,115,Christian County,030,Christian County High School,115030,024115030,210115000220,WKEC,908,12,130,126,57,40,97,0,0,0,1,1,2,6,7,13,0,0,0,6,6,12,56,76,132,256
20192020,024,CHRISTIAN,115,Christian County,035,Christian County Middle School,115035,024115035,210115000221,WKEC,908,07,171,193,61,71,132,1,0,1,1,0,1,13,6,19,1,0,1,14,8,22,102,86,188,364
20192020,024,CHRISTIAN,115,Christian County,035,Christian County Middle School,115035,024115035,210115000221,WKEC,908,All Students,339,355,125,124,249,1,0,1,1,0,1,21,17,38,2,0,2,18,21,39,187,177,364,694
20192020,024,CHRISTIAN,115,Christian County,035,Christian County Middle School,115035,024115035,210115000221,WKEC,908,08,168,162,64,53,117,0,0,0,0,0,0,8,11,19,1,0,1,4,13,17,85,91,176,330
20192020,024,CHRISTIAN,115,Christian County,040,Crofton Elementary School,115040,024115040,210115000222,WKEC,908,05,34,30,0,1,1,0,0,0,0,0,0,1,2,3,0,0,0,1,1,2,28,30,58,64
20192020,024,CHRISTIAN,115,Christian County,040,Crofton Elementary School,115040,024115040,210115000222,WKEC,908,All Students,181,215,7,4,11,0,1,1,0,0,0,5,6,11,0,0,0,6,12,18,197,158,355,396
20192020,024,CHRISTIAN,115,Christian County,040,Crofton Elementary School,115040,024115040,210115000222,WKEC,908,PS,17,15,1,1,2,0,0,0,0,0,0,1,0,1,0,0,0,1,2,3,12,14,26,32
20192020,024,CHRISTIAN,115,Christian County,040,Crofton Elementary School,115040,024115040,210115000222,WKEC,908,KG,20,32,2,0,2,0,0,0,0,0,0,1,0,1,0,0,0,0,0,0,29,20,49,52
20192020,024,CHRISTIAN,115,Christian County,040,Crofton Elementary School,115040,024115040,210115000222,WKEC,908,01,22,25,1,2,3,0,0,0,0,0,0,1,1,2,0,0,0,0,2,2,23,17,40,47
20192020,024,CHRISTIAN,115,Christian County,040,Crofton Elementary School,115040,024115040,210115000222,WKEC,908,02,27,26,3,0,3,0,0,0,0,0,0,1,0,1,0,0,0,0,3,3,22,24,46,53
20192020,024,CHRISTIAN,115,Christian County,040,Crofton Elementary School,115040,024115040,210115000222,WKEC,908,03,23,32,1,0,1,0,0,0,0,0,0,0,1,1,0,0,0,0,2,2,31,20,51,55
20192020,024,CHRISTIAN,115,Christian County,040,Crofton Elementary School,115040,024115040,210115000222,WKEC,908,04,31,37,0,0,0,0,1,1,0,0,0,1,1,2,0,0,0,1,3,4,35,26,61,68
20192020,024,CHRISTIAN,115,Christian County,040,Crofton Elementary School,115040,024115040,210115000222,WKEC,908,06,24,33,0,1,1,0,0,0,0,0,0,0,1,1,0,0,0,4,1,5,29,21,50,57
20192020,024,CHRISTIAN,115,Christian County,050,Hopkinsville High School,115050,024115050,210115000223,WKEC,908,10,97,113,38,37,75,1,1,2,1,0,1,7,8,15,0,1,1,4,5,9,62,45,107,210
20192020,024,CHRISTIAN,115,Christian County,050,Hopkinsville High School,115050,024115050,210115000223,WKEC,908,All Students,441,436,163,154,317,2,3,5,5,2,7,36,44,80,0,1,1,16,19,35,214,218,432,877
20192020,024,CHRISTIAN,115,Christian County,050,Hopkinsville High School,115050,024115050,210115000223,WKEC,908,09,107,113,53,35,88,0,1,1,1,1,2,13,15,28,0,0,0,6,5,11,40,50,90,220
20192020,024,CHRISTIAN,115,Christian County,050,Hopkinsville High School,115050,024115050,210115000223,WKEC,908,11,102,92,29,32,61,1,0,1,1,0,1,6,9,15,0,0,0,2,6,8,53,55,108,194
20192020,024,CHRISTIAN,115,Christian County,050,Hopkinsville High School,115050,024115050,210115000223,WKEC,908,12,135,115,42,50,92,0,1,1,1,1,2,10,12,22,0,0,0,4,3,7,58,68,126,250
20192020,024,CHRISTIAN,115,Christian County,050,Hopkinsville High School,115050,024115050,210115000223,WKEC,908,14,0,3,1,0,1,0,0,0,1,0,1,0,0,0,0,0,0,0,0,0,1,0,1,3
20192020,024,CHRISTIAN,115,Christian County,055,Indian Hills Elementary School,115055,024115055,210115000224,WKEC,908,06,35,29,7,17,24,0,0,0,0,0,0,2,2,4,0,0,0,1,2,3,19,14,33,64
20192020,024,CHRISTIAN,115,Christian County,055,Indian Hills Elementary School,115055,024115055,210115000224,WKEC,908,All Students,220,239,75,92,167,0,0,0,1,2,3,27,12,39,1,1,2,23,18,41,112,95,207,459
20192020,024,CHRISTIAN,115,Christian County,055,Indian Hills Elementary School,115055,024115055,210115000224,WKEC,908,PS,13,27,10,7,17,1,0,1,0,0,0,2,2,4,0,0,0,1,0,1,13,4,17,40
20192020,024,CHRISTIAN,115,Christian County,055,Indian Hills Elementary School,115055,024115055,210115000224,WKEC,908,KG,34,35,8,9,17,0,0,0,1,1,2,2,1,3,1,1,2,5,2,7,18,20,38,69
20192020,024,CHRISTIAN,115,Christian County,055,Indian Hills Elementary School,115055,024115055,210115000224,WKEC,908,01,27,37,14,8,22,0,0,0,0,1,1,4,1,5,0,0,0,4,2,6,15,15,30,64
20192020,024,CHRISTIAN,115,Christian County,055,Indian Hills Elementary School,115055,024115055,210115000224,WKEC,908,02,27,35,7,11,18,0,0,0,0,0,0,6,1,7,0,0,0,5,2,7,17,13,30,62
20192020,024,CHRISTIAN,115,Christian County,055,Indian Hills Elementary School,115055,024115055,210115000224,WKEC,908,03,40,33,13,23,36,0,0,0,0,0,0,4,3,7,0,0,0,2,4,6,14,10,24,73
20192020,024,CHRISTIAN,115,Christian County,055,Indian Hills Elementary School,115055,024115055,210115000224,WKEC,908,04,27,37,14,15,29,0,0,0,0,0,0,5,1,6,0,0,0,2,2,4,16,9,25,64
20192020,024,CHRISTIAN,115,Christian County,055,Indian Hills Elementary School,115055,024115055,210115000224,WKEC,908,05,30,33,12,9,21,0,0,0,0,0,0,4,3,7,0,0,0,4,4,8,13,14,27,63
20192020,024,CHRISTIAN,115,Christian County,058,Hopkinsville Middle School,115058,024115058,210115000225,WKEC,908,07,130,160,66,44,110,0,0,0,2,1,3,18,13,31,0,0,0,13,11,24,61,61,122,290
20192020,024,CHRISTIAN,115,Christian County,058,Hopkinsville Middle School,115058,024115058,210115000225,WKEC,908,All Students,269,303,115,88,203,2,0,2,4,3,7,28,24,52,0,0,0,22,24,46,132,130,262,572
20192020,024,CHRISTIAN,115,Christian County,058,Hopkinsville Middle School,115058,024115058,210115000225,WKEC,908,08,139,143,49,44,93,2,0,2,2,2,4,10,11,21,0,0,0,9,13,22,71,69,140,282
20192020,024,CHRISTIAN,115,Christian County,100,Christian County Alternative School,115100,024115100,210115001402,WKEC,908,10,2,13,6,2,8,0,0,0,0,0,0,0,0,0,0,0,0,2,0,2,5,0,5,15
20192020,024,CHRISTIAN,115,Christian County,100,Christian County Alternative School,115100,024115100,210115001402,WKEC,908,All Students,9,38,19,7,26,0,0,0,0,0,0,1,0,1,0,0,0,3,0,3,15,2,17,47
20192020,024,CHRISTIAN,115,Christian County,100,Christian County Alternative School,115100,024115100,210115001402,WKEC,908,06,1,4,3,1,4,0,0,0,0,0,0,0,0,0,0,0,0,0,0,0,1,0,1,5
20192020,024,CHRISTIAN,115,Christian County,100,Christian County Alternative School,115100,024115100,210115001402,WKEC,908,12,1,3,1,1,2,0,0,0,0,0,0,0,0,0,0,0,0,0,0,0,2,0,2,4
20192020,024,CHRISTIAN,115,Christian County,100,Christian County Alternative School,115100,024115100,210115001402,WKEC,908,09,5,12,6,3,9,0,0,0,0,0,0,1,0,1,0,0,0,1,0,1,4,2,6,17
20192020,024,CHRISTIAN,115,Christian County,100,Christian County Alternative School,115100,024115100,210115001402,WKEC,908,11,0,6,3,0,3,0,0,0,0,0,0,0,0,0,0,0,0,0,0,0,3,0,3,6
20192020,024,CHRISTIAN,115,Christian County,125,Millbrooke Elementary School,115125,024115125,210115000229,WKEC,908,All Students,335,418,112,104,216,1,2,3,0,3,3,28,13,41,0,1,1,34,29,63,243,183,426,753
20192020,024,CHRISTIAN,115,Christian County,125,Millbrooke Elementary School,115125,024115125,210115000229,WKEC,908,KG,42,55,16,10,26,0,0,0,0,0,0,1,1,2,0,0,0,6,5,11,32,26,58,97
20192020,024,CHRISTIAN,115,Christian County,125,Millbrooke Elementary School,115125,024115125,210115000229,WKEC,908,01,54,59,16,15,31,1,0,1,0,0,0,1,2,3,0,0,0,5,3,8,36,34,70,113
20192020,024,CHRISTIAN,115,Christian County,125,Millbrooke Elementary School,115125,024115125,210115000229,WKEC,908,02,43,44,13,16,29,0,0,0,0,0,0,6,2,8,0,0,0,5,2,7,20,23,43,87
20192020,024,CHRISTIAN,115,Christian County,125,Millbrooke Elementary School,115125,024115125,210115000229,WKEC,908,03,44,62,18,9,27,0,2,2,0,0,0,2,4,6,0,0,0,5,5,10,37,24,61,106
20192020,024,CHRISTIAN,115,Christian County,125,Millbrooke Elementary School,115125,024115125,210115000229,WKEC,908,04,45,67,13,18,31,0,0,0,0,0,0,8,1,9,0,0,0,4,4,8,42,22,64,112
20192020,024,CHRISTIAN,115,Christian County,125,Millbrooke Elementary School,115125,024115125,210115000229,WKEC,908,05,56,66,25,20,45,0,0,0,0,1,1,3,2,5,0,0,0,5,3,8,33,30,63,122
20192020,024,CHRISTIAN,115,Christian County,125,Millbrooke Elementary School,115125,024115125,210115000229,WKEC,908,06,51,65,11,16,27,0,0,0,0,2,2,7,1,8,0,1,1,4,7,11,43,24,67,116
20192020,024,CHRISTIAN,115,Christian County,130,Pembroke Elementary School,115130,024115130,210115000231,WKEC,908,06,44,46,14,9,23,0,0,0,0,0,0,9,8,17,0,0,0,3,8,11,20,19,39,90
20192020,024,CHRISTIAN,115,Christian County,130,Pembroke Elementary School,115130,024115130,210115000231,WKEC,908,PS,27,34,11,6,17,0,0,0,0,0,0,4,2,6,0,0,0,5,6,11,14,13,27,61
20192020,024,CHRISTIAN,115,Christian County,130,Pembroke Elementary School,115130,024115130,210115000231,WKEC,908,All Students,306,341,89,84,173,3,2,5,2,0,2,38,44,82,2,1,3,45,31,76,162,144,306,647
20192020,024,CHRISTIAN,115,Christian County,130,Pembroke Elementary School,115130,024115130,210115000231,WKEC,908,KG,51,58,13,10,23,2,0,2,0,0,0,5,3,8,1,0,1,8,7,15,29,31,60,109
20192020,024,CHRISTIAN,115,Christian County,130,Pembroke Elementary School,115130,024115130,210115000231,WKEC,908,01,44,45,7,12,19,0,0,0,1,0,1,1,8,9,0,0,0,8,3,11,28,21,49,89
20192020,024,CHRISTIAN,115,Christian County,130,Pembroke Elementary School,115130,024115130,210115000231,WKEC,908,02,46,43,10,11,21,0,1,1,0,0,0,9,6,15,0,0,0,3,3,6,21,25,46,89
20192020,024,CHRISTIAN,115,Christian County,130,Pembroke Elementary School,115130,024115130,210115000231,WKEC,908,03,44,41,14,11,25,1,1,2,0,0,0,4,8,12,0,0,0,5,3,8,17,21,38,85
20192020,024,CHRISTIAN,115,Christian County,130,Pembroke Elementary School,115130,024115130,210115000231,WKEC,908,04,38,63,19,15,34,0,0,0,0,0,0,3,4,7,1,1,2,12,4,16,28,14,42,101
20192020,024,CHRISTIAN,115,Christian County,130,Pembroke Elementary School,115130,024115130,210115000231,WKEC,908,05,39,45,12,16,28,0,0,0,1,0,1,7,7,14,0,0,0,6,3,9,19,13,32,84
20192020,024,CHRISTIAN,115,Christian County,150,Sinking Fork Elementary School,115150,024115150,210115000232,WKEC,908,05,39,31,10,16,26,0,0,0,0,0,0,0,0,0,0,0,0,0,3,3,21,20,41,70
20192020,024,CHRISTIAN,115,Christian County,150,Sinking Fork Elementary School,115150,024115150,210115000232,WKEC,908,All Students,205,213,61,78,139,0,1,1,0,0,0,17,12,29,0,2,2,11,14,25,124,98,222,418
20192020,024,CHRISTIAN,115,Christian County,150,Sinking Fork Elementary School,115150,024115150,210115000232,WKEC,908,PS,12,20,4,6,10,0,0,0,0,0,0,2,0,2,0,0,0,3,1,4,11,5,16,32
20192020,024,CHRISTIAN,115,Christian County,150,Sinking Fork Elementary School,115150,024115150,210115000232,WKEC,908,KG,29,21,6,8,14,0,0,0,0,0,0,1,1,2,0,0,0,2,1,3,12,19,31,50
20192020,024,CHRISTIAN,115,Christian County,150,Sinking Fork Elementary School,115150,024115150,210115000232,WKEC,908,01,19,38,6,5,11,0,1,1,0,0,0,2,2,4,0,0,0,3,2,5,27,9,36,57
20192020,024,CHRISTIAN,115,Christian County,150,Sinking Fork Elementary School,115150,024115150,210115000232,WKEC,908,02,35,28,10,14,24,0,0,0,0,0,0,3,2,5,0,1,1,1,2,3,14,16,30,63
20192020,024,CHRISTIAN,115,Christian County,150,Sinking Fork Elementary School,115150,024115150,210115000232,WKEC,908,03,24,31,9,6,15,0,0,0,0,0,0,2,3,5,0,0,0,1,1,2,19,14,33,55
20192020,024,CHRISTIAN,115,Christian County,150,Sinking Fork Elementary School,115150,024115150,210115000232,WKEC,908,04,28,36,11,14,25,0,0,0,0,0,0,3,2,5,0,1,1,4,4,8,18,7,25,64
20192020,024,CHRISTIAN,115,Christian County,150,Sinking Fork Elementary School,115150,024115150,210115000232,WKEC,908,06,31,28,9,15,24,0,0,0,0,0,0,6,2,8,0,0,0,0,1,1,13,13,26,59
20192020,024,CHRISTIAN,115,Christian County,170,South Christian Elementary School,115170,024115170,210115000233,WKEC,908,05,40,51,8,10,18,0,0,0,2,1,3,7,2,9,0,1,1,2,4,6,32,22,54,91
20192020,024,CHRISTIAN,115,Christian County,170,South Christian Elementary School,115170,024115170,210115000233,WKEC,908,All Students,301,351,94,80,174,3,1,4,5,8,13,39,30,69,1,1,2,15,26,41,194,155,349,652
20192020,024,CHRISTIAN,115,Christian County,170,South Christian Elementary School,115170,024115170,210115000233,WKEC,908,PS,19,27,8,6,14,0,0,0,1,0,1,0,2,2,0,0,0,1,3,4,17,8,25,46
20192020,024,CHRISTIAN,115,Christian County,170,South Christian Elementary School,115170,024115170,210115000233,WKEC,908,KG,48,60,18,14,32,0,0,0,1,1,2,7,6,13,0,0,0,4,4,8,30,23,53,108
20192020,024,CHRISTIAN,115,Christian County,170,South Christian Elementary School,115170,024115170,210115000233,WKEC,908,01,45,53,19,8,27,0,0,0,0,1,1,5,3,8,0,0,0,2,7,9,27,26,53,98
20192020,024,CHRISTIAN,115,Christian County,170,South Christian Elementary School,115170,024115170,210115000233,WKEC,908,02,47,58,16,17,33,1,0,1,0,1,1,5,7,12,0,0,0,0,1,1,36,21,57,105
20192020,024,CHRISTIAN,115,Christian County,170,South Christian Elementary School,115170,024115170,210115000233,WKEC,908,03,40,51,14,9,23,1,0,1,0,2,2,6,3,9,0,0,0,4,2,6,26,24,50,91
20192020,024,CHRISTIAN,115,Christian County,170,South Christian Elementary School,115170,024115170,210115000233,WKEC,908,04,32,41,9,10,19,1,1,2,2,0,2,2,4,6,1,0,1,1,2,3,25,15,40,73
20192020,024,CHRISTIAN,115,Christian County,170,South Christian Elementary School,115170,024115170,210115000233,WKEC,908,06,49,37,10,12,22,0,0,0,0,2,2,7,5,12,0,0,0,2,6,8,18,24,42,86
20192020,024,CHRISTIAN,115,Christian County,180,Christian County Day Treatment,115180,024115180,210115000234,WKEC,908,09,1,6,3,0,3,0,0,0,0,0,0,0,0,0,0,0,0,1,0,1,2,1,3,7
20192020,024,CHRISTIAN,115,Christian County,180,Christian County Day Treatment,115180,024115180,210115000234,WKEC,908,11,1,2,1,1,2,0,0,0,0,0,0,0,0,0,0,0,0,0,0,0,1,0,1,3
20192020,024,CHRISTIAN,115,Christian County,180,Christian County Day Treatment,115180,024115180,210115000234,WKEC,908,All Students,4,14,5,1,6,0,0,0,0,0,0,0,0,0,0,0,0,2,1,3,7,2,9,18
20192020,024,CHRISTIAN,115,Christian County,180,Christian County Day Treatment,115180,024115180,210115000234,WKEC,908,10,2,6,1,0,1,0,0,0,0,0,0,0,0,0,0,0,0,1,1,2,4,1,5,8
20192020,024,CHRISTIAN,115,Christian County,975,Gateway Academy to Innovation & Tech.,115975,024115975,210115001938,WKEC,908,10,92,90,17,21,38,0,1,1,1,1,2,7,12,19,0,0,0,5,2,7,60,55,115,182
20192020,024,CHRISTIAN,115,Christian County,975,Gateway Academy to Innovation & Tech.,115975,024115975,210115001938,WKEC,908,12,25,53,12,9,21,0,0,0,0,1,1,4,5,9,0,0,0,4,0,4,33,10,43,78
20192020,024,CHRISTIAN,115,Christian County,975,Gateway Academy to Innovation & Tech.,115975,024115975,210115001938,WKEC,908,All Students,285,306,63,82,145,1,2,3,2,6,8,23,28,51,0,0,0,16,10,26,201,157,358,591
20192020,024,CHRISTIAN,115,Christian County,975,Gateway Academy to Innovation & Tech.,115975,024115975,210115001938,WKEC,908,09,94,87,18,28,46,1,0,1,0,2,2,5,10,15,0,0,0,5,4,9,58,50,108,181
20192020,024,CHRISTIAN,115,Christian County,975,Gateway Academy to Innovation & Tech.,115975,024115975,210115001938,WKEC,908,11,74,76,16,24,40,0,1,1,1,2,3,7,1,8,0,0,0,2,4,6,50,42,92,150
20192020,025,CLARK,121,Clark County,"",---District Total---,121,"","",CKEC,901,KG,173,209,10,9,19,0,0,0,0,0,0,11,16,27,0,1,1,4,11,15,184,136,320,382
20192020,025,CLARK,121,Clark County,"",---District Total---,121,"","",CKEC,901,All Students,2469,2732,151,138,289,1,6,7,16,23,39,205,182,387,2,3,5,100,113,213,2257,2004,4261,5201
20192020,025,CLARK,121,Clark County,"",---District Total---,121,"","",CKEC,901,PS,191,218,10,7,17,1,0,1,1,1,2,28,11,39,1,0,1,7,5,12,170,167,337,409
20192020,025,CLARK,121,Clark County,"",---District Total---,121,"","",CKEC,901,01,190,206,11,6,17,0,0,0,0,3,3,15,21,36,0,0,0,10,10,20,170,150,320,396
20192020,025,CLARK,121,Clark County,"",---District Total---,121,"","",CKEC,901,02,156,178,8,10,18,0,0,0,1,2,3,12,13,25,1,0,1,7,10,17,149,121,270,334
20192020,025,CLARK,121,Clark County,"",---District Total---,121,"","",CKEC,901,03,188,202,7,10,17,0,0,0,3,3,6,17,16,33,0,1,1,16,12,28,159,146,305,390
20192020,025,CLARK,121,Clark County,"",---District Total---,121,"","",CKEC,901,04,175,183,5,9,14,0,0,0,0,2,2,17,12,29,0,0,0,9,10,19,152,142,294,358
20192020,025,CLARK,121,Clark County,"",---District Total---,121,"","",CKEC,901,05,213,242,13,14,27,1,4,5,1,3,4,21,10,31,0,0,0,11,9,20,195,173,368,455
20192020,025,CLARK,121,Clark County,"",---District Total---,121,"","",CKEC,901,06,185,221,11,9,20,0,0,0,2,0,2,12,14,26,0,0,0,12,10,22,184,152,336,406
20192020,025,CLARK,121,Clark County,"",---District Total---,121,"","",CKEC,901,07,229,218,14,15,29,0,0,0,0,3,3,17,20,37,0,0,0,5,11,16,182,180,362,447
20192020,025,CLARK,121,Clark County,"",---District Total---,121,"","",CKEC,901,08,203,251,14,16,30,0,1,1,2,0,2,14,13,27,1,0,1,5,12,17,215,161,376,454
20192020,025,CLARK,121,Clark County,"",---District Total---,121,"","",CKEC,901,09,195,218,10,14,24,0,0,0,2,3,5,21,20,41,0,0,0,10,1,11,175,157,332,413
20192020,025,CLARK,121,Clark County,"",---District Total---,121,"","",CKEC,901,10,203,215,14,12,26,0,1,1,2,3,5,18,8,26,0,0,0,3,3,6,178,176,354,418
20192020,025,CLARK,121,Clark County,"",---District Total---,121,"","",CKEC,901,11,189,202,15,9,24,0,0,0,1,0,1,16,12,28,0,0,0,5,5,10,165,163,328,391
20192020,025,CLARK,121,Clark County,"",---District Total---,121,"","",CKEC,901,12,168,186,19,5,24,0,0,0,2,1,3,14,7,21,0,1,1,3,9,12,148,145,293,354
20192020,025,CLARK,121,Clark County,"",---District Total---,121,"","",CKEC,901,14,2,1,0,0,0,0,0,0,0,0,0,0,0,0,0,0,0,0,0,0,1,2,3,3
20192020,025,CLARK,121,Clark County,002,Willis H. Justice Elementary School,121002,025121002,210120002405,CKEC,901,04,42,42,0,2,2,0,0,0,0,0,0,3,3,6,0,0,0,3,2,5,36,35,71,84
20192020,025,CLARK,121,Clark County,002,Willis H. Justice Elementary School,121002,025121002,210120002405,CKEC,901,All Students,211,230,13,14,27,0,0,0,2,0,2,15,21,36,0,0,0,11,11,22,189,165,354,441
20192020,025,CLARK,121,Clark County,002,Willis H. Justice Elementary School,121002,025121002,210120002405,CKEC,901,KG,39,47,4,3,7,0,0,0,0,0,0,2,1,3,0,0,0,1,2,3,40,33,73,86
20192020,025,CLARK,121,Clark County,002,Willis H. Justice Elementary School,121002,025121002,210120002405,CKEC,901,01,47,47,4,3,7,0,0,0,0,0,0,3,7,10,0,0,0,3,1,4,37,36,73,94
20192020,025,CLARK,121,Clark County,002,Willis H. Justice Elementary School,121002,025121002,210120002405,CKEC,901,02,41,42,2,3,5,0,0,0,1,0,1,3,3,6,0,0,0,1,3,4,35,32,67,83
20192020,025,CLARK,121,Clark County,002,Willis H. Justice Elementary School,121002,025121002,210120002405,CKEC,901,03,42,52,3,3,6,0,0,0,1,0,1,4,7,11,0,0,0,3,3,6,41,29,70,94
20192020,025,CLARK,121,Clark County,004,Strode Station Elementary School,121004,025121004,210120002395,CKEC,901,03,54,57,1,3,4,0,0,0,2,3,5,10,0,10,0,1,1,6,1,7,38,46,84,111
20192020,025,CLARK,121,Clark County,004,Strode Station Elementary School,121004,025121004,210120002395,CKEC,901,All Students,262,261,9,14,23,0,0,0,2,8,10,31,22,53,1,2,3,21,16,37,197,200,397,523
20192020,025,CLARK,121,Clark County,004,Strode Station Elementary School,121004,025121004,210120002395,CKEC,901,KG,55,52,5,1,6,0,0,0,0,0,0,5,9,14,0,1,1,3,3,6,39,41,80,107
20192020,025,CLARK,121,Clark County,004,Strode Station Elementary School,121004,025121004,210120002395,CKEC,901,01,57,59,2,2,4,0,0,0,0,3,3,7,4,11,0,0,0,3,5,8,47,43,90,116
20192020,025,CLARK,121,Clark County,004,Strode Station Elementary School,121004,025121004,210120002395,CKEC,901,02,48,51,1,4,5,0,0,0,0,2,2,5,5,10,1,0,1,5,5,10,39,32,71,99
20192020,025,CLARK,121,Clark County,004,Strode Station Elementary School,121004,025121004,210120002395,CKEC,901,04,48,42,0,4,4,0,0,0,0,0,0,4,4,8,0,0,0,4,2,6,34,38,72,90
20192020,025,CLARK,121,Clark County,006,Shearer Elementary School,121006,025121006,210120002397,CKEC,901,03,44,42,0,1,1,0,0,0,0,0,0,2,5,7,0,0,0,7,4,11,33,34,67,86
20192020,025,CLARK,121,Clark County,006,Shearer Elementary School,121006,025121006,210120002397,CKEC,901,All Students,188,220,4,4,8,0,0,0,0,1,1,16,21,37,0,0,0,12,14,26,188,148,336,408
20192020,025,CLARK,121,Clark County,006,Shearer Elementary School,121006,025121006,210120002397,CKEC,901,KG,34,43,0,1,1,0,0,0,0,0,0,1,3,4,0,0,0,0,2,2,42,28,70,77
20192020,025,CLARK,121,Clark County,006,Shearer Elementary School,121006,025121006,210120002397,CKEC,901,01,47,48,2,1,3,0,0,0,0,0,0,3,8,11,0,0,0,3,3,6,40,35,75,95
20192020,025,CLARK,121,Clark County,006,Shearer Elementary School,121006,025121006,210120002397,CKEC,901,02,27,46,2,1,3,0,0,0,0,0,0,3,2,5,0,0,0,1,1,2,40,23,63,73
20192020,025,CLARK,121,Clark County,006,Shearer Elementary School,121006,025121006,210120002397,CKEC,901,04,36,41,0,0,0,0,0,0,0,1,1,7,3,10,0,0,0,1,4,5,33,28,61,77
20192020,025,CLARK,121,Clark County,008,William G. Conkwright Elementary,121008,025121008,210120002391,CKEC,901,03,48,51,3,3,6,0,0,0,0,0,0,1,4,5,0,0,0,0,4,4,47,37,84,99
20192020,025,CLARK,121,Clark County,008,William G. Conkwright Elementary,121008,025121008,210120002391,CKEC,901,All Students,221,267,15,12,27,0,0,0,0,1,1,10,14,24,0,0,0,2,12,14,240,182,422,488
20192020,025,CLARK,121,Clark County,008,William G. Conkwright Elementary,121008,025121008,210120002391,CKEC,901,KG,45,67,1,4,5,0,0,0,0,0,0,3,3,6,0,0,0,0,4,4,63,34,97,112
20192020,025,CLARK,121,Clark County,008,William G. Conkwright Elementary,121008,025121008,210120002391,CKEC,901,01,39,52,3,0,3,0,0,0,0,0,0,2,2,4,0,0,0,1,1,2,46,36,82,91
20192020,025,CLARK,121,Clark County,008,William G. Conkwright Elementary,121008,025121008,210120002391,CKEC,901,02,40,39,3,2,5,0,0,0,0,0,0,1,3,4,0,0,0,0,1,1,35,34,69,79
20192020,025,CLARK,121,Clark County,008,William G. Conkwright Elementary,121008,025121008,210120002391,CKEC,901,04,49,58,5,3,8,0,0,0,0,1,1,3,2,5,0,0,0,1,2,3,49,41,90,107
20192020,025,CLARK,121,Clark County,013,Phoenix Academy,121013,025121013,210120001624,CKEC,901,11,5,9,3,1,4,0,0,0,0,0,0,1,0,1,0,0,0,0,1,1,5,3,8,14
20192020,025,CLARK,121,Clark County,013,Phoenix Academy,121013,025121013,210120001624,CKEC,901,All Students,18,37,7,1,8,0,0,0,0,0,0,6,1,7,0,0,0,0,4,4,24,12,36,55
20192020,025,CLARK,121,Clark County,013,Phoenix Academy,121013,025121013,210120001624,CKEC,901,07,0,2,0,0,0,0,0,0,0,0,0,1,0,1,0,0,0,0,0,0,1,0,1,2
20192020,025,CLARK,121,Clark County,013,Phoenix Academy,121013,025121013,210120001624,CKEC,901,08,1,3,1,0,1,0,0,0,0,0,0,0,0,0,0,0,0,0,1,1,2,0,2,4
20192020,025,CLARK,121,Clark County,013,Phoenix Academy,121013,025121013,210120001624,CKEC,901,09,2,4,1,0,1,0,0,0,0,0,0,1,1,2,0,0,0,0,0,0,2,1,3,6
20192020,025,CLARK,121,Clark County,013,Phoenix Academy,121013,025121013,210120001624,CKEC,901,10,3,8,0,0,0,0,0,0,0,0,0,1,0,1,0,0,0,0,0,0,7,3,10,11
20192020,025,CLARK,121,Clark County,013,Phoenix Academy,121013,025121013,210120001624,CKEC,901,12,7,11,2,0,2,0,0,0,0,0,0,2,0,2,0,0,0,0,2,2,7,5,12,18
20192020,025,CLARK,121,Clark County,017,Clark County Preschool,121017,025121017,210120002120,CKEC,901,All Students,0,0,0,0,0,0,0,0,0,0,0,0,0,0,0,0,0,0,0,0,0,0,0,0
20192020,025,CLARK,121,Clark County,017,Clark County Preschool,121017,025121017,210120002120,CKEC,901,PS,191,218,10,7,17,1,0,1,1,1,2,28,11,39,1,0,1,7,5,12,170,167,337,409
20192020,025,CLARK,121,Clark County,023,Robert D. Campbell Jr. High,121023,025121023,210120002402,CKEC,901,07,229,216,14,15,29,0,0,0,0,3,3,16,20,36,0,0,0,5,11,16,181,180,361,445
20192020,025,CLARK,121,Clark County,023,Robert D. Campbell Jr. High,121023,025121023,210120002402,CKEC,901,All Students,431,464,27,31,58,0,1,1,2,3,5,30,33,63,1,0,1,10,22,32,394,341,735,895
20192020,025,CLARK,121,Clark County,023,Robert D. Campbell Jr. High,121023,025121023,210120002402,CKEC,901,08,202,248,13,16,29,0,1,1,2,0,2,14,13,27,1,0,1,5,11,16,213,161,374,450
20192020,025,CLARK,121,Clark County,026,Rev. Henry E. Baker Sr. Interm. School,121026,025121026,210120002389,CKEC,901,05,213,242,13,14,27,1,4,5,1,3,4,21,10,31,0,0,0,11,9,20,195,173,368,455
20192020,025,CLARK,121,Clark County,026,Rev. Henry E. Baker Sr. Interm. School,121026,025121026,210120002389,CKEC,901,All Students,398,463,24,23,47,1,4,5,3,3,6,33,24,57,0,0,0,23,19,42,379,325,704,861
20192020,025,CLARK,121,Clark County,026,Rev. Henry E. Baker Sr. Interm. School,121026,025121026,210120002389,CKEC,901,06,185,221,11,9,20,0,0,0,2,0,2,12,14,26,0,0,0,12,10,22,184,152,336,406
20192020,025,CLARK,121,Clark County,030,George Rogers Clark High School,121030,025121030,210120000237,CKEC,901,11,184,193,12,8,20,0,0,0,1,0,1,15,12,27,0,0,0,5,4,9,160,160,320,377
20192020,025,CLARK,121,Clark County,030,George Rogers Clark High School,121030,025121030,210120000237,CKEC,901,All Students,740,790,52,39,91,0,1,1,7,7,14,64,46,110,0,1,1,21,15,36,646,631,1277,1530
20192020,025,CLARK,121,Clark County,030,George Rogers Clark High School,121030,025121030,210120000237,CKEC,901,12,161,175,17,5,22,0,0,0,2,1,3,12,7,19,0,1,1,3,7,10,141,140,281,336
20192020,025,CLARK,121,Clark County,030,George Rogers Clark High School,121030,025121030,210120000237,CKEC,901,14,2,1,0,0,0,0,0,0,0,0,0,0,0,0,0,0,0,0,0,0,1,2,3,3
20192020,025,CLARK,121,Clark County,030,George Rogers Clark High School,121030,025121030,210120000237,CKEC,901,09,193,214,9,14,23,0,0,0,2,3,5,20,19,39,0,0,0,10,1,11,173,156,329,407
20192020,025,CLARK,121,Clark County,030,George Rogers Clark High School,121030,025121030,210120000237,CKEC,901,10,200,207,14,12,26,0,1,1,2,3,5,17,8,25,0,0,0,3,3,6,171,173,344,407
20192020,026,CLAY,125,Clay County,"",---District Total---,125,"","",SESC,907,03,119,136,1,1,2,0,0,0,2,0,2,1,1,2,0,0,0,0,0,0,132,117,249,255
20192020,026,CLAY,125,Clay County,"",---District Total---,125,"","",SESC,907,04,102,119,4,0,4,0,0,0,0,1,1,1,0,1,1,1,2,1,0,1,112,100,212,221
20192020,026,CLAY,125,Clay County,"",---District Total---,125,"","",SESC,907,05,135,116,0,2,2,0,0,0,0,0,0,3,2,5,0,0,0,0,3,3,113,128,241,251
20192020,026,CLAY,125,Clay County,"",---District Total---,125,"","",SESC,907,06,117,134,2,0,2,0,0,0,1,0,1,1,2,3,0,0,0,0,0,0,130,115,245,251
20192020,026,CLAY,125,Clay County,"",---District Total---,125,"","",SESC,907,07,112,132,0,3,3,0,0,0,0,0,0,0,0,0,0,0,0,0,1,1,132,108,240,244
20192020,026,CLAY,125,Clay County,"",---District Total---,125,"","",SESC,907,08,103,131,2,4,6,0,0,0,0,1,1,0,2,2,0,0,0,0,1,1,129,95,224,234
20192020,026,CLAY,125,Clay County,"",---District Total---,125,"","",SESC,907,09,126,119,0,3,3,0,0,0,0,0,0,1,0,1,0,0,0,0,1,1,118,122,240,245
20192020,026,CLAY,125,Clay County,"",---District Total---,125,"","",SESC,907,10,111,118,1,1,2,0,0,0,0,0,0,0,0,0,0,0,0,0,0,0,117,110,227,229
20192020,026,CLAY,125,Clay County,"",---District Total---,125,"","",SESC,907,12,95,93,1,2,3,0,0,0,0,0,0,0,0,0,0,0,0,0,0,0,92,93,185,188
20192020,026,CLAY,125,Clay County,"",---District Total---,125,"","",SESC,907,11,82,104,1,1,2,0,0,0,0,1,1,1,3,4,0,0,0,1,1,2,101,76,177,186
20192020,026,CLAY,125,Clay County,"",---District Total---,125,"","",SESC,907,All Students,1458,1565,15,20,35,2,4,6,3,3,6,9,12,21,1,1,2,4,13,17,1531,1405,2936,3023
20192020,026,CLAY,125,Clay County,"",---District Total---,125,"","",SESC,907,PS,79,51,0,1,1,0,2,2,0,0,0,1,0,1,0,0,0,0,1,1,50,75,125,130
20192020,026,CLAY,125,Clay County,"",---District Total---,125,"","",SESC,907,KG,116,122,0,0,0,2,3,5,0,0,0,0,0,0,0,0,0,2,0,2,118,113,231,238
20192020,026,CLAY,125,Clay County,"",---District Total---,125,"","",SESC,907,01,118,130,2,2,4,0,1,1,0,0,0,1,1,2,0,0,0,0,5,5,127,109,236,248
20192020,026,CLAY,125,Clay County,"",---District Total---,125,"","",SESC,907,02,122,111,1,1,2,0,0,0,0,0,0,0,1,1,0,0,0,0,1,1,110,119,229,233
20192020,026,CLAY,125,Clay County,040,Big Creek Elementary,125040,026125040,210123000247,SESC,907,04,10,7,0,0,0,0,0,0,0,0,0,0,0,0,0,0,0,0,0,0,7,10,17,17
20192020,026,CLAY,125,Clay County,040,Big Creek Elementary,125040,026125040,210123000247,SESC,907,06,17,10,0,0,0,0,0,0,0,0,0,0,0,0,0,0,0,0,0,0,10,17,27,27
20192020,026,CLAY,125,Clay County,040,Big Creek Elementary,125040,026125040,210123000247,SESC,907,All Students,78,71,0,1,1,2,2,4,0,0,0,1,0,1,0,0,0,0,0,0,68,75,143,149
20192020,026,CLAY,125,Clay County,040,Big Creek Elementary,125040,026125040,210123000247,SESC,907,PS,11,6,0,0,0,0,2,2,0,0,0,0,0,0,0,0,0,0,0,0,6,9,15,17
20192020,026,CLAY,125,Clay County,040,Big Creek Elementary,125040,026125040,210123000247,SESC,907,KG,5,10,0,0,0,2,2,4,0,0,0,0,0,0,0,0,0,0,0,0,8,3,11,15
20192020,026,CLAY,125,Clay County,040,Big Creek Elementary,125040,026125040,210123000247,SESC,907,01,10,8,0,0,0,0,0,0,0,0,0,0,0,0,0,0,0,0,0,0,8,10,18,18
20192020,026,CLAY,125,Clay County,040,Big Creek Elementary,125040,026125040,210123000247,SESC,907,02,14,8,0,0,0,0,0,0,0,0,0,0,0,0,0,0,0,0,0,0,8,14,22,22
20192020,026,CLAY,125,Clay County,040,Big Creek Elementary,125040,026125040,210123000247,SESC,907,03,9,15,0,0,0,0,0,0,0,0,0,1,0,1,0,0,0,0,0,0,14,9,23,24
20192020,026,CLAY,125,Clay County,040,Big Creek Elementary,125040,026125040,210123000247,SESC,907,05,13,13,0,1,1,0,0,0,0,0,0,0,0,0,0,0,0,0,0,0,13,12,25,26
20192020,026,CLAY,125,Clay County,041,Horse Creek Learning Center,125041,026125041,210123001846,SESC,907,09,9,9,0,0,0,0,0,0,0,0,0,1,0,1,0,0,0,0,0,0,8,9,17,18
20192020,026,CLAY,125,Clay County,041,Horse Creek Learning Center,125041,026125041,210123001846,SESC,907,10,8,2,0,0,0,0,0,0,0,0,0,0,0,0,0,0,0,0,0,0,2,8,10,10
20192020,026,CLAY,125,Clay County,041,Horse Creek Learning Center,125041,026125041,210123001846,SESC,907,11,5,3,0,0,0,0,0,0,0,0,0,0,0,0,0,0,0,0,0,0,3,5,8,8
20192020,026,CLAY,125,Clay County,041,Horse Creek Learning Center,125041,026125041,210123001846,SESC,907,All Students,33,30,1,0,1,0,0,0,0,0,0,1,0,1,0,0,0,0,0,0,28,33,61,63
20192020,026,CLAY,125,Clay County,041,Horse Creek Learning Center,125041,026125041,210123001846,SESC,907,05,1,2,0,0,0,0,0,0,0,0,0,0,0,0,0,0,0,0,0,0,2,1,3,3
20192020,026,CLAY,125,Clay County,041,Horse Creek Learning Center,125041,026125041,210123001846,SESC,907,07,3,4,0,0,0,0,0,0,0,0,0,0,0,0,0,0,0,0,0,0,4,3,7,7
20192020,026,CLAY,125,Clay County,041,Horse Creek Learning Center,125041,026125041,210123001846,SESC,907,12,6,6,1,0,1,0,0,0,0,0,0,0,0,0,0,0,0,0,0,0,5,6,11,12
20192020,026,CLAY,125,Clay County,041,Horse Creek Learning Center,125041,026125041,210123001846,SESC,907,08,1,4,0,0,0,0,0,0,0,0,0,0,0,0,0,0,0,0,0,0,4,1,5,5
20192020,026,CLAY,125,Clay County,070,Burning Springs Elementary,125070,026125070,210123000248,SESC,907,KG,22,23,0,0,0,0,0,0,0,0,0,0,0,0,0,0,0,0,0,0,23,22,45,45
20192020,026,CLAY,125,Clay County,070,Burning Springs Elementary,125070,026125070,210123000248,SESC,907,All Students,152,125,0,0,0,0,1,1,0,0,0,1,2,3,0,0,0,0,3,3,124,146,270,277
20192020,026,CLAY,125,Clay County,070,Burning Springs Elementary,125070,026125070,210123000248,SESC,907,PS,11,8,0,0,0,0,0,0,0,0,0,0,0,0,0,0,0,0,0,0,8,11,19,19
20192020,026,CLAY,125,Clay County,070,Burning Springs Elementary,125070,026125070,210123000248,SESC,907,01,21,20,0,0,0,0,1,1,0,0,0,1,0,1,0,0,0,0,3,3,19,17,36,41
20192020,026,CLAY,125,Clay County,070,Burning Springs Elementary,125070,026125070,210123000248,SESC,907,02,28,17,0,0,0,0,0,0,0,0,0,0,0,0,0,0,0,0,0,0,17,28,45,45
20192020,026,CLAY,125,Clay County,070,Burning Springs Elementary,125070,026125070,210123000248,SESC,907,03,25,18,0,0,0,0,0,0,0,0,0,0,1,1,0,0,0,0,0,0,18,24,42,43
20192020,026,CLAY,125,Clay County,070,Burning Springs Elementary,125070,026125070,210123000248,SESC,907,04,15,14,0,0,0,0,0,0,0,0,0,0,0,0,0,0,0,0,0,0,14,15,29,29
20192020,026,CLAY,125,Clay County,070,Burning Springs Elementary,125070,026125070,210123000248,SESC,907,05,18,12,0,0,0,0,0,0,0,0,0,0,1,1,0,0,0,0,0,0,12,17,29,30
20192020,026,CLAY,125,Clay County,070,Burning Springs Elementary,125070,026125070,210123000248,SESC,907,06,23,21,0,0,0,0,0,0,0,0,0,0,0,0,0,0,0,0,0,0,21,23,44,44
20192020,026,CLAY,125,Clay County,095,Clay County Middle School,125095,026125095,210123001699,SESC,907,All Students,211,255,2,7,9,0,0,0,0,1,1,0,2,2,0,0,0,0,2,2,253,199,452,466
20192020,026,CLAY,125,Clay County,095,Clay County Middle School,125095,026125095,210123001699,SESC,907,07,109,128,0,3,3,0,0,0,0,0,0,0,0,0,0,0,0,0,1,1,128,105,233,237
20192020,026,CLAY,125,Clay County,095,Clay County Middle School,125095,026125095,210123001699,SESC,907,08,102,127,2,4,6,0,0,0,0,1,1,0,2,2,0,0,0,0,1,1,125,94,219,229
20192020,026,CLAY,125,Clay County,100,Clay County High School,125100,026125100,210123000249,SESC,907,All Students,386,414,2,7,9,0,0,0,0,1,1,1,3,4,0,0,0,1,2,3,410,373,783,800
20192020,026,CLAY,125,Clay County,100,Clay County High School,125100,026125100,210123000249,SESC,907,09,117,110,0,3,3,0,0,0,0,0,0,0,0,0,0,0,0,0,1,1,110,113,223,227
20192020,026,CLAY,125,Clay County,100,Clay County High School,125100,026125100,210123000249,SESC,907,10,103,116,1,1,2,0,0,0,0,0,0,0,0,0,0,0,0,0,0,0,115,102,217,219
20192020,026,CLAY,125,Clay County,100,Clay County High School,125100,026125100,210123000249,SESC,907,11,77,101,1,1,2,0,0,0,0,1,1,1,3,4,0,0,0,1,1,2,98,71,169,178
20192020,026,CLAY,125,Clay County,100,Clay County High School,125100,026125100,210123000249,SESC,907,12,89,87,0,2,2,0,0,0,0,0,0,0,0,0,0,0,0,0,0,0,87,87,174,176
20192020,026,CLAY,125,Clay County,200,Goose Rock Elementary,125200,026125200,210123000251,SESC,907,06,9,14,0,0,0,0,0,0,0,0,0,0,0,0,0,0,0,0,0,0,14,9,23,23
20192020,026,CLAY,125,Clay County,200,Goose Rock Elementary,125200,026125200,210123000251,SESC,907,05,20,19,0,1,1,0,0,0,0,0,0,0,0,0,0,0,0,0,0,0,19,19,38,39
20192020,026,CLAY,125,Clay County,200,Goose Rock Elementary,125200,026125200,210123000251,SESC,907,All Students,91,111,1,1,2,0,0,0,0,0,0,0,0,0,0,0,0,0,0,0,110,90,200,202
20192020,026,CLAY,125,Clay County,200,Goose Rock Elementary,125200,026125200,210123000251,SESC,907,PS,12,8,0,0,0,0,0,0,0,0,0,0,0,0,0,0,0,0,0,0,8,12,20,20
20192020,026,CLAY,125,Clay County,200,Goose Rock Elementary,125200,026125200,210123000251,SESC,907,KG,10,16,0,0,0,0,0,0,0,0,0,0,0,0,0,0,0,0,0,0,16,10,26,26
20192020,026,CLAY,125,Clay County,200,Goose Rock Elementary,125200,026125200,210123000251,SESC,907,01,17,15,0,0,0,0,0,0,0,0,0,0,0,0,0,0,0,0,0,0,15,17,32,32
20192020,026,CLAY,125,Clay County,200,Goose Rock Elementary,125200,026125200,210123000251,SESC,907,02,14,16,0,0,0,0,0,0,0,0,0,0,0,0,0,0,0,0,0,0,16,14,30,30
20192020,026,CLAY,125,Clay County,200,Goose Rock Elementary,125200,026125200,210123000251,SESC,907,03,12,13,0,0,0,0,0,0,0,0,0,0,0,0,0,0,0,0,0,0,13,12,25,25
20192020,026,CLAY,125,Clay County,200,Goose Rock Elementary,125200,026125200,210123000251,SESC,907,04,9,18,1,0,1,0,0,0,0,0,0,0,0,0,0,0,0,0,0,0,17,9,26,27
20192020,026,CLAY,125,Clay County,220,Hacker Elementary School,125220,026125220,210123000252,SESC,907,05,14,22,0,0,0,0,0,0,0,0,0,2,0,2,0,0,0,0,0,0,20,14,34,36
20192020,026,CLAY,125,Clay County,220,Hacker Elementary School,125220,026125220,210123000252,SESC,907,All Students,140,159,0,0,0,0,1,1,1,1,2,2,1,3,0,0,0,1,1,2,155,136,291,299
20192020,026,CLAY,125,Clay County,220,Hacker Elementary School,125220,026125220,210123000252,SESC,907,PS,15,5,0,0,0,0,0,0,0,0,0,0,0,0,0,0,0,0,0,0,5,15,20,20
20192020,026,CLAY,125,Clay County,220,Hacker Elementary School,125220,026125220,210123000252,SESC,907,KG,23,21,0,0,0,0,1,1,0,0,0,0,0,0,0,0,0,1,0,1,20,22,42,44
20192020,026,CLAY,125,Clay County,220,Hacker Elementary School,125220,026125220,210123000252,SESC,907,01,22,23,0,0,0,0,0,0,0,0,0,0,0,0,0,0,0,0,0,0,23,22,45,45
20192020,026,CLAY,125,Clay County,220,Hacker Elementary School,125220,026125220,210123000252,SESC,907,02,14,21,0,0,0,0,0,0,0,0,0,0,0,0,0,0,0,0,1,1,21,13,34,35
20192020,026,CLAY,125,Clay County,220,Hacker Elementary School,125220,026125220,210123000252,SESC,907,03,20,26,0,0,0,0,0,0,1,0,1,0,0,0,0,0,0,0,0,0,25,20,45,46
20192020,026,CLAY,125,Clay County,220,Hacker Elementary School,125220,026125220,210123000252,SESC,907,04,27,14,0,0,0,0,0,0,0,1,1,0,0,0,0,0,0,0,0,0,14,26,40,41
20192020,026,CLAY,125,Clay County,220,Hacker Elementary School,125220,026125220,210123000252,SESC,907,06,20,32,0,0,0,0,0,0,0,0,0,0,1,1,0,0,0,0,0,0,32,19,51,52
20192020,026,CLAY,125,Clay County,500,Manchester Elementary School,125500,026125500,210123000255,SESC,907,05,40,27,0,0,0,0,0,0,0,0,0,0,0,0,0,0,0,0,2,2,27,38,65,67
20192020,026,CLAY,125,Clay County,500,Manchester Elementary School,125500,026125500,210123000255,SESC,907,All Students,198,205,8,4,12,0,0,0,2,0,2,1,3,4,1,1,2,2,2,4,191,188,379,403
20192020,026,CLAY,125,Clay County,500,Manchester Elementary School,125500,026125500,210123000255,SESC,907,PS,22,16,0,1,1,0,0,0,0,0,0,0,0,0,0,0,0,0,1,1,16,20,36,38
20192020,026,CLAY,125,Clay County,500,Manchester Elementary School,125500,026125500,210123000255,SESC,907,KG,29,29,0,0,0,0,0,0,0,0,0,0,0,0,0,0,0,1,0,1,28,29,57,58
20192020,026,CLAY,125,Clay County,500,Manchester Elementary School,125500,026125500,210123000255,SESC,907,01,22,33,2,2,4,0,0,0,0,0,0,0,1,1,0,0,0,0,0,0,31,19,50,55
20192020,026,CLAY,125,Clay County,500,Manchester Elementary School,125500,026125500,210123000255,SESC,907,02,29,28,1,1,2,0,0,0,0,0,0,0,1,1,0,0,0,0,0,0,27,27,54,57
20192020,026,CLAY,125,Clay County,500,Manchester Elementary School,125500,026125500,210123000255,SESC,907,03,27,30,1,1,2,0,0,0,1,0,1,0,0,0,0,0,0,0,0,0,28,26,54,57
20192020,026,CLAY,125,Clay County,500,Manchester Elementary School,125500,026125500,210123000255,SESC,907,04,23,36,3,0,3,0,0,0,0,0,0,1,0,1,1,1,2,1,0,1,30,22,52,59
20192020,026,CLAY,125,Clay County,500,Manchester Elementary School,125500,026125500,210123000255,SESC,907,06,28,22,1,0,1,0,0,0,1,0,1,0,1,1,0,0,0,0,0,0,20,27,47,50
20192020,026,CLAY,125,Clay County,570,Oneida Elementary School,125570,026125570,210123000256,SESC,907,05,6,5,0,0,0,0,0,0,0,0,0,0,0,0,0,0,0,0,0,0,5,6,11,11
20192020,026,CLAY,125,Clay County,570,Oneida Elementary School,125570,026125570,210123000256,SESC,907,All Students,37,53,1,0,1,0,0,0,0,0,0,0,0,0,0,0,0,0,0,0,52,37,89,90
20192020,026,CLAY,125,Clay County,570,Oneida Elementary School,125570,026125570,210123000256,SESC,907,PS,8,8,0,0,0,0,0,0,0,0,0,1,0,1,0,0,0,0,0,0,7,8,15,16
20192020,026,CLAY,125,Clay County,570,Oneida Elementary School,125570,026125570,210123000256,SESC,907,KG,5,8,0,0,0,0,0,0,0,0,0,0,0,0,0,0,0,0,0,0,8,5,13,13
20192020,026,CLAY,125,Clay County,570,Oneida Elementary School,125570,026125570,210123000256,SESC,907,01,6,11,0,0,0,0,0,0,0,0,0,0,0,0,0,0,0,0,0,0,11,6,17,17
20192020,026,CLAY,125,Clay County,570,Oneida Elementary School,125570,026125570,210123000256,SESC,907,02,4,8,0,0,0,0,0,0,0,0,0,0,0,0,0,0,0,0,0,0,8,4,12,12
20192020,026,CLAY,125,Clay County,570,Oneida Elementary School,125570,026125570,210123000256,SESC,907,03,8,9,0,0,0,0,0,0,0,0,0,0,0,0,0,0,0,0,0,0,9,8,17,17
20192020,026,CLAY,125,Clay County,570,Oneida Elementary School,125570,026125570,210123000256,SESC,907,04,3,5,0,0,0,0,0,0,0,0,0,0,0,0,0,0,0,0,0,0,5,3,8,8
20192020,026,CLAY,125,Clay County,570,Oneida Elementary School,125570,026125570,210123000256,SESC,907,06,5,7,1,0,1,0,0,0,0,0,0,0,0,0,0,0,0,0,0,0,6,5,11,12
20192020,026,CLAY,125,Clay County,580,Paces Creek Elementary,125580,026125580,210123001413,SESC,907,06,15,28,0,0,0,0,0,0,0,0,0,1,0,1,0,0,0,0,0,0,27,15,42,43
20192020,026,CLAY,125,Clay County,580,Paces Creek Elementary,125580,026125580,210123001413,SESC,907,All Students,132,142,0,0,0,0,0,0,0,0,0,2,1,3,0,0,0,0,3,3,140,128,268,274
20192020,026,CLAY,125,Clay County,580,Paces Creek Elementary,125580,026125580,210123001413,SESC,907,KG,22,15,0,0,0,0,0,0,0,0,0,0,0,0,0,0,0,0,0,0,15,22,37,37
20192020,026,CLAY,125,Clay County,580,Paces Creek Elementary,125580,026125580,210123001413,SESC,907,01,20,20,0,0,0,0,0,0,0,0,0,0,0,0,0,0,0,0,2,2,20,18,38,40
20192020,026,CLAY,125,Clay County,580,Paces Creek Elementary,125580,026125580,210123001413,SESC,907,02,19,13,0,0,0,0,0,0,0,0,0,0,0,0,0,0,0,0,0,0,13,19,32,32
20192020,026,CLAY,125,Clay County,580,Paces Creek Elementary,125580,026125580,210123001413,SESC,907,03,18,25,0,0,0,0,0,0,0,0,0,0,0,0,0,0,0,0,0,0,25,18,43,43
20192020,026,CLAY,125,Clay County,580,Paces Creek Elementary,125580,026125580,210123001413,SESC,907,04,15,25,0,0,0,0,0,0,0,0,0,0,0,0,0,0,0,0,0,0,25,15,40,40
20192020,026,CLAY,125,Clay County,580,Paces Creek Elementary,125580,026125580,210123001413,SESC,907,05,23,16,0,0,0,0,0,0,0,0,0,1,1,2,0,0,0,0,1,1,15,21,36,39
20192020,027,CLINTON,131,Clinton County,"",---District Total---,131,"","",GRREC,902,PS,81,73,2,0,2,0,0,0,0,1,1,2,4,6,0,0,0,3,2,5,66,74,140,154
20192020,027,CLINTON,131,Clinton County,"",---District Total---,131,"","",GRREC,902,All Students,757,808,11,3,14,2,0,2,0,0,0,59,44,103,1,1,2,3,2,5,732,707,1439,1565
20192020,027,CLINTON,131,Clinton County,"",---District Total---,131,"","",GRREC,902,KG,57,55,0,0,0,0,0,0,0,0,0,5,4,9,0,0,0,1,0,1,49,53,102,112
20192020,027,CLINTON,131,Clinton County,"",---District Total---,131,"","",GRREC,902,01,74,67,0,1,1,0,0,0,0,0,0,0,3,3,0,0,0,1,0,1,66,70,136,141
20192020,027,CLINTON,131,Clinton County,"",---District Total---,131,"","",GRREC,902,02,64,51,0,0,0,1,0,1,0,0,0,2,4,6,0,0,0,0,0,0,48,60,108,115
20192020,027,CLINTON,131,Clinton County,"",---District Total---,131,"","",GRREC,902,03,55,47,0,0,0,0,0,0,0,0,0,5,2,7,0,0,0,0,1,1,42,52,94,102
20192020,027,CLINTON,131,Clinton County,"",---District Total---,131,"","",GRREC,902,04,55,56,0,1,1,0,0,0,0,0,0,8,3,11,1,0,1,0,0,0,47,51,98,111
20192020,027,CLINTON,131,Clinton County,"",---District Total---,131,"","",GRREC,902,05,67,54,1,0,1,0,0,0,0,0,0,9,3,12,0,0,0,0,0,0,44,64,108,121
20192020,027,CLINTON,131,Clinton County,"",---District Total---,131,"","",GRREC,902,06,54,82,0,1,1,0,0,0,0,0,0,3,7,10,0,0,0,0,0,0,79,46,125,136
20192020,027,CLINTON,131,Clinton County,"",---District Total---,131,"","",GRREC,902,07,67,66,0,0,0,0,0,0,0,0,0,3,4,7,0,1,1,1,0,1,62,62,124,133
20192020,027,CLINTON,131,Clinton County,"",---District Total---,131,"","",GRREC,902,08,46,66,3,0,3,0,0,0,0,0,0,0,5,5,0,0,0,0,0,0,63,41,104,112
20192020,027,CLINTON,131,Clinton County,"",---District Total---,131,"","",GRREC,902,09,57,81,3,0,3,0,0,0,0,0,0,8,2,10,0,0,0,0,0,0,70,55,125,138
20192020,027,CLINTON,131,Clinton County,"",---District Total---,131,"","",GRREC,902,10,49,75,4,0,4,0,0,0,0,0,0,7,3,10,0,0,0,0,0,0,64,46,110,124
20192020,027,CLINTON,131,Clinton County,"",---District Total---,131,"","",GRREC,902,11,60,57,0,0,0,0,0,0,0,0,0,4,3,7,0,0,0,0,1,1,53,56,109,117
20192020,027,CLINTON,131,Clinton County,"",---District Total---,131,"","",GRREC,902,12,51,51,0,0,0,1,0,1,0,0,0,5,1,6,0,0,0,0,0,0,45,50,95,102
20192020,027,CLINTON,131,Clinton County,"",---District Total---,131,"","",GRREC,902,14,1,0,0,0,0,0,0,0,0,0,0,0,0,0,0,0,0,0,0,0,0,1,1,1
20192020,027,CLINTON,131,Clinton County,015,Albany Elementary School,131015,027131015,210126000257,GRREC,902,KG,0,1,0,0,0,0,0,0,0,0,0,0,0,0,0,0,0,0,0,0,1,0,1,1
20192020,027,CLINTON,131,Clinton County,015,Albany Elementary School,131015,027131015,210126000257,GRREC,902,01,71,59,0,1,1,0,0,0,0,0,0,0,3,3,0,0,0,1,0,1,58,67,125,130
20192020,027,CLINTON,131,Clinton County,015,Albany Elementary School,131015,027131015,210126000257,GRREC,902,All Students,245,214,0,2,2,1,0,1,0,0,0,15,12,27,1,0,1,1,1,2,196,230,426,459
20192020,027,CLINTON,131,Clinton County,015,Albany Elementary School,131015,027131015,210126000257,GRREC,902,02,64,51,0,0,0,1,0,1,0,0,0,2,4,6,0,0,0,0,0,0,48,60,108,115
20192020,027,CLINTON,131,Clinton County,015,Albany Elementary School,131015,027131015,210126000257,GRREC,902,03,55,47,0,0,0,0,0,0,0,0,0,5,2,7,0,0,0,0,1,1,42,52,94,102
20192020,027,CLINTON,131,Clinton County,015,Albany Elementary School,131015,027131015,210126000257,GRREC,902,04,55,56,0,1,1,0,0,0,0,0,0,8,3,11,1,0,1,0,0,0,47,51,98,111
20192020,027,CLINTON,131,Clinton County,016,Foothills Academy,131016,027131016,210126002162,GRREC,902,09,0,18,2,0,2,0,0,0,0,0,0,3,0,3,0,0,0,0,0,0,13,0,13,18
20192020,027,CLINTON,131,Clinton County,016,Foothills Academy,131016,027131016,210126002162,GRREC,902,11,0,5,0,0,0,0,0,0,0,0,0,0,0,0,0,0,0,0,0,0,5,0,5,5
20192020,027,CLINTON,131,Clinton County,016,Foothills Academy,131016,027131016,210126002162,GRREC,902,10,0,20,4,0,4,0,0,0,0,0,0,3,0,3,0,0,0,0,0,0,13,0,13,20
20192020,027,CLINTON,131,Clinton County,016,Foothills Academy,131016,027131016,210126002162,GRREC,902,12,0,5,0,0,0,0,0,0,0,0,0,2,0,2,0,0,0,0,0,0,3,0,3,5
20192020,027,CLINTON,131,Clinton County,016,Foothills Academy,131016,027131016,210126002162,GRREC,902,All Students,0,64,9,0,9,0,0,0,0,0,0,8,0,8,0,0,0,0,0,0,47,0,47,64
20192020,027,CLINTON,131,Clinton County,016,Foothills Academy,131016,027131016,210126002162,GRREC,902,06,0,1,0,0,0,0,0,0,0,0,0,0,0,0,0,0,0,0,0,0,1,0,1,1
20192020,027,CLINTON,131,Clinton County,016,Foothills Academy,131016,027131016,210126002162,GRREC,902,07,0,2,0,0,0,0,0,0,0,0,0,0,0,0,0,0,0,0,0,0,2,0,2,2
20192020,027,CLINTON,131,Clinton County,016,Foothills Academy,131016,027131016,210126002162,GRREC,902,08,0,13,3,0,3,0,0,0,0,0,0,0,0,0,0,0,0,0,0,0,10,0,10,13
20192020,027,CLINTON,131,Clinton County,020,Clinton County Early Childhood Center,131020,027131020,210126002228,GRREC,902,PS,81,73,2,0,2,0,0,0,0,1,1,2,4,6,0,0,0,3,2,5,66,74,140,154
20192020,027,CLINTON,131,Clinton County,020,Clinton County Early Childhood Center,131020,027131020,210126002228,GRREC,902,KG,57,54,0,0,0,0,0,0,0,0,0,5,4,9,0,0,0,1,0,1,48,53,101,111
20192020,027,CLINTON,131,Clinton County,020,Clinton County Early Childhood Center,131020,027131020,210126002228,GRREC,902,All Students,60,62,0,0,0,0,0,0,0,0,0,5,4,9,0,0,0,1,0,1,56,56,112,122
20192020,027,CLINTON,131,Clinton County,020,Clinton County Early Childhood Center,131020,027131020,210126002228,GRREC,902,01,3,8,0,0,0,0,0,0,0,0,0,0,0,0,0,0,0,0,0,0,8,3,11,11
20192020,027,CLINTON,131,Clinton County,045,Clinton County Middle School,131045,027131045,210126000444,GRREC,902,05,67,54,1,0,1,0,0,0,0,0,0,9,3,12,0,0,0,0,0,0,44,64,108,121
20192020,027,CLINTON,131,Clinton County,045,Clinton County Middle School,131045,027131045,210126000444,GRREC,902,All Students,234,252,1,1,2,0,0,0,0,0,0,15,19,34,0,1,1,1,0,1,235,213,448,486
20192020,027,CLINTON,131,Clinton County,045,Clinton County Middle School,131045,027131045,210126000444,GRREC,902,06,54,81,0,1,1,0,0,0,0,0,0,3,7,10,0,0,0,0,0,0,78,46,124,135
20192020,027,CLINTON,131,Clinton County,045,Clinton County Middle School,131045,027131045,210126000444,GRREC,902,07,67,64,0,0,0,0,0,0,0,0,0,3,4,7,0,1,1,1,0,1,60,62,122,131
20192020,027,CLINTON,131,Clinton County,045,Clinton County Middle School,131045,027131045,210126000444,GRREC,902,08,46,53,0,0,0,0,0,0,0,0,0,0,5,5,0,0,0,0,0,0,53,41,94,99
20192020,027,CLINTON,131,Clinton County,050,Clinton County High School,131050,027131050,210126000259,GRREC,902,10,49,55,0,0,0,0,0,0,0,0,0,4,3,7,0,0,0,0,0,0,51,46,97,104
20192020,027,CLINTON,131,Clinton County,050,Clinton County High School,131050,027131050,210126000259,GRREC,902,11,60,52,0,0,0,0,0,0,0,0,0,4,3,7,0,0,0,0,1,1,48,56,104,112
20192020,027,CLINTON,131,Clinton County,050,Clinton County High School,131050,027131050,210126000259,GRREC,902,12,51,46,0,0,0,1,0,1,0,0,0,3,1,4,0,0,0,0,0,0,42,50,92,97
20192020,027,CLINTON,131,Clinton County,050,Clinton County High School,131050,027131050,210126000259,GRREC,902,14,1,0,0,0,0,0,0,0,0,0,0,0,0,0,0,0,0,0,0,0,0,1,1,1
20192020,027,CLINTON,131,Clinton County,050,Clinton County High School,131050,027131050,210126000259,GRREC,902,All Students,218,216,1,0,1,1,0,1,0,0,0,16,9,25,0,0,0,0,1,1,198,208,406,434
20192020,027,CLINTON,131,Clinton County,050,Clinton County High School,131050,027131050,210126000259,GRREC,902,09,57,63,1,0,1,0,0,0,0,0,0,5,2,7,0,0,0,0,0,0,57,55,112,120
20192020,014,BRECKINRIDGE,132,Cloverport Independent,"",---District Total---,132,"","",GRREC,902,03,7,9,0,0,0,0,0,0,0,0,0,0,0,0,0,0,0,0,0,0,9,7,16,16
20192020,014,BRECKINRIDGE,132,Cloverport Independent,"",---District Total---,132,"","",GRREC,902,04,7,9,0,0,0,0,0,0,0,0,0,0,0,0,0,0,0,0,0,0,9,7,16,16
20192020,014,BRECKINRIDGE,132,Cloverport Independent,"",---District Total---,132,"","",GRREC,902,05,17,23,0,1,1,0,0,0,0,0,0,0,0,0,0,0,0,0,0,0,23,16,39,40
20192020,014,BRECKINRIDGE,132,Cloverport Independent,"",---District Total---,132,"","",GRREC,902,06,14,9,0,0,0,0,0,0,0,0,0,0,0,0,0,0,0,0,0,0,9,14,23,23
20192020,014,BRECKINRIDGE,132,Cloverport Independent,"",---District Total---,132,"","",GRREC,902,07,11,18,2,0,2,0,0,0,0,0,0,1,0,1,0,0,0,1,1,2,14,10,24,29
20192020,014,BRECKINRIDGE,132,Cloverport Independent,"",---District Total---,132,"","",GRREC,902,08,16,11,0,1,1,0,0,0,0,0,0,0,0,0,0,0,0,0,0,0,11,15,26,27
20192020,014,BRECKINRIDGE,132,Cloverport Independent,"",---District Total---,132,"","",GRREC,902,09,15,15,0,1,1,0,0,0,0,0,0,0,0,0,0,0,0,0,0,0,15,14,29,30
20192020,014,BRECKINRIDGE,132,Cloverport Independent,"",---District Total---,132,"","",GRREC,902,10,10,16,0,0,0,0,0,0,0,0,0,0,0,0,0,0,0,0,0,0,16,10,26,26
20192020,014,BRECKINRIDGE,132,Cloverport Independent,"",---District Total---,132,"","",GRREC,902,12,11,12,0,0,0,0,0,0,0,0,0,0,0,0,0,0,0,0,0,0,12,11,23,23
20192020,014,BRECKINRIDGE,132,Cloverport Independent,"",---District Total---,132,"","",GRREC,902,11,14,16,2,1,3,0,0,0,0,0,0,0,1,1,0,0,0,1,0,1,13,12,25,30
20192020,014,BRECKINRIDGE,132,Cloverport Independent,"",---District Total---,132,"","",GRREC,902,All Students,148,164,5,4,9,0,0,0,0,0,0,1,1,2,0,0,0,4,2,6,154,141,295,312
20192020,014,BRECKINRIDGE,132,Cloverport Independent,"",---District Total---,132,"","",GRREC,902,PS,8,10,0,0,0,0,0,0,0,0,0,0,0,0,0,0,0,0,0,0,10,8,18,18
20192020,014,BRECKINRIDGE,132,Cloverport Independent,"",---District Total---,132,"","",GRREC,902,KG,5,7,0,0,0,0,0,0,0,0,0,0,0,0,0,0,0,1,0,1,6,5,11,12
20192020,014,BRECKINRIDGE,132,Cloverport Independent,"",---District Total---,132,"","",GRREC,902,01,12,8,1,0,1,0,0,0,0,0,0,0,0,0,0,0,0,0,1,1,7,11,18,20
20192020,014,BRECKINRIDGE,132,Cloverport Independent,"",---District Total---,132,"","",GRREC,902,02,9,11,0,0,0,0,0,0,0,0,0,0,0,0,0,0,0,1,0,1,10,9,19,20
20192020,014,BRECKINRIDGE,132,Cloverport Independent,010,Frederick Fraize High School,132010,014132010,210129000261,GRREC,902,11,14,16,2,1,3,0,0,0,0,0,0,0,1,1,0,0,0,1,0,1,13,12,25,30
20192020,014,BRECKINRIDGE,132,Cloverport Independent,010,Frederick Fraize High School,132010,014132010,210129000261,GRREC,902,All Students,50,59,2,2,4,0,0,0,0,0,0,0,1,1,0,0,0,1,0,1,56,47,103,109
20192020,014,BRECKINRIDGE,132,Cloverport Independent,010,Frederick Fraize High School,132010,014132010,210129000261,GRREC,902,09,15,15,0,1,1,0,0,0,0,0,0,0,0,0,0,0,0,0,0,0,15,14,29,30
20192020,014,BRECKINRIDGE,132,Cloverport Independent,010,Frederick Fraize High School,132010,014132010,210129000261,GRREC,902,10,10,16,0,0,0,0,0,0,0,0,0,0,0,0,0,0,0,0,0,0,16,10,26,26
20192020,014,BRECKINRIDGE,132,Cloverport Independent,010,Frederick Fraize High School,132010,014132010,210129000261,GRREC,902,12,11,12,0,0,0,0,0,0,0,0,0,0,0,0,0,0,0,0,0,0,12,11,23,23
20192020,014,BRECKINRIDGE,132,Cloverport Independent,020,William H Natcher Elementary School,132020,014132020,210129000262,GRREC,902,04,7,9,0,0,0,0,0,0,0,0,0,0,0,0,0,0,0,0,0,0,9,7,16,16
20192020,014,BRECKINRIDGE,132,Cloverport Independent,020,William H Natcher Elementary School,132020,014132020,210129000262,GRREC,902,All Students,57,67,1,1,2,0,0,0,0,0,0,0,0,0,0,0,0,2,1,3,64,55,119,124
20192020,014,BRECKINRIDGE,132,Cloverport Independent,020,William H Natcher Elementary School,132020,014132020,210129000262,GRREC,902,PS,8,10,0,0,0,0,0,0,0,0,0,0,0,0,0,0,0,0,0,0,10,8,18,18
20192020,014,BRECKINRIDGE,132,Cloverport Independent,020,William H Natcher Elementary School,132020,014132020,210129000262,GRREC,902,KG,5,7,0,0,0,0,0,0,0,0,0,0,0,0,0,0,0,1,0,1,6,5,11,12
20192020,014,BRECKINRIDGE,132,Cloverport Independent,020,William H Natcher Elementary School,132020,014132020,210129000262,GRREC,902,01,12,8,1,0,1,0,0,0,0,0,0,0,0,0,0,0,0,0,1,1,7,11,18,20
20192020,014,BRECKINRIDGE,132,Cloverport Independent,020,William H Natcher Elementary School,132020,014132020,210129000262,GRREC,902,02,9,11,0,0,0,0,0,0,0,0,0,0,0,0,0,0,0,1,0,1,10,9,19,20
20192020,014,BRECKINRIDGE,132,Cloverport Independent,020,William H Natcher Elementary School,132020,014132020,210129000262,GRREC,902,03,7,9,0,0,0,0,0,0,0,0,0,0,0,0,0,0,0,0,0,0,9,7,16,16
20192020,014,BRECKINRIDGE,132,Cloverport Independent,020,William H Natcher Elementary School,132020,014132020,210129000262,GRREC,902,05,17,23,0,1,1,0,0,0,0,0,0,0,0,0,0,0,0,0,0,0,23,16,39,40
20192020,014,BRECKINRIDGE,132,Cloverport Independent,025,Frederick Fraize Middle School,132025,014132025,210129000907,GRREC,902,07,11,18,2,0,2,0,0,0,0,0,0,1,0,1,0,0,0,1,1,2,14,10,24,29
20192020,014,BRECKINRIDGE,132,Cloverport Independent,025,Frederick Fraize Middle School,132025,014132025,210129000907,GRREC,902,All Students,41,38,2,1,3,0,0,0,0,0,0,1,0,1,0,0,0,1,1,2,34,39,73,79
20192020,014,BRECKINRIDGE,132,Cloverport Independent,025,Frederick Fraize Middle School,132025,014132025,210129000907,GRREC,902,06,14,9,0,0,0,0,0,0,0,0,0,0,0,0,0,0,0,0,0,0,9,14,23,23
20192020,014,BRECKINRIDGE,132,Cloverport Independent,025,Frederick Fraize Middle School,132025,014132025,210129000907,GRREC,902,08,16,11,0,1,1,0,0,0,0,0,0,0,0,0,0,0,0,0,0,0,11,15,26,27
20192020,118,WHITLEY,133,Corbin Independent,"",---District Total---,133,"","",SESC,907,11,124,125,0,0,0,1,0,1,0,2,2,5,1,6,0,0,0,2,2,4,117,119,236,249
20192020,118,WHITLEY,133,Corbin Independent,"",---District Total---,133,"","",SESC,907,All Students,1396,1498,2,2,4,2,0,2,9,12,21,42,49,91,1,1,2,18,16,34,1424,1316,2740,2894
20192020,118,WHITLEY,133,Corbin Independent,"",---District Total---,133,"","",SESC,907,PS,57,72,1,0,1,0,0,0,1,1,2,2,1,3,0,0,0,1,1,2,67,54,121,129
20192020,118,WHITLEY,133,Corbin Independent,"",---District Total---,133,"","",SESC,907,KG,80,72,0,1,1,0,0,0,1,2,3,3,4,7,0,0,0,0,0,0,68,73,141,152
20192020,118,WHITLEY,133,Corbin Independent,"",---District Total---,133,"","",SESC,907,01,107,118,1,1,2,0,0,0,1,2,3,5,0,5,0,0,0,2,4,6,109,100,209,225
20192020,118,WHITLEY,133,Corbin Independent,"",---District Total---,133,"","",SESC,907,02,87,93,0,0,0,0,0,0,0,0,0,3,3,6,1,0,1,0,0,0,89,84,173,180
20192020,118,WHITLEY,133,Corbin Independent,"",---District Total---,133,"","",SESC,907,03,88,114,0,0,0,0,0,0,0,0,0,6,3,9,0,0,0,1,0,1,107,85,192,202
20192020,118,WHITLEY,133,Corbin Independent,"",---District Total---,133,"","",SESC,907,04,103,99,0,0,0,0,0,0,0,0,0,0,3,3,0,0,0,0,0,0,99,100,199,202
20192020,118,WHITLEY,133,Corbin Independent,"",---District Total---,133,"","",SESC,907,05,87,101,1,0,1,0,0,0,0,0,0,2,1,3,0,0,0,1,1,2,97,85,182,188
20192020,118,WHITLEY,133,Corbin Independent,"",---District Total---,133,"","",SESC,907,06,112,137,0,0,0,0,0,0,0,0,0,4,7,11,0,0,0,2,1,3,131,104,235,249
20192020,118,WHITLEY,133,Corbin Independent,"",---District Total---,133,"","",SESC,907,07,124,122,0,0,0,0,0,0,1,0,1,2,5,7,0,0,0,1,2,3,118,117,235,246
20192020,118,WHITLEY,133,Corbin Independent,"",---District Total---,133,"","",SESC,907,08,109,138,0,0,0,0,0,0,1,0,1,2,7,9,0,1,1,2,2,4,133,99,232,247
20192020,118,WHITLEY,133,Corbin Independent,"",---District Total---,133,"","",SESC,907,09,107,134,0,0,0,0,0,0,4,0,4,5,6,11,0,0,0,2,1,3,123,100,223,241
20192020,118,WHITLEY,133,Corbin Independent,"",---District Total---,133,"","",SESC,907,10,134,139,0,0,0,1,0,1,0,3,3,2,4,6,0,0,0,3,3,6,133,124,257,273
20192020,118,WHITLEY,133,Corbin Independent,"",---District Total---,133,"","",SESC,907,12,133,106,0,0,0,0,0,0,1,3,4,3,5,8,0,0,0,2,0,2,100,125,225,239
20192020,118,WHITLEY,133,Corbin Independent,"",---District Total---,133,"","",SESC,907,14,1,0,0,0,0,0,0,0,0,0,0,0,0,0,0,0,0,0,0,0,0,1,1,1
20192020,118,WHITLEY,133,Corbin Independent,012,Corbin Educational Center,133012,118133012,210132001622,SESC,907,12,1,3,0,0,0,0,0,0,0,0,0,0,0,0,0,0,0,0,0,0,3,1,4,4
20192020,118,WHITLEY,133,Corbin Independent,012,Corbin Educational Center,133012,118133012,210132001622,SESC,907,All Students,16,32,0,0,0,1,0,1,0,0,0,0,0,0,0,0,0,0,1,1,31,15,46,48
20192020,118,WHITLEY,133,Corbin Independent,012,Corbin Educational Center,133012,118133012,210132001622,SESC,907,04,0,2,0,0,0,0,0,0,0,0,0,0,0,0,0,0,0,0,0,0,2,0,2,2
20192020,118,WHITLEY,133,Corbin Independent,012,Corbin Educational Center,133012,118133012,210132001622,SESC,907,05,0,1,0,0,0,0,0,0,0,0,0,0,0,0,0,0,0,0,0,0,1,0,1,1
20192020,118,WHITLEY,133,Corbin Independent,012,Corbin Educational Center,133012,118133012,210132001622,SESC,907,06,1,5,0,0,0,0,0,0,0,0,0,0,0,0,0,0,0,0,0,0,5,1,6,6
20192020,118,WHITLEY,133,Corbin Independent,012,Corbin Educational Center,133012,118133012,210132001622,SESC,907,07,1,4,0,0,0,0,0,0,0,0,0,0,0,0,0,0,0,0,0,0,4,1,5,5
20192020,118,WHITLEY,133,Corbin Independent,012,Corbin Educational Center,133012,118133012,210132001622,SESC,907,08,2,6,0,0,0,0,0,0,0,0,0,0,0,0,0,0,0,0,0,0,6,2,8,8
20192020,118,WHITLEY,133,Corbin Independent,012,Corbin Educational Center,133012,118133012,210132001622,SESC,907,09,2,2,0,0,0,0,0,0,0,0,0,0,0,0,0,0,0,0,0,0,2,2,4,4
20192020,118,WHITLEY,133,Corbin Independent,012,Corbin Educational Center,133012,118133012,210132001622,SESC,907,10,5,6,0,0,0,1,0,1,0,0,0,0,0,0,0,0,0,0,1,1,5,4,9,11
20192020,118,WHITLEY,133,Corbin Independent,012,Corbin Educational Center,133012,118133012,210132001622,SESC,907,11,4,3,0,0,0,0,0,0,0,0,0,0,0,0,0,0,0,0,0,0,3,4,7,7
20192020,118,WHITLEY,133,Corbin Independent,016,Corbin Preschool,133016,118133016,210132001982,SESC,907,All Students,0,0,0,0,0,0,0,0,0,0,0,0,0,0,0,0,0,0,0,0,0,0,0,0
20192020,118,WHITLEY,133,Corbin Independent,016,Corbin Preschool,133016,118133016,210132001982,SESC,907,PS,57,72,1,0,1,0,0,0,1,1,2,2,1,3,0,0,0,1,1,2,67,54,121,129
20192020,118,WHITLEY,133,Corbin Independent,019,CORBIN ELEMENTARY SCHOOL,133019,118133019,210132002489,SESC,907,04,101,97,0,0,0,0,0,0,0,0,0,0,3,3,0,0,0,0,0,0,97,98,195,198
20192020,118,WHITLEY,133,Corbin Independent,019,CORBIN ELEMENTARY SCHOOL,133019,118133019,210132002489,SESC,907,All Students,183,192,1,0,1,0,0,0,0,0,0,2,4,6,0,0,0,1,1,2,188,178,366,375
20192020,118,WHITLEY,133,Corbin Independent,019,CORBIN ELEMENTARY SCHOOL,133019,118133019,210132002489,SESC,907,05,82,95,1,0,1,0,0,0,0,0,0,2,1,3,0,0,0,1,1,2,91,80,171,177
20192020,118,WHITLEY,133,Corbin Independent,040,Corbin High School,133040,118133040,210132000266,SESC,907,12,102,92,0,0,0,0,0,0,1,3,4,3,3,6,0,0,0,1,0,1,87,96,183,194
20192020,118,WHITLEY,133,Corbin Independent,040,Corbin High School,133040,118133040,210132000266,SESC,907,All Students,430,460,0,0,0,1,0,1,5,8,13,15,14,29,0,0,0,8,5,13,431,403,834,890
20192020,118,WHITLEY,133,Corbin Independent,040,Corbin High School,133040,118133040,210132000266,SESC,907,08,0,1,0,0,0,0,0,0,0,0,0,0,0,0,0,0,0,0,0,0,1,0,1,1
20192020,118,WHITLEY,133,Corbin Independent,040,Corbin High School,133040,118133040,210132000266,SESC,907,09,100,125,0,0,0,0,0,0,4,0,4,5,6,11,0,0,0,2,1,3,114,93,207,225
20192020,118,WHITLEY,133,Corbin Independent,040,Corbin High School,133040,118133040,210132000266,SESC,907,10,117,125,0,0,0,0,0,0,0,3,3,2,4,6,0,0,0,3,2,5,120,108,228,242
20192020,118,WHITLEY,133,Corbin Independent,040,Corbin High School,133040,118133040,210132000266,SESC,907,11,110,117,0,0,0,1,0,1,0,2,2,5,1,6,0,0,0,2,2,4,109,105,214,227
20192020,118,WHITLEY,133,Corbin Independent,040,Corbin High School,133040,118133040,210132000266,SESC,907,14,1,0,0,0,0,0,0,0,0,0,0,0,0,0,0,0,0,0,0,0,0,1,1,1
20192020,118,WHITLEY,133,Corbin Independent,050,Corbin Middle School,133050,118133050,210132001414,SESC,907,07,121,117,0,0,0,0,0,0,1,0,1,2,5,7,0,0,0,1,2,3,113,114,227,238
20192020,118,WHITLEY,133,Corbin Independent,050,Corbin Middle School,133050,118133050,210132001414,SESC,907,All Students,334,373,0,0,0,0,0,0,2,0,2,8,18,26,0,1,1,5,5,10,358,310,668,707
20192020,118,WHITLEY,133,Corbin Independent,050,Corbin Middle School,133050,118133050,210132001414,SESC,907,06,109,130,0,0,0,0,0,0,0,0,0,4,7,11,0,0,0,2,1,3,124,101,225,239
20192020,118,WHITLEY,133,Corbin Independent,050,Corbin Middle School,133050,118133050,210132001414,SESC,907,08,104,126,0,0,0,0,0,0,1,0,1,2,6,8,0,1,1,2,2,4,121,95,216,230
20192020,118,WHITLEY,133,Corbin Independent,070,Corbin Primary,133070,118133070,210132002218,SESC,907,KG,80,72,0,1,1,0,0,0,1,2,3,3,4,7,0,0,0,0,0,0,68,73,141,152
20192020,118,WHITLEY,133,Corbin Independent,070,Corbin Primary,133070,118133070,210132002218,SESC,907,All Students,362,397,1,2,3,0,0,0,2,4,6,17,10,27,1,0,1,3,4,7,373,342,715,759
20192020,118,WHITLEY,133,Corbin Independent,070,Corbin Primary,133070,118133070,210132002218,SESC,907,03,88,114,0,0,0,0,0,0,0,0,0,6,3,9,0,0,0,1,0,1,107,85,192,202
20192020,118,WHITLEY,133,Corbin Independent,070,Corbin Primary,133070,118133070,210132002218,SESC,907,02,87,93,0,0,0,0,0,0,0,0,0,3,3,6,1,0,1,0,0,0,89,84,173,180
20192020,118,WHITLEY,133,Corbin Independent,070,Corbin Primary,133070,118133070,210132002218,SESC,907,01,107,118,1,1,2,0,0,0,1,2,3,5,0,5,0,0,0,2,4,6,109,100,209,225
20192020,118,WHITLEY,133,Corbin Independent,100,Corbin School of Innovation,133100,118133100,210132002367,SESC,907,11,10,5,0,0,0,0,0,0,0,0,0,0,0,0,0,0,0,0,0,0,5,10,15,15
20192020,118,WHITLEY,133,Corbin Independent,100,Corbin School of Innovation,133100,118133100,210132002367,SESC,907,All Students,71,44,0,0,0,0,0,0,0,0,0,0,3,3,0,0,0,1,0,1,43,68,111,115
20192020,118,WHITLEY,133,Corbin Independent,100,Corbin School of Innovation,133100,118133100,210132002367,SESC,907,04,2,0,0,0,0,0,0,0,0,0,0,0,0,0,0,0,0,0,0,0,0,2,2,2
20192020,118,WHITLEY,133,Corbin Independent,100,Corbin School of Innovation,133100,118133100,210132002367,SESC,907,05,5,5,0,0,0,0,0,0,0,0,0,0,0,0,0,0,0,0,0,0,5,5,10,10
20192020,118,WHITLEY,133,Corbin Independent,100,Corbin School of Innovation,133100,118133100,210132002367,SESC,907,06,2,2,0,0,0,0,0,0,0,0,0,0,0,0,0,0,0,0,0,0,2,2,4,4
20192020,118,WHITLEY,133,Corbin Independent,100,Corbin School of Innovation,133100,118133100,210132002367,SESC,907,07,2,1,0,0,0,0,0,0,0,0,0,0,0,0,0,0,0,0,0,0,1,2,3,3
20192020,118,WHITLEY,133,Corbin Independent,100,Corbin School of Innovation,133100,118133100,210132002367,SESC,907,08,3,5,0,0,0,0,0,0,0,0,0,0,1,1,0,0,0,0,0,0,5,2,7,8
20192020,118,WHITLEY,133,Corbin Independent,100,Corbin School of Innovation,133100,118133100,210132002367,SESC,907,09,5,7,0,0,0,0,0,0,0,0,0,0,0,0,0,0,0,0,0,0,7,5,12,12
20192020,118,WHITLEY,133,Corbin Independent,100,Corbin School of Innovation,133100,118133100,210132002367,SESC,907,10,12,8,0,0,0,0,0,0,0,0,0,0,0,0,0,0,0,0,0,0,8,12,20,20
20192020,118,WHITLEY,133,Corbin Independent,100,Corbin School of Innovation,133100,118133100,210132002367,SESC,907,12,30,11,0,0,0,0,0,0,0,0,0,0,2,2,0,0,0,1,0,1,10,28,38,41
20192020,059,KENTON,134,Covington Independent,"",---District Total---,134,"","",NKCES,905,12,74,101,32,20,52,0,0,0,1,0,1,12,4,16,0,0,0,11,6,17,45,44,89,175
20192020,059,KENTON,134,Covington Independent,"",---District Total---,134,"","",NKCES,905,All Students,1721,1934,553,525,1078,1,1,2,1,1,2,396,318,714,9,4,13,188,209,397,786,663,1449,3655
20192020,059,KENTON,134,Covington Independent,"",---District Total---,134,"","",NKCES,905,PS,155,223,45,39,84,0,1,1,0,1,1,58,39,97,0,0,0,23,27,50,97,48,145,378
20192020,059,KENTON,134,Covington Independent,"",---District Total---,134,"","",NKCES,905,KG,184,199,54,41,95,1,0,1,0,1,1,40,46,86,1,0,1,25,30,55,78,66,144,383
20192020,059,KENTON,134,Covington Independent,"",---District Total---,134,"","",NKCES,905,01,182,192,58,64,122,0,0,0,0,0,0,41,39,80,0,0,0,12,16,28,81,63,144,374
20192020,059,KENTON,134,Covington Independent,"",---District Total---,134,"","",NKCES,905,02,139,177,53,39,92,0,0,0,0,0,0,32,32,64,0,0,0,23,16,39,69,52,121,316
20192020,059,KENTON,134,Covington Independent,"",---District Total---,134,"","",NKCES,905,03,149,175,56,41,97,0,0,0,0,0,0,30,26,56,3,0,3,14,21,35,72,61,133,324
20192020,059,KENTON,134,Covington Independent,"",---District Total---,134,"","",NKCES,905,04,148,166,42,46,88,0,0,0,0,0,0,33,26,59,0,1,1,17,22,39,74,53,127,314
20192020,059,KENTON,134,Covington Independent,"",---District Total---,134,"","",NKCES,905,05,162,163,53,55,108,0,0,0,0,0,0,41,29,70,1,1,2,14,17,31,54,60,114,325
20192020,059,KENTON,134,Covington Independent,"",---District Total---,134,"","",NKCES,905,06,126,139,34,34,68,0,0,0,0,0,0,24,25,49,0,0,0,17,15,32,64,52,116,265
20192020,059,KENTON,134,Covington Independent,"",---District Total---,134,"","",NKCES,905,07,123,118,33,53,86,0,0,0,0,0,0,24,20,44,1,0,1,11,13,24,49,37,86,241
20192020,059,KENTON,134,Covington Independent,"",---District Total---,134,"","",NKCES,905,08,117,130,34,43,77,0,0,0,0,0,0,25,19,44,0,1,1,12,18,30,59,36,95,247
20192020,059,KENTON,134,Covington Independent,"",---District Total---,134,"","",NKCES,905,09,122,174,44,37,81,0,0,0,0,0,0,62,26,88,2,0,2,10,9,19,56,50,106,296
20192020,059,KENTON,134,Covington Independent,"",---District Total---,134,"","",NKCES,905,10,101,122,36,25,61,0,1,1,0,0,0,20,18,38,0,1,1,13,9,22,53,47,100,223
20192020,059,KENTON,134,Covington Independent,"",---District Total---,134,"","",NKCES,905,11,94,78,24,27,51,0,0,0,0,0,0,12,8,20,1,0,1,9,17,26,32,42,74,172
20192020,059,KENTON,134,Covington Independent,010,Biggs Early Childhood Education Ctr,134010,059134010,210135001664,NKCES,905,All Students,0,0,0,0,0,0,0,0,0,0,0,0,0,0,0,0,0,0,0,0,0,0,0,0
20192020,059,KENTON,134,Covington Independent,010,Biggs Early Childhood Education Ctr,134010,059134010,210135001664,NKCES,905,PS,155,223,45,39,84,0,1,1,0,1,1,58,39,97,0,0,0,23,27,50,97,48,145,378
20192020,059,KENTON,134,Covington Independent,011,Covington Adult High School,134011,059134011,210135001495,NKCES,905,11,4,3,1,0,1,0,0,0,0,0,0,0,0,0,0,0,0,0,0,0,2,4,6,7
20192020,059,KENTON,134,Covington Independent,011,Covington Adult High School,134011,059134011,210135001495,NKCES,905,All Students,20,25,3,6,9,0,0,0,0,0,0,4,0,4,0,0,0,4,0,4,14,14,28,45
20192020,059,KENTON,134,Covington Independent,011,Covington Adult High School,134011,059134011,210135001495,NKCES,905,12,16,22,2,6,8,0,0,0,0,0,0,4,0,4,0,0,0,4,0,4,12,10,22,38
20192020,059,KENTON,134,Covington Independent,013,Transformational Learning Center,134013,059134013,210135001783,NKCES,905,11,7,4,1,4,5,0,0,0,0,0,0,1,0,1,0,0,0,1,1,2,1,2,3,11
20192020,059,KENTON,134,Covington Independent,013,Transformational Learning Center,134013,059134013,210135001783,NKCES,905,All Students,41,58,14,20,34,0,0,0,0,0,0,1,1,2,0,0,0,4,8,12,39,12,51,99
20192020,059,KENTON,134,Covington Independent,013,Transformational Learning Center,134013,059134013,210135001783,NKCES,905,01,0,2,0,0,0,0,0,0,0,0,0,0,0,0,0,0,0,0,0,0,2,0,2,2
20192020,059,KENTON,134,Covington Independent,013,Transformational Learning Center,134013,059134013,210135001783,NKCES,905,02,0,2,0,0,0,0,0,0,0,0,0,0,0,0,0,0,0,0,0,0,2,0,2,2
20192020,059,KENTON,134,Covington Independent,013,Transformational Learning Center,134013,059134013,210135001783,NKCES,905,03,0,2,0,0,0,0,0,0,0,0,0,0,0,0,0,0,0,0,0,0,2,0,2,2
20192020,059,KENTON,134,Covington Independent,013,Transformational Learning Center,134013,059134013,210135001783,NKCES,905,04,0,1,0,0,0,0,0,0,0,0,0,0,0,0,0,0,0,0,0,0,1,0,1,1
20192020,059,KENTON,134,Covington Independent,013,Transformational Learning Center,134013,059134013,210135001783,NKCES,905,05,0,7,1,0,1,0,0,0,0,0,0,0,0,0,0,0,0,0,0,0,6,0,6,7
20192020,059,KENTON,134,Covington Independent,013,Transformational Learning Center,134013,059134013,210135001783,NKCES,905,06,2,7,1,1,2,0,0,0,0,0,0,0,0,0,0,0,0,1,0,1,5,1,6,9
20192020,059,KENTON,134,Covington Independent,013,Transformational Learning Center,134013,059134013,210135001783,NKCES,905,07,4,3,1,3,4,0,0,0,0,0,0,0,0,0,0,0,0,0,0,0,2,1,3,7
20192020,059,KENTON,134,Covington Independent,013,Transformational Learning Center,134013,059134013,210135001783,NKCES,905,08,7,8,1,3,4,0,0,0,0,0,0,0,0,0,0,0,0,1,4,5,6,0,6,15
20192020,059,KENTON,134,Covington Independent,013,Transformational Learning Center,134013,059134013,210135001783,NKCES,905,09,16,14,4,7,11,0,0,0,0,0,0,0,1,1,0,0,0,1,3,4,9,5,14,30
20192020,059,KENTON,134,Covington Independent,013,Transformational Learning Center,134013,059134013,210135001783,NKCES,905,10,4,8,5,2,7,0,0,0,0,0,0,0,0,0,0,0,0,0,0,0,3,2,5,12
20192020,059,KENTON,134,Covington Independent,013,Transformational Learning Center,134013,059134013,210135001783,NKCES,905,12,1,0,0,0,0,0,0,0,0,0,0,0,0,0,0,0,0,0,0,0,0,1,1,1
20192020,059,KENTON,134,Covington Independent,017,Holmes Middle School,134017,059134017,210135001944,NKCES,905,07,119,115,32,50,82,0,0,0,0,0,0,24,20,44,1,0,1,11,13,24,47,36,83,234
20192020,059,KENTON,134,Covington Independent,017,Holmes Middle School,134017,059134017,210135001944,NKCES,905,All Students,353,369,98,123,221,0,0,0,0,0,0,73,64,137,1,1,2,38,42,80,159,123,282,722
20192020,059,KENTON,134,Covington Independent,017,Holmes Middle School,134017,059134017,210135001944,NKCES,905,06,124,132,33,33,66,0,0,0,0,0,0,24,25,49,0,0,0,16,15,31,59,51,110,256
20192020,059,KENTON,134,Covington Independent,017,Holmes Middle School,134017,059134017,210135001944,NKCES,905,08,110,122,33,40,73,0,0,0,0,0,0,25,19,44,0,1,1,11,14,25,53,36,89,232
20192020,059,KENTON,134,Covington Independent,019,Holmes High School,134019,059134019,210135002049,NKCES,905,11,83,71,22,23,45,0,0,0,0,0,0,11,8,19,1,0,1,8,16,24,29,36,65,154
20192020,059,KENTON,134,Covington Independent,019,Holmes High School,134019,059134019,210135002049,NKCES,905,All Students,343,424,123,90,213,0,1,1,1,0,1,101,55,156,3,1,4,37,37,74,159,159,318,767
20192020,059,KENTON,134,Covington Independent,019,Holmes High School,134019,059134019,210135002049,NKCES,905,09,106,160,40,30,70,0,0,0,0,0,0,62,25,87,2,0,2,9,6,15,47,45,92,266
20192020,059,KENTON,134,Covington Independent,019,Holmes High School,134019,059134019,210135002049,NKCES,905,10,97,114,31,23,54,0,1,1,0,0,0,20,18,38,0,1,1,13,9,22,50,45,95,211
20192020,059,KENTON,134,Covington Independent,019,Holmes High School,134019,059134019,210135002049,NKCES,905,12,57,79,30,14,44,0,0,0,1,0,1,8,4,12,0,0,0,7,6,13,33,33,66,136
20192020,059,KENTON,134,Covington Independent,110,John G Carlisle Elementary,134110,059134110,210135000270,NKCES,905,05,33,40,8,10,18,0,0,0,0,0,0,15,6,21,0,0,0,4,2,6,13,15,28,73
20192020,059,KENTON,134,Covington Independent,110,John G Carlisle Elementary,134110,059134110,210135000270,NKCES,905,All Students,173,214,57,47,104,1,0,1,0,0,0,70,52,122,0,0,0,24,21,45,62,53,115,387
20192020,059,KENTON,134,Covington Independent,110,John G Carlisle Elementary,134110,059134110,210135000270,NKCES,905,KG,36,46,14,2,16,1,0,1,0,0,0,11,18,29,0,0,0,7,7,14,13,9,22,82
20192020,059,KENTON,134,Covington Independent,110,John G Carlisle Elementary,134110,059134110,210135000270,NKCES,905,01,25,32,6,11,17,0,0,0,0,0,0,16,4,20,0,0,0,2,4,6,8,6,14,57
20192020,059,KENTON,134,Covington Independent,110,John G Carlisle Elementary,134110,059134110,210135000270,NKCES,905,02,24,42,13,5,18,0,0,0,0,0,0,10,12,22,0,0,0,3,2,5,16,5,21,66
20192020,059,KENTON,134,Covington Independent,110,John G Carlisle Elementary,134110,059134110,210135000270,NKCES,905,03,32,27,11,10,21,0,0,0,0,0,0,9,10,19,0,0,0,3,2,5,4,10,14,59
20192020,059,KENTON,134,Covington Independent,110,John G Carlisle Elementary,134110,059134110,210135000270,NKCES,905,04,23,27,5,9,14,0,0,0,0,0,0,9,2,11,0,0,0,5,4,9,8,8,16,50
20192020,059,KENTON,134,Covington Independent,115,Latonia Elementary School,134115,059134115,210135000271,NKCES,905,04,24,28,7,9,16,0,0,0,0,0,0,1,2,3,0,1,1,1,0,1,19,12,31,52
20192020,059,KENTON,134,Covington Independent,115,Latonia Elementary School,134115,059134115,210135000271,NKCES,905,All Students,185,170,48,54,102,0,0,0,0,0,0,5,10,15,1,1,2,14,20,34,102,100,202,355
20192020,059,KENTON,134,Covington Independent,115,Latonia Elementary School,134115,059134115,210135000271,NKCES,905,KG,34,24,4,6,10,0,0,0,0,0,0,1,1,2,0,0,0,3,7,10,16,20,36,58
20192020,059,KENTON,134,Covington Independent,115,Latonia Elementary School,134115,059134115,210135000271,NKCES,905,01,41,29,8,16,24,0,0,0,0,0,0,0,2,2,0,0,0,1,2,3,20,21,41,70
20192020,059,KENTON,134,Covington Independent,115,Latonia Elementary School,134115,059134115,210135000271,NKCES,905,02,30,27,9,9,18,0,0,0,0,0,0,1,2,3,0,0,0,6,3,9,11,16,27,57
20192020,059,KENTON,134,Covington Independent,115,Latonia Elementary School,134115,059134115,210135000271,NKCES,905,03,27,40,12,5,17,0,0,0,0,0,0,2,2,4,0,0,0,0,5,5,26,15,41,67
20192020,059,KENTON,134,Covington Independent,115,Latonia Elementary School,134115,059134115,210135000271,NKCES,905,05,29,22,8,9,17,0,0,0,0,0,0,0,1,1,1,0,1,3,3,6,10,16,26,51
20192020,059,KENTON,134,Covington Independent,150,Ninth District Elementary,134150,059134150,210135000274,NKCES,905,04,31,33,11,6,17,0,0,0,0,0,0,4,8,12,0,0,0,5,6,11,13,11,24,64
20192020,059,KENTON,134,Covington Independent,150,Ninth District Elementary,134150,059134150,210135000274,NKCES,905,All Students,183,215,76,60,136,0,0,0,0,0,0,32,31,63,1,1,2,31,31,62,75,60,135,398
20192020,059,KENTON,134,Covington Independent,150,Ninth District Elementary,134150,059134150,210135000274,NKCES,905,KG,26,47,14,6,20,0,0,0,0,0,0,5,8,13,0,0,0,7,7,14,21,5,26,73
20192020,059,KENTON,134,Covington Independent,150,Ninth District Elementary,134150,059134150,210135000274,NKCES,905,01,38,40,14,17,31,0,0,0,0,0,0,6,6,12,0,0,0,4,3,7,16,12,28,78
20192020,059,KENTON,134,Covington Independent,150,Ninth District Elementary,134150,059134150,210135000274,NKCES,905,02,20,37,16,5,21,0,0,0,0,0,0,5,2,7,0,0,0,6,6,12,10,7,17,57
20192020,059,KENTON,134,Covington Independent,150,Ninth District Elementary,134150,059134150,210135000274,NKCES,905,03,29,31,10,9,19,0,0,0,0,0,0,3,0,3,1,0,1,6,4,10,11,16,27,60
20192020,059,KENTON,134,Covington Independent,150,Ninth District Elementary,134150,059134150,210135000274,NKCES,905,05,39,27,11,17,28,0,0,0,0,0,0,9,7,16,0,1,1,3,5,8,4,9,13,66
20192020,059,KENTON,134,Covington Independent,160,Glenn O Swing Elementary,134160,059134160,210135000275,NKCES,905,04,37,39,8,9,17,0,0,0,0,0,0,11,11,22,0,0,0,5,3,8,15,14,29,76
20192020,059,KENTON,134,Covington Independent,160,Glenn O Swing Elementary,134160,059134160,210135000275,NKCES,905,All Students,227,232,62,60,122,0,0,0,0,1,1,49,57,106,1,0,1,22,24,46,98,85,183,459
20192020,059,KENTON,134,Covington Independent,160,Glenn O Swing Elementary,134160,059134160,210135000275,NKCES,905,KG,32,39,10,12,22,0,0,0,0,1,1,10,4,14,0,0,0,5,3,8,14,12,26,71
20192020,059,KENTON,134,Covington Independent,160,Glenn O Swing Elementary,134160,059134160,210135000275,NKCES,905,01,38,41,13,7,20,0,0,0,0,0,0,7,14,21,0,0,0,3,4,7,18,13,31,79
20192020,059,KENTON,134,Covington Independent,160,Glenn O Swing Elementary,134160,059134160,210135000275,NKCES,905,02,40,34,5,8,13,0,0,0,0,0,0,7,9,16,0,0,0,4,3,7,18,20,38,74
20192020,059,KENTON,134,Covington Independent,160,Glenn O Swing Elementary,134160,059134160,210135000275,NKCES,905,03,39,38,10,11,21,0,0,0,0,0,0,6,9,15,1,0,1,2,5,7,19,14,33,77
20192020,059,KENTON,134,Covington Independent,160,Glenn O Swing Elementary,134160,059134160,210135000275,NKCES,905,05,41,41,16,13,29,0,0,0,0,0,0,8,10,18,0,0,0,3,6,9,14,12,26,82
20192020,059,KENTON,134,Covington Independent,170,Sixth District Elementary School,134170,059134170,210135000276,NKCES,905,04,33,38,11,13,24,0,0,0,0,0,0,8,3,11,0,0,0,1,9,10,18,8,26,71
20192020,059,KENTON,134,Covington Independent,170,Sixth District Elementary School,134170,059134170,210135000276,NKCES,905,All Students,196,227,72,65,137,0,0,0,0,0,0,61,48,109,2,0,2,14,26,40,78,57,135,423
20192020,059,KENTON,134,Covington Independent,170,Sixth District Elementary School,134170,059134170,210135000276,NKCES,905,KG,56,43,12,15,27,0,0,0,0,0,0,13,15,28,1,0,1,3,6,9,14,20,34,99
20192020,059,KENTON,134,Covington Independent,170,Sixth District Elementary School,134170,059134170,210135000276,NKCES,905,01,40,48,17,13,30,0,0,0,0,0,0,12,13,25,0,0,0,2,3,5,17,11,28,88
20192020,059,KENTON,134,Covington Independent,170,Sixth District Elementary School,134170,059134170,210135000276,NKCES,905,02,25,35,10,12,22,0,0,0,0,0,0,9,7,16,0,0,0,4,2,6,12,4,16,60
20192020,059,KENTON,134,Covington Independent,170,Sixth District Elementary School,134170,059134170,210135000276,NKCES,905,03,22,37,13,6,19,0,0,0,0,0,0,10,5,15,1,0,1,3,5,8,10,6,16,59
20192020,059,KENTON,134,Covington Independent,170,Sixth District Elementary School,134170,059134170,210135000276,NKCES,905,05,20,26,9,6,15,0,0,0,0,0,0,9,5,14,0,0,0,1,1,2,7,8,15,46
20192020,059,KENTON,134,Covington Independent,906,Chapman Vocational Education Center,134906,059134906,210135002338,NKCES,905,12,0,0,0,0,0,0,0,0,0,0,0,0,0,0,0,0,0,0,0,0,0,0,0,0
20192020,059,KENTON,134,Covington Independent,906,Chapman Vocational Education Center,134906,059134906,210135002338,NKCES,905,All Students,0,0,0,0,0,0,0,0,0,0,0,0,0,0,0,0,0,0,0,0,0,0,0,0
20192020,059,KENTON,134,Covington Independent,906,Chapman Vocational Education Center,134906,059134906,210135002338,NKCES,905,09,0,0,0,0,0,0,0,0,0,0,0,0,0,0,0,0,0,0,0,0,0,0,0,0
20192020,059,KENTON,134,Covington Independent,906,Chapman Vocational Education Center,134906,059134906,210135002338,NKCES,905,10,0,0,0,0,0,0,0,0,0,0,0,0,0,0,0,0,0,0,0,0,0,0,0,0
20192020,059,KENTON,134,Covington Independent,906,Chapman Vocational Education Center,134906,059134906,210135002338,NKCES,905,11,0,0,0,0,0,0,0,0,0,0,0,0,0,0,0,0,0,0,0,0,0,0,0,0
20192020,028,CRITTENDEN,135,Crittenden County,"",---District Total---,135,"","",WKEC,908,07,47,58,1,0,1,0,0,0,0,0,0,3,0,3,0,0,0,2,1,3,52,46,98,105
20192020,028,CRITTENDEN,135,Crittenden County,"",---District Total---,135,"","",WKEC,908,All Students,628,708,3,2,5,0,2,2,2,1,3,17,8,25,0,0,0,26,16,42,660,599,1259,1336
20192020,028,CRITTENDEN,135,Crittenden County,"",---District Total---,135,"","",WKEC,908,PS,39,48,0,0,0,0,0,0,0,0,0,0,0,0,0,0,0,3,3,6,45,36,81,87
20192020,028,CRITTENDEN,135,Crittenden County,"",---District Total---,135,"","",WKEC,908,KG,60,69,0,0,0,0,0,0,0,1,1,0,1,1,0,0,0,3,4,7,66,54,120,129
20192020,028,CRITTENDEN,135,Crittenden County,"",---District Total---,135,"","",WKEC,908,01,42,53,0,0,0,0,0,0,0,0,0,1,3,4,0,0,0,5,1,6,47,38,85,95
20192020,028,CRITTENDEN,135,Crittenden County,"",---District Total---,135,"","",WKEC,908,02,37,47,0,0,0,0,0,0,0,0,0,2,1,3,0,0,0,1,1,2,44,35,79,84
20192020,028,CRITTENDEN,135,Crittenden County,"",---District Total---,135,"","",WKEC,908,03,42,52,0,0,0,0,0,0,0,0,0,2,0,2,0,0,0,3,1,4,47,41,88,94
20192020,028,CRITTENDEN,135,Crittenden County,"",---District Total---,135,"","",WKEC,908,04,41,62,0,0,0,0,0,0,1,0,1,3,1,4,0,0,0,2,1,3,56,39,95,103
20192020,028,CRITTENDEN,135,Crittenden County,"",---District Total---,135,"","",WKEC,908,05,52,51,0,0,0,0,0,0,0,0,0,0,1,1,0,0,0,3,1,4,48,50,98,103
20192020,028,CRITTENDEN,135,Crittenden County,"",---District Total---,135,"","",WKEC,908,06,62,47,0,0,0,0,0,0,0,0,0,1,0,1,0,0,0,3,2,5,43,60,103,109
20192020,028,CRITTENDEN,135,Crittenden County,"",---District Total---,135,"","",WKEC,908,08,76,63,0,1,1,0,0,0,0,0,0,1,0,1,0,0,0,1,0,1,61,75,136,139
20192020,028,CRITTENDEN,135,Crittenden County,"",---District Total---,135,"","",WKEC,908,09,40,60,1,0,1,0,1,1,1,0,1,1,1,2,0,0,0,1,0,1,56,38,94,100
20192020,028,CRITTENDEN,135,Crittenden County,"",---District Total---,135,"","",WKEC,908,10,40,52,0,0,0,0,0,0,0,0,0,1,0,1,0,0,0,0,1,1,51,39,90,92
20192020,028,CRITTENDEN,135,Crittenden County,"",---District Total---,135,"","",WKEC,908,11,45,51,1,1,2,0,1,1,0,0,0,1,0,1,0,0,0,1,1,2,48,42,90,96
20192020,028,CRITTENDEN,135,Crittenden County,"",---District Total---,135,"","",WKEC,908,12,44,42,0,0,0,0,0,0,0,0,0,1,0,1,0,0,0,1,2,3,40,42,82,86
20192020,028,CRITTENDEN,135,Crittenden County,"",---District Total---,135,"","",WKEC,908,14,0,1,0,0,0,0,0,0,0,0,0,0,0,0,0,0,0,0,0,0,1,0,1,1
20192020,028,CRITTENDEN,135,Crittenden County,020,Crittenden County High School,135020,028135020,210138000279,WKEC,908,14,0,1,0,0,0,0,0,0,0,0,0,0,0,0,0,0,0,0,0,0,1,0,1,1
20192020,028,CRITTENDEN,135,Crittenden County,020,Crittenden County High School,135020,028135020,210138000279,WKEC,908,All Students,166,200,2,1,3,0,2,2,1,0,1,4,1,5,0,0,0,3,4,7,190,158,348,366
20192020,028,CRITTENDEN,135,Crittenden County,020,Crittenden County High School,135020,028135020,210138000279,WKEC,908,09,40,60,1,0,1,0,1,1,1,0,1,1,1,2,0,0,0,1,0,1,56,38,94,100
20192020,028,CRITTENDEN,135,Crittenden County,020,Crittenden County High School,135020,028135020,210138000279,WKEC,908,10,40,52,0,0,0,0,0,0,0,0,0,1,0,1,0,0,0,0,1,1,51,39,90,92
20192020,028,CRITTENDEN,135,Crittenden County,020,Crittenden County High School,135020,028135020,210138000279,WKEC,908,11,45,51,1,1,2,0,1,1,0,0,0,1,0,1,0,0,0,1,1,2,48,42,90,96
20192020,028,CRITTENDEN,135,Crittenden County,020,Crittenden County High School,135020,028135020,210138000279,WKEC,908,12,41,36,0,0,0,0,0,0,0,0,0,1,0,1,0,0,0,1,2,3,34,39,73,77
20192020,028,CRITTENDEN,135,Crittenden County,022,Pathway Academy High School,135022,028135022,210138002225,WKEC,908,All Students,3,6,0,0,0,0,0,0,0,0,0,0,0,0,0,0,0,0,0,0,6,3,9,9
20192020,028,CRITTENDEN,135,Crittenden County,022,Pathway Academy High School,135022,028135022,210138002225,WKEC,908,12,3,6,0,0,0,0,0,0,0,0,0,0,0,0,0,0,0,0,0,0,6,3,9,9
20192020,028,CRITTENDEN,135,Crittenden County,025,Crittenden County Middle School,135025,028135025,210138000280,WKEC,908,07,47,58,1,0,1,0,0,0,0,0,0,3,0,3,0,0,0,2,1,3,52,46,98,105
20192020,028,CRITTENDEN,135,Crittenden County,025,Crittenden County Middle School,135025,028135025,210138000280,WKEC,908,All Students,185,168,1,1,2,0,0,0,0,0,0,5,0,5,0,0,0,6,3,9,156,181,337,353
20192020,028,CRITTENDEN,135,Crittenden County,025,Crittenden County Middle School,135025,028135025,210138000280,WKEC,908,06,62,47,0,0,0,0,0,0,0,0,0,1,0,1,0,0,0,3,2,5,43,60,103,109
20192020,028,CRITTENDEN,135,Crittenden County,025,Crittenden County Middle School,135025,028135025,210138000280,WKEC,908,08,76,63,0,1,1,0,0,0,0,0,0,1,0,1,0,0,0,1,0,1,61,75,136,139
20192020,028,CRITTENDEN,135,Crittenden County,100,Crittenden County Elementary School,135100,028135100,210138001441,WKEC,908,04,41,62,0,0,0,0,0,0,1,0,1,3,1,4,0,0,0,2,1,3,56,39,95,103
20192020,028,CRITTENDEN,135,Crittenden County,100,Crittenden County Elementary School,135100,028135100,210138001441,WKEC,908,All Students,274,334,0,0,0,0,0,0,1,1,2,8,7,15,0,0,0,17,9,26,308,257,565,608
20192020,028,CRITTENDEN,135,Crittenden County,100,Crittenden County Elementary School,135100,028135100,210138001441,WKEC,908,PS,39,48,0,0,0,0,0,0,0,0,0,0,0,0,0,0,0,3,3,6,45,36,81,87
20192020,028,CRITTENDEN,135,Crittenden County,100,Crittenden County Elementary School,135100,028135100,210138001441,WKEC,908,KG,60,69,0,0,0,0,0,0,0,1,1,0,1,1,0,0,0,3,4,7,66,54,120,129
20192020,028,CRITTENDEN,135,Crittenden County,100,Crittenden County Elementary School,135100,028135100,210138001441,WKEC,908,01,42,53,0,0,0,0,0,0,0,0,0,1,3,4,0,0,0,5,1,6,47,38,85,95
20192020,028,CRITTENDEN,135,Crittenden County,100,Crittenden County Elementary School,135100,028135100,210138001441,WKEC,908,02,37,47,0,0,0,0,0,0,0,0,0,2,1,3,0,0,0,1,1,2,44,35,79,84
20192020,028,CRITTENDEN,135,Crittenden County,100,Crittenden County Elementary School,135100,028135100,210138001441,WKEC,908,03,42,52,0,0,0,0,0,0,0,0,0,2,0,2,0,0,0,3,1,4,47,41,88,94
20192020,028,CRITTENDEN,135,Crittenden County,100,Crittenden County Elementary School,135100,028135100,210138001441,WKEC,908,05,52,51,0,0,0,0,0,0,0,0,0,0,1,1,0,0,0,3,1,4,48,50,98,103
20192020,029,CUMBERLAND,141,Cumberland County,"",---District Total---,141,"","",GRREC,902,11,28,35,0,0,0,0,0,0,0,0,0,2,0,2,0,0,0,1,0,1,32,28,60,63
20192020,029,CUMBERLAND,141,Cumberland County,"",---District Total---,141,"","",GRREC,902,All Students,441,466,9,4,13,0,1,1,3,0,3,15,11,26,0,0,0,20,20,40,419,405,824,907
20192020,029,CUMBERLAND,141,Cumberland County,"",---District Total---,141,"","",GRREC,902,PS,29,33,3,0,3,0,0,0,0,0,0,0,1,1,0,0,0,1,7,8,29,21,50,62
20192020,029,CUMBERLAND,141,Cumberland County,"",---District Total---,141,"","",GRREC,902,KG,43,32,4,2,6,0,0,0,1,0,1,1,2,3,0,0,0,0,2,2,26,37,63,75
20192020,029,CUMBERLAND,141,Cumberland County,"",---District Total---,141,"","",GRREC,902,01,39,39,1,0,1,0,0,0,1,0,1,2,2,4,0,0,0,2,0,2,33,37,70,78
20192020,029,CUMBERLAND,141,Cumberland County,"",---District Total---,141,"","",GRREC,902,02,29,31,0,0,0,0,0,0,0,0,0,1,0,1,0,0,0,2,1,3,28,28,56,60
20192020,029,CUMBERLAND,141,Cumberland County,"",---District Total---,141,"","",GRREC,902,03,35,36,0,0,0,0,0,0,0,0,0,0,0,0,0,0,0,2,1,3,34,34,68,71
20192020,029,CUMBERLAND,141,Cumberland County,"",---District Total---,141,"","",GRREC,902,04,30,36,1,0,1,0,0,0,1,0,1,1,0,1,0,0,0,0,0,0,33,30,63,66
20192020,029,CUMBERLAND,141,Cumberland County,"",---District Total---,141,"","",GRREC,902,05,34,30,0,1,1,0,0,0,0,0,0,1,0,1,0,0,0,1,5,6,28,28,56,64
20192020,029,CUMBERLAND,141,Cumberland County,"",---District Total---,141,"","",GRREC,902,06,35,42,0,0,0,0,0,0,0,0,0,0,2,2,0,0,0,2,2,4,40,31,71,77
20192020,029,CUMBERLAND,141,Cumberland County,"",---District Total---,141,"","",GRREC,902,07,34,41,0,0,0,0,0,0,0,0,0,3,1,4,0,0,0,2,4,6,36,29,65,75
20192020,029,CUMBERLAND,141,Cumberland County,"",---District Total---,141,"","",GRREC,902,08,36,32,0,0,0,0,0,0,0,0,0,1,0,1,0,0,0,3,2,5,28,34,62,68
20192020,029,CUMBERLAND,141,Cumberland County,"",---District Total---,141,"","",GRREC,902,09,35,32,0,1,1,0,0,0,0,0,0,1,1,2,0,0,0,1,2,3,30,31,61,67
20192020,029,CUMBERLAND,141,Cumberland County,"",---District Total---,141,"","",GRREC,902,10,34,37,2,0,2,0,1,1,0,0,0,1,1,2,0,0,0,3,1,4,31,31,62,71
20192020,029,CUMBERLAND,141,Cumberland County,"",---District Total---,141,"","",GRREC,902,12,29,43,1,0,1,0,0,0,0,0,0,1,2,3,0,0,0,1,0,1,40,27,67,72
20192020,029,CUMBERLAND,141,Cumberland County,070,Cumberland County Elementary School,141070,029141070,210141000286,GRREC,902,05,34,30,0,1,1,0,0,0,0,0,0,1,0,1,0,0,0,1,5,6,28,28,56,64
20192020,029,CUMBERLAND,141,Cumberland County,070,Cumberland County Elementary School,141070,029141070,210141000286,GRREC,902,All Students,210,204,6,3,9,0,0,0,3,0,3,6,4,10,0,0,0,7,9,16,182,194,376,414
20192020,029,CUMBERLAND,141,Cumberland County,070,Cumberland County Elementary School,141070,029141070,210141000286,GRREC,902,PS,29,33,3,0,3,0,0,0,0,0,0,0,1,1,0,0,0,1,7,8,29,21,50,62
20192020,029,CUMBERLAND,141,Cumberland County,070,Cumberland County Elementary School,141070,029141070,210141000286,GRREC,902,KG,43,32,4,2,6,0,0,0,1,0,1,1,2,3,0,0,0,0,2,2,26,37,63,75
20192020,029,CUMBERLAND,141,Cumberland County,070,Cumberland County Elementary School,141070,029141070,210141000286,GRREC,902,01,39,39,1,0,1,0,0,0,1,0,1,2,2,4,0,0,0,2,0,2,33,37,70,78
20192020,029,CUMBERLAND,141,Cumberland County,070,Cumberland County Elementary School,141070,029141070,210141000286,GRREC,902,02,29,31,0,0,0,0,0,0,0,0,0,1,0,1,0,0,0,2,1,3,28,28,56,60
20192020,029,CUMBERLAND,141,Cumberland County,070,Cumberland County Elementary School,141070,029141070,210141000286,GRREC,902,03,35,36,0,0,0,0,0,0,0,0,0,0,0,0,0,0,0,2,1,3,34,34,68,71
20192020,029,CUMBERLAND,141,Cumberland County,070,Cumberland County Elementary School,141070,029141070,210141000286,GRREC,902,04,30,36,1,0,1,0,0,0,1,0,1,1,0,1,0,0,0,0,0,0,33,30,63,66
20192020,029,CUMBERLAND,141,Cumberland County,075,Cumberland County Middle School,141075,029141075,210141001561,GRREC,902,All Students,105,115,0,0,0,0,0,0,0,0,0,4,3,7,0,0,0,7,8,15,104,94,198,220
20192020,029,CUMBERLAND,141,Cumberland County,075,Cumberland County Middle School,141075,029141075,210141001561,GRREC,902,06,35,42,0,0,0,0,0,0,0,0,0,0,2,2,0,0,0,2,2,4,40,31,71,77
20192020,029,CUMBERLAND,141,Cumberland County,075,Cumberland County Middle School,141075,029141075,210141001561,GRREC,902,07,34,41,0,0,0,0,0,0,0,0,0,3,1,4,0,0,0,2,4,6,36,29,65,75
20192020,029,CUMBERLAND,141,Cumberland County,075,Cumberland County Middle School,141075,029141075,210141001561,GRREC,902,08,36,32,0,0,0,0,0,0,0,0,0,1,0,1,0,0,0,3,2,5,28,34,62,68
20192020,029,CUMBERLAND,141,Cumberland County,080,Cumberland County High School,141080,029141080,210141000287,GRREC,902,12,29,43,1,0,1,0,0,0,0,0,0,1,2,3,0,0,0,1,0,1,40,27,67,72
20192020,029,CUMBERLAND,141,Cumberland County,080,Cumberland County High School,141080,029141080,210141000287,GRREC,902,11,28,35,0,0,0,0,0,0,0,0,0,2,0,2,0,0,0,1,0,1,32,28,60,63
20192020,029,CUMBERLAND,141,Cumberland County,080,Cumberland County High School,141080,029141080,210141000287,GRREC,902,All Students,126,147,3,1,4,0,1,1,0,0,0,5,4,9,0,0,0,6,3,9,133,117,250,273
20192020,029,CUMBERLAND,141,Cumberland County,080,Cumberland County High School,141080,029141080,210141000287,GRREC,902,09,35,32,0,1,1,0,0,0,0,0,0,1,1,2,0,0,0,1,2,3,30,31,61,67
20192020,029,CUMBERLAND,141,Cumberland County,080,Cumberland County High School,141080,029141080,210141000287,GRREC,902,10,34,37,2,0,2,0,1,1,0,0,0,1,1,2,0,0,0,3,1,4,31,31,62,71
20192020,011,BOYLE,143,Danville Independent,"",---District Total---,143,"","",CKEC,901,All Students,858,975,156,145,301,2,2,4,5,5,10,120,104,224,0,0,0,113,106,219,579,496,1075,1833
20192020,011,BOYLE,143,Danville Independent,"",---District Total---,143,"","",CKEC,901,PS,54,68,11,5,16,0,0,0,1,0,1,10,7,17,0,0,0,7,14,21,39,28,67,122
20192020,011,BOYLE,143,Danville Independent,"",---District Total---,143,"","",CKEC,901,KG,75,80,12,14,26,0,0,0,2,0,2,11,12,23,0,0,0,12,6,18,43,43,86,155
20192020,011,BOYLE,143,Danville Independent,"",---District Total---,143,"","",CKEC,901,01,65,77,15,8,23,0,0,0,0,2,2,7,3,10,0,0,0,12,11,23,43,41,84,142
20192020,011,BOYLE,143,Danville Independent,"",---District Total---,143,"","",CKEC,901,02,58,79,11,8,19,0,0,0,0,0,0,8,6,14,0,0,0,12,5,17,48,39,87,137
20192020,011,BOYLE,143,Danville Independent,"",---District Total---,143,"","",CKEC,901,03,77,76,13,7,20,0,1,1,0,0,0,9,16,25,0,0,0,5,12,17,49,41,90,153
20192020,011,BOYLE,143,Danville Independent,"",---District Total---,143,"","",CKEC,901,04,68,75,8,11,19,0,0,0,1,1,2,6,11,17,0,0,0,7,6,13,53,39,92,143
20192020,011,BOYLE,143,Danville Independent,"",---District Total---,143,"","",CKEC,901,05,63,76,12,11,23,0,0,0,0,0,0,17,4,21,0,0,0,8,13,21,39,35,74,139
20192020,011,BOYLE,143,Danville Independent,"",---District Total---,143,"","",CKEC,901,06,68,89,19,13,32,1,0,1,0,0,0,11,9,20,0,0,0,12,7,19,46,39,85,157
20192020,011,BOYLE,143,Danville Independent,"",---District Total---,143,"","",CKEC,901,07,69,73,8,11,19,1,1,2,0,0,0,8,9,17,0,0,0,8,11,19,48,37,85,142
20192020,011,BOYLE,143,Danville Independent,"",---District Total---,143,"","",CKEC,901,08,52,88,12,8,20,0,0,0,0,1,1,10,5,15,0,0,0,14,6,20,52,32,84,140
20192020,011,BOYLE,143,Danville Independent,"",---District Total---,143,"","",CKEC,901,09,69,62,11,16,27,0,0,0,1,0,1,14,10,24,0,0,0,8,8,16,28,35,63,131
20192020,011,BOYLE,143,Danville Independent,"",---District Total---,143,"","",CKEC,901,10,61,66,10,15,25,0,0,0,0,0,0,4,6,10,0,0,0,5,3,8,47,37,84,127
20192020,011,BOYLE,143,Danville Independent,"",---District Total---,143,"","",CKEC,901,11,75,69,13,7,20,0,0,0,0,1,1,8,6,14,0,0,0,5,9,14,43,52,95,144
20192020,011,BOYLE,143,Danville Independent,"",---District Total---,143,"","",CKEC,901,12,58,64,12,16,28,0,0,0,1,0,1,7,7,14,0,0,0,5,9,14,39,26,65,122
20192020,011,BOYLE,143,Danville Independent,"",---District Total---,143,"","",CKEC,901,14,0,1,0,0,0,0,0,0,0,0,0,0,0,0,0,0,0,0,0,0,1,0,1,1
20192020,011,BOYLE,143,Danville Independent,003,Mary G. Hogsett Primary School,143003,011143003,210144002477,CKEC,901,All Students,140,152,26,22,48,0,0,0,2,2,4,18,15,33,0,0,0,24,17,41,82,84,166,292
20192020,011,BOYLE,143,Danville Independent,003,Mary G. Hogsett Primary School,143003,011143003,210144002477,CKEC,901,01,65,75,14,8,22,0,0,0,0,2,2,7,3,10,0,0,0,12,11,23,42,41,83,140
20192020,011,BOYLE,143,Danville Independent,003,Mary G. Hogsett Primary School,143003,011143003,210144002477,CKEC,901,PS,54,68,11,5,16,0,0,0,1,0,1,10,7,17,0,0,0,7,14,21,39,28,67,122
20192020,011,BOYLE,143,Danville Independent,003,Mary G. Hogsett Primary School,143003,011143003,210144002477,CKEC,901,KG,75,77,12,14,26,0,0,0,2,0,2,11,12,23,0,0,0,12,6,18,40,43,83,152
20192020,011,BOYLE,143,Danville Independent,005,John W. Bate Middle School,143005,011143005,210144000290,CKEC,901,06,68,83,18,13,31,1,0,1,0,0,0,9,9,18,0,0,0,12,7,19,43,39,82,151
20192020,011,BOYLE,143,Danville Independent,005,John W. Bate Middle School,143005,011143005,210144000290,CKEC,901,08,52,83,12,8,20,0,0,0,0,1,1,9,5,14,0,0,0,14,6,20,48,32,80,135
20192020,011,BOYLE,143,Danville Independent,005,John W. Bate Middle School,143005,011143005,210144000290,CKEC,901,All Students,189,236,38,32,70,1,1,2,0,1,1,26,23,49,0,0,0,34,24,58,137,108,245,425
20192020,011,BOYLE,143,Danville Independent,005,John W. Bate Middle School,143005,011143005,210144000290,CKEC,901,07,69,70,8,11,19,0,1,1,0,0,0,8,9,17,0,0,0,8,11,19,46,37,83,139
20192020,011,BOYLE,143,Danville Independent,010,Edna L. Toliver Intermediate School,143010,011143010,210144002476,CKEC,901,03,77,74,13,7,20,0,1,1,0,0,0,9,16,25,0,0,0,5,12,17,47,41,88,151
20192020,011,BOYLE,143,Danville Independent,010,Edna L. Toliver Intermediate School,143010,011143010,210144002476,CKEC,901,05,63,70,12,11,23,0,0,0,0,0,0,16,4,20,0,0,0,8,13,21,34,35,69,133
20192020,011,BOYLE,143,Danville Independent,010,Edna L. Toliver Intermediate School,143010,011143010,210144002476,CKEC,901,All Students,266,293,42,37,79,0,1,1,1,1,2,39,37,76,0,0,0,32,36,68,179,154,333,559
20192020,011,BOYLE,143,Danville Independent,010,Edna L. Toliver Intermediate School,143010,011143010,210144002476,CKEC,901,02,58,77,11,8,19,0,0,0,0,0,0,8,6,14,0,0,0,12,5,17,46,39,85,135
20192020,011,BOYLE,143,Danville Independent,010,Edna L. Toliver Intermediate School,143010,011143010,210144002476,CKEC,901,04,68,72,6,11,17,0,0,0,1,1,2,6,11,17,0,0,0,7,6,13,52,39,91,140
20192020,011,BOYLE,143,Danville Independent,030,Danville High School,143030,011143030,210144000291,CKEC,901,10,61,63,10,15,25,0,0,0,0,0,0,4,6,10,0,0,0,5,3,8,44,37,81,124
20192020,011,BOYLE,143,Danville Independent,030,Danville High School,143030,011143030,210144000291,CKEC,901,14,0,1,0,0,0,0,0,0,0,0,0,0,0,0,0,0,0,0,0,0,1,0,1,1
20192020,011,BOYLE,143,Danville Independent,030,Danville High School,143030,011143030,210144000291,CKEC,901,12,58,64,12,16,28,0,0,0,1,0,1,7,7,14,0,0,0,5,9,14,39,26,65,122
20192020,011,BOYLE,143,Danville Independent,030,Danville High School,143030,011143030,210144000291,CKEC,901,All Students,263,256,46,54,100,0,0,0,2,1,3,32,29,61,0,0,0,23,29,52,153,150,303,519
20192020,011,BOYLE,143,Danville Independent,030,Danville High School,143030,011143030,210144000291,CKEC,901,09,69,60,11,16,27,0,0,0,1,0,1,13,10,23,0,0,0,8,8,16,27,35,62,129
20192020,011,BOYLE,143,Danville Independent,030,Danville High School,143030,011143030,210144000291,CKEC,901,11,75,68,13,7,20,0,0,0,0,1,1,8,6,14,0,0,0,5,9,14,42,52,94,143
20192020,011,BOYLE,143,Danville Independent,350,Sunrise Academy,143350,011143350,210144000646,CKEC,901,01,0,2,1,0,1,0,0,0,0,0,0,0,0,0,0,0,0,0,0,0,1,0,1,2
20192020,011,BOYLE,143,Danville Independent,350,Sunrise Academy,143350,011143350,210144000646,CKEC,901,All Students,0,38,4,0,4,1,0,1,0,0,0,5,0,5,0,0,0,0,0,0,28,0,28,38
20192020,011,BOYLE,143,Danville Independent,350,Sunrise Academy,143350,011143350,210144000646,CKEC,901,KG,0,3,0,0,0,0,0,0,0,0,0,0,0,0,0,0,0,0,0,0,3,0,3,3
20192020,011,BOYLE,143,Danville Independent,350,Sunrise Academy,143350,011143350,210144000646,CKEC,901,02,0,2,0,0,0,0,0,0,0,0,0,0,0,0,0,0,0,0,0,0,2,0,2,2
20192020,011,BOYLE,143,Danville Independent,350,Sunrise Academy,143350,011143350,210144000646,CKEC,901,03,0,2,0,0,0,0,0,0,0,0,0,0,0,0,0,0,0,0,0,0,2,0,2,2
20192020,011,BOYLE,143,Danville Independent,350,Sunrise Academy,143350,011143350,210144000646,CKEC,901,04,0,3,2,0,2,0,0,0,0,0,0,0,0,0,0,0,0,0,0,0,1,0,1,3
20192020,011,BOYLE,143,Danville Independent,350,Sunrise Academy,143350,011143350,210144000646,CKEC,901,05,0,6,0,0,0,0,0,0,0,0,0,1,0,1,0,0,0,0,0,0,5,0,5,6
20192020,011,BOYLE,143,Danville Independent,350,Sunrise Academy,143350,011143350,210144000646,CKEC,901,06,0,6,1,0,1,0,0,0,0,0,0,2,0,2,0,0,0,0,0,0,3,0,3,6
20192020,011,BOYLE,143,Danville Independent,350,Sunrise Academy,143350,011143350,210144000646,CKEC,901,07,0,3,0,0,0,1,0,1,0,0,0,0,0,0,0,0,0,0,0,0,2,0,2,3
20192020,011,BOYLE,143,Danville Independent,350,Sunrise Academy,143350,011143350,210144000646,CKEC,901,08,0,5,0,0,0,0,0,0,0,0,0,1,0,1,0,0,0,0,0,0,4,0,4,5
20192020,011,BOYLE,143,Danville Independent,350,Sunrise Academy,143350,011143350,210144000646,CKEC,901,09,0,2,0,0,0,0,0,0,0,0,0,1,0,1,0,0,0,0,0,0,1,0,1,2
20192020,011,BOYLE,143,Danville Independent,350,Sunrise Academy,143350,011143350,210144000646,CKEC,901,10,0,3,0,0,0,0,0,0,0,0,0,0,0,0,0,0,0,0,0,0,3,0,3,3
20192020,011,BOYLE,143,Danville Independent,350,Sunrise Academy,143350,011143350,210144000646,CKEC,901,11,0,1,0,0,0,0,0,0,0,0,0,0,0,0,0,0,0,0,0,0,1,0,1,1
20192020,030,DAVIESS,145,Daviess County,"",---District Total---,145,"","",GRREC,902,14,3,9,1,0,1,0,0,0,0,0,0,0,0,0,0,0,0,0,0,0,8,3,11,12
20192020,030,DAVIESS,145,Daviess County,"",---District Total---,145,"","",GRREC,902,All Students,5455,5703,187,172,359,11,13,24,232,242,474,363,348,711,7,9,16,262,249,511,4641,4422,9063,11158
20192020,030,DAVIESS,145,Daviess County,"",---District Total---,145,"","",GRREC,902,PS,290,388,14,7,21,1,0,1,16,18,34,21,23,44,1,0,1,24,11,35,311,231,542,678
20192020,030,DAVIESS,145,Daviess County,"",---District Total---,145,"","",GRREC,902,KG,410,418,11,14,25,3,3,6,19,23,42,27,19,46,0,1,1,23,22,45,335,328,663,828
20192020,030,DAVIESS,145,Daviess County,"",---District Total---,145,"","",GRREC,902,01,456,526,17,17,34,1,2,3,21,18,39,37,31,68,1,1,2,28,32,60,421,355,776,982
20192020,030,DAVIESS,145,Daviess County,"",---District Total---,145,"","",GRREC,902,02,424,395,14,14,28,2,1,3,18,28,46,28,32,60,0,0,0,19,22,41,314,327,641,819
20192020,030,DAVIESS,145,Daviess County,"",---District Total---,145,"","",GRREC,902,03,409,450,17,15,32,1,2,3,19,23,42,30,31,61,0,1,1,26,16,42,357,321,678,859
20192020,030,DAVIESS,145,Daviess County,"",---District Total---,145,"","",GRREC,902,04,435,441,12,7,19,1,1,2,19,18,37,38,26,64,1,1,2,28,23,51,342,359,701,876
20192020,030,DAVIESS,145,Daviess County,"",---District Total---,145,"","",GRREC,902,05,412,428,10,19,29,1,0,1,11,20,31,33,29,62,0,1,1,16,27,43,357,316,673,840
20192020,030,DAVIESS,145,Daviess County,"",---District Total---,145,"","",GRREC,902,06,475,421,14,12,26,0,2,2,9,24,33,27,35,62,2,0,2,19,16,35,350,386,736,896
20192020,030,DAVIESS,145,Daviess County,"",---District Total---,145,"","",GRREC,902,07,408,429,18,8,26,0,0,0,23,13,36,26,36,62,0,0,0,23,12,35,339,339,678,837
20192020,030,DAVIESS,145,Daviess County,"",---District Total---,145,"","",GRREC,902,08,407,417,13,13,26,1,2,3,22,13,35,23,25,48,1,1,2,15,19,34,342,334,676,824
20192020,030,DAVIESS,145,Daviess County,"",---District Total---,145,"","",GRREC,902,09,424,481,16,12,28,0,0,0,28,17,45,33,25,58,1,0,1,23,18,41,380,352,732,905
20192020,030,DAVIESS,145,Daviess County,"",---District Total---,145,"","",GRREC,902,10,447,475,15,19,34,1,0,1,22,19,41,31,25,56,1,0,1,17,19,36,388,365,753,922
20192020,030,DAVIESS,145,Daviess County,"",---District Total---,145,"","",GRREC,902,11,403,399,15,14,29,0,0,0,13,14,27,14,17,31,0,2,2,7,14,21,350,342,692,802
20192020,030,DAVIESS,145,Daviess County,"",---District Total---,145,"","",GRREC,902,12,342,414,14,8,22,0,0,0,8,12,20,16,17,33,0,1,1,18,9,27,358,295,653,756
20192020,030,DAVIESS,145,Daviess County,005,Apollo High School,145005,030145005,210147000295,GRREC,902,12,126,147,5,4,9,0,0,0,6,8,14,8,7,15,0,1,1,9,3,12,119,103,222,273
20192020,030,DAVIESS,145,Daviess County,005,Apollo High School,145005,030145005,210147000295,GRREC,902,All Students,702,743,30,38,68,1,0,1,44,47,91,49,52,101,2,3,5,39,33,72,578,529,1107,1445
20192020,030,DAVIESS,145,Daviess County,005,Apollo High School,145005,030145005,210147000295,GRREC,902,08,0,1,0,0,0,0,0,0,0,0,0,0,0,0,0,0,0,0,0,0,1,0,1,1
20192020,030,DAVIESS,145,Daviess County,005,Apollo High School,145005,030145005,210147000295,GRREC,902,09,196,209,9,9,18,0,0,0,15,14,29,12,19,31,1,0,1,15,10,25,157,144,301,405
20192020,030,DAVIESS,145,Daviess County,005,Apollo High School,145005,030145005,210147000295,GRREC,902,10,188,209,7,13,20,1,0,1,13,11,24,23,12,35,1,0,1,9,10,19,155,142,297,397
20192020,030,DAVIESS,145,Daviess County,005,Apollo High School,145005,030145005,210147000295,GRREC,902,11,192,171,8,12,20,0,0,0,10,14,24,6,14,20,0,2,2,6,10,16,141,140,281,363
20192020,030,DAVIESS,145,Daviess County,005,Apollo High School,145005,030145005,210147000295,GRREC,902,14,0,6,1,0,1,0,0,0,0,0,0,0,0,0,0,0,0,0,0,0,5,0,5,6
20192020,030,DAVIESS,145,Daviess County,006,Meadow Lands Elementary School,145006,030145006,210147001949,GRREC,902,04,29,36,0,1,1,0,0,0,0,0,0,5,1,6,0,0,0,1,2,3,30,25,55,65
20192020,030,DAVIESS,145,Daviess County,006,Meadow Lands Elementary School,145006,030145006,210147001949,GRREC,902,All Students,200,232,3,6,9,1,0,1,1,1,2,29,16,45,0,0,0,11,8,19,187,169,356,432
20192020,030,DAVIESS,145,Daviess County,006,Meadow Lands Elementary School,145006,030145006,210147001949,GRREC,902,PS,18,20,0,0,0,1,0,1,0,1,1,4,2,6,0,0,0,0,0,0,15,15,30,38
20192020,030,DAVIESS,145,Daviess County,006,Meadow Lands Elementary School,145006,030145006,210147001949,GRREC,902,KG,33,32,0,1,1,1,0,1,0,0,0,1,1,2,0,0,0,0,2,2,30,29,59,65
20192020,030,DAVIESS,145,Daviess County,006,Meadow Lands Elementary School,145006,030145006,210147001949,GRREC,902,01,40,45,0,0,0,0,0,0,1,0,1,7,4,11,0,0,0,3,1,4,34,35,69,85
20192020,030,DAVIESS,145,Daviess County,006,Meadow Lands Elementary School,145006,030145006,210147001949,GRREC,902,02,37,37,1,1,2,0,0,0,0,1,1,4,4,8,0,0,0,2,1,3,30,30,60,74
20192020,030,DAVIESS,145,Daviess County,006,Meadow Lands Elementary School,145006,030145006,210147001949,GRREC,902,03,28,32,2,1,3,0,0,0,0,0,0,3,4,7,0,0,0,1,0,1,26,23,49,60
20192020,030,DAVIESS,145,Daviess County,006,Meadow Lands Elementary School,145006,030145006,210147001949,GRREC,902,05,33,50,0,2,2,0,0,0,0,0,0,9,2,11,0,0,0,4,2,6,37,27,64,83
20192020,030,DAVIESS,145,Daviess County,007,East View Elementary School,145007,030145007,210147001625,GRREC,902,04,41,38,0,0,0,1,0,1,0,0,0,6,4,10,0,0,0,3,1,4,28,36,64,79
20192020,030,DAVIESS,145,Daviess County,007,East View Elementary School,145007,030145007,210147001625,GRREC,902,All Students,252,259,2,1,3,2,0,2,0,0,0,31,28,59,0,0,0,13,13,26,211,210,421,511
20192020,030,DAVIESS,145,Daviess County,007,East View Elementary School,145007,030145007,210147001625,GRREC,902,PS,24,32,0,0,0,0,0,0,0,0,0,3,2,5,0,0,0,0,0,0,29,22,51,56
20192020,030,DAVIESS,145,Daviess County,007,East View Elementary School,145007,030145007,210147001625,GRREC,902,KG,35,40,0,0,0,0,0,0,0,0,0,6,2,8,0,0,0,3,2,5,31,31,62,75
20192020,030,DAVIESS,145,Daviess County,007,East View Elementary School,145007,030145007,210147001625,GRREC,902,01,48,54,1,0,1,0,0,0,0,0,0,5,6,11,0,0,0,3,5,8,45,37,82,102
20192020,030,DAVIESS,145,Daviess County,007,East View Elementary School,145007,030145007,210147001625,GRREC,902,02,47,40,0,0,0,0,0,0,0,0,0,6,8,14,0,0,0,4,1,5,30,38,68,87
20192020,030,DAVIESS,145,Daviess County,007,East View Elementary School,145007,030145007,210147001625,GRREC,902,03,48,42,0,0,0,0,0,0,0,0,0,3,4,7,0,0,0,0,2,2,39,42,81,90
20192020,030,DAVIESS,145,Daviess County,007,East View Elementary School,145007,030145007,210147001625,GRREC,902,05,33,45,1,1,2,1,0,1,0,0,0,5,4,9,0,0,0,0,2,2,38,26,64,78
20192020,030,DAVIESS,145,Daviess County,008,F T Burns Middle School,145008,030145008,210147000296,GRREC,902,06,152,139,8,5,13,0,1,1,4,8,12,14,11,25,2,0,2,6,6,12,105,121,226,291
20192020,030,DAVIESS,145,Daviess County,008,F T Burns Middle School,145008,030145008,210147000296,GRREC,902,07,127,141,8,3,11,0,0,0,11,5,16,6,12,18,0,0,0,10,4,14,106,103,209,268
20192020,030,DAVIESS,145,Daviess County,008,F T Burns Middle School,145008,030145008,210147000296,GRREC,902,08,142,123,8,8,16,1,0,1,5,6,11,9,9,18,1,1,2,6,8,14,93,110,203,265
20192020,030,DAVIESS,145,Daviess County,008,F T Burns Middle School,145008,030145008,210147000296,GRREC,902,All Students,421,403,24,16,40,1,1,2,20,19,39,29,32,61,3,1,4,22,18,40,304,334,638,824
20192020,030,DAVIESS,145,Daviess County,010,Daviess County High School,145010,030145010,210147000297,GRREC,902,11,188,182,3,2,5,0,0,0,3,0,3,7,3,10,0,0,0,1,3,4,168,180,348,370
20192020,030,DAVIESS,145,Daviess County,010,Daviess County High School,145010,030145010,210147000297,GRREC,902,14,3,3,0,0,0,0,0,0,0,0,0,0,0,0,0,0,0,0,0,0,3,3,6,6
20192020,030,DAVIESS,145,Daviess County,010,Daviess County High School,145010,030145010,210147000297,GRREC,902,12,174,194,6,1,7,0,0,0,2,3,5,6,6,12,0,0,0,6,2,8,174,162,336,368
20192020,030,DAVIESS,145,Daviess County,010,Daviess County High School,145010,030145010,210147000297,GRREC,902,All Students,831,864,20,10,30,0,0,0,27,14,41,41,27,68,0,0,0,18,18,36,758,762,1520,1695
20192020,030,DAVIESS,145,Daviess County,010,Daviess County High School,145010,030145010,210147000297,GRREC,902,09,224,255,6,3,9,0,0,0,13,3,16,20,6,26,0,0,0,7,6,13,209,206,415,479
20192020,030,DAVIESS,145,Daviess County,010,Daviess County High School,145010,030145010,210147000297,GRREC,902,10,242,230,5,4,9,0,0,0,9,8,17,8,12,20,0,0,0,4,7,11,204,211,415,472
20192020,030,DAVIESS,145,Daviess County,011,Southern Oaks Elementary School,145011,030145011,210147002230,GRREC,902,04,34,40,0,0,0,0,0,0,6,3,9,3,2,5,0,0,0,1,3,4,30,26,56,74
20192020,030,DAVIESS,145,Daviess County,011,Southern Oaks Elementary School,145011,030145011,210147002230,GRREC,902,All Students,204,223,1,3,4,0,0,0,23,21,44,29,17,46,0,0,0,8,5,13,162,158,320,427
20192020,030,DAVIESS,145,Daviess County,011,Southern Oaks Elementary School,145011,030145011,210147002230,GRREC,902,PS,13,25,0,1,1,0,0,0,3,1,4,3,1,4,0,0,0,1,0,1,18,10,28,38
20192020,030,DAVIESS,145,Daviess County,011,Southern Oaks Elementary School,145011,030145011,210147002230,GRREC,902,KG,37,31,0,0,0,0,0,0,4,8,12,2,3,5,0,0,0,1,2,3,24,24,48,68
20192020,030,DAVIESS,145,Daviess County,011,Southern Oaks Elementary School,145011,030145011,210147002230,GRREC,902,01,38,48,0,2,2,0,0,0,3,1,4,7,2,9,0,0,0,1,0,1,37,33,70,86
20192020,030,DAVIESS,145,Daviess County,011,Southern Oaks Elementary School,145011,030145011,210147002230,GRREC,902,02,29,40,0,1,1,0,0,0,7,3,10,6,4,10,0,0,0,2,0,2,25,21,46,69
20192020,030,DAVIESS,145,Daviess County,011,Southern Oaks Elementary School,145011,030145011,210147002230,GRREC,902,03,30,37,1,0,1,0,0,0,2,3,5,6,3,9,0,0,0,2,0,2,26,24,50,67
20192020,030,DAVIESS,145,Daviess County,011,Southern Oaks Elementary School,145011,030145011,210147002230,GRREC,902,05,36,27,0,0,0,0,0,0,1,3,4,5,3,8,0,0,0,1,0,1,20,30,50,63
20192020,030,DAVIESS,145,Daviess County,015,The Center for Academic Improvement,145015,030145015,210147002470,GRREC,902,11,0,0,0,0,0,0,0,0,0,0,0,0,0,0,0,0,0,0,0,0,0,0,0,0
20192020,030,DAVIESS,145,Daviess County,015,The Center for Academic Improvement,145015,030145015,210147002470,GRREC,902,All Students,0,0,0,0,0,0,0,0,0,0,0,0,0,0,0,0,0,0,0,0,0,0,0,0
20192020,030,DAVIESS,145,Daviess County,015,The Center for Academic Improvement,145015,030145015,210147002470,GRREC,902,06,0,0,0,0,0,0,0,0,0,0,0,0,0,0,0,0,0,0,0,0,0,0,0,0
20192020,030,DAVIESS,145,Daviess County,015,The Center for Academic Improvement,145015,030145015,210147002470,GRREC,902,07,0,0,0,0,0,0,0,0,0,0,0,0,0,0,0,0,0,0,0,0,0,0,0,0
20192020,030,DAVIESS,145,Daviess County,015,The Center for Academic Improvement,145015,030145015,210147002470,GRREC,902,08,0,0,0,0,0,0,0,0,0,0,0,0,0,0,0,0,0,0,0,0,0,0,0,0
20192020,030,DAVIESS,145,Daviess County,015,The Center for Academic Improvement,145015,030145015,210147002470,GRREC,902,09,0,0,0,0,0,0,0,0,0,0,0,0,0,0,0,0,0,0,0,0,0,0,0,0
20192020,030,DAVIESS,145,Daviess County,015,The Center for Academic Improvement,145015,030145015,210147002470,GRREC,902,10,0,0,0,0,0,0,0,0,0,0,0,0,0,0,0,0,0,0,0,0,0,0,0,0
20192020,030,DAVIESS,145,Daviess County,015,The Center for Academic Improvement,145015,030145015,210147002470,GRREC,902,12,0,0,0,0,0,0,0,0,0,0,0,0,0,0,0,0,0,0,0,0,0,0,0,0
20192020,030,DAVIESS,145,Daviess County,020,Daviess County Middle School,145020,030145020,210147000298,GRREC,902,07,156,131,4,3,7,0,0,0,4,4,8,9,12,21,0,0,0,11,5,16,103,132,235,287
20192020,030,DAVIESS,145,Daviess County,020,Daviess County Middle School,145020,030145020,210147000298,GRREC,902,All Students,436,426,6,6,12,0,2,2,12,10,22,20,33,53,0,0,0,21,17,38,367,368,735,862
20192020,030,DAVIESS,145,Daviess County,020,Daviess County Middle School,145020,030145020,210147000298,GRREC,902,06,151,143,0,0,0,0,0,0,1,4,5,5,15,20,0,0,0,6,3,9,131,129,260,294
20192020,030,DAVIESS,145,Daviess County,020,Daviess County Middle School,145020,030145020,210147000298,GRREC,902,08,129,152,2,3,5,0,2,2,7,2,9,6,6,12,0,0,0,4,9,13,133,107,240,281
20192020,030,DAVIESS,145,Daviess County,025,Highland Elementary School,145025,030145025,210147000299,GRREC,902,05,40,43,1,3,4,0,0,0,4,5,9,0,2,2,0,0,0,2,1,3,36,29,65,83
20192020,030,DAVIESS,145,Daviess County,025,Highland Elementary School,145025,030145025,210147000299,GRREC,902,All Students,229,282,11,9,20,1,1,2,27,25,52,10,4,14,0,0,0,15,9,24,218,181,399,511
20192020,030,DAVIESS,145,Daviess County,025,Highland Elementary School,145025,030145025,210147000299,GRREC,902,PS,26,44,2,0,2,0,0,0,2,1,3,1,1,2,0,0,0,5,0,5,34,24,58,70
20192020,030,DAVIESS,145,Daviess County,025,Highland Elementary School,145025,030145025,210147000299,GRREC,902,KG,29,44,2,2,4,0,0,0,6,1,7,2,0,2,0,0,0,1,2,3,33,24,57,73
20192020,030,DAVIESS,145,Daviess County,025,Highland Elementary School,145025,030145025,210147000299,GRREC,902,01,35,57,5,2,7,0,0,0,8,2,10,4,0,4,0,0,0,3,2,5,37,29,66,92
20192020,030,DAVIESS,145,Daviess County,025,Highland Elementary School,145025,030145025,210147000299,GRREC,902,02,46,43,0,1,1,1,0,1,5,9,14,1,0,1,0,0,0,2,2,4,34,34,68,89
20192020,030,DAVIESS,145,Daviess County,025,Highland Elementary School,145025,030145025,210147000299,GRREC,902,03,38,45,1,0,1,0,1,1,1,6,7,1,0,1,0,0,0,4,2,6,38,29,67,83
20192020,030,DAVIESS,145,Daviess County,025,Highland Elementary School,145025,030145025,210147000299,GRREC,902,04,41,50,2,1,3,0,0,0,3,2,5,2,2,4,0,0,0,3,0,3,40,36,76,91
20192020,030,DAVIESS,145,Daviess County,040,Deer Park Elementary School,145040,030145040,210147000301,GRREC,902,05,43,39,2,2,4,0,0,0,1,2,3,3,2,5,0,1,1,2,1,3,31,35,66,82
20192020,030,DAVIESS,145,Daviess County,040,Deer Park Elementary School,145040,030145040,210147000301,GRREC,902,All Students,249,242,13,10,23,1,1,2,22,26,48,11,9,20,0,1,1,11,15,26,184,187,371,491
20192020,030,DAVIESS,145,Daviess County,040,Deer Park Elementary School,145040,030145040,210147000301,GRREC,902,PS,31,43,5,0,5,0,0,0,1,5,6,0,1,1,0,0,0,2,5,7,35,20,55,74
20192020,030,DAVIESS,145,Daviess County,040,Deer Park Elementary School,145040,030145040,210147000301,GRREC,902,KG,37,44,3,3,6,0,0,0,4,4,8,2,1,3,0,0,0,2,4,6,33,25,58,81
20192020,030,DAVIESS,145,Daviess County,040,Deer Park Elementary School,145040,030145040,210147000301,GRREC,902,01,39,53,2,0,2,0,0,0,4,6,10,2,0,2,0,0,0,2,2,4,43,31,74,92
20192020,030,DAVIESS,145,Daviess County,040,Deer Park Elementary School,145040,030145040,210147000301,GRREC,902,02,33,31,2,1,3,1,0,1,2,4,6,1,1,2,0,0,0,1,4,5,24,23,47,64
20192020,030,DAVIESS,145,Daviess County,040,Deer Park Elementary School,145040,030145040,210147000301,GRREC,902,03,47,44,2,2,4,0,0,0,7,6,13,3,1,4,0,0,0,2,1,3,30,37,67,91
20192020,030,DAVIESS,145,Daviess County,040,Deer Park Elementary School,145040,030145040,210147000301,GRREC,902,04,50,31,2,2,4,0,1,1,4,4,8,0,4,4,0,0,0,2,3,5,23,36,59,81
20192020,030,DAVIESS,145,Daviess County,070,Sorgho Elementary School,145070,030145070,210147000303,GRREC,902,05,28,38,2,2,4,0,0,0,0,0,0,2,3,5,0,0,0,1,1,2,33,22,55,66
20192020,030,DAVIESS,145,Daviess County,070,Sorgho Elementary School,145070,030145070,210147000303,GRREC,902,All Students,181,215,5,12,17,0,2,2,1,1,2,21,20,41,0,0,0,8,15,23,180,131,311,396
20192020,030,DAVIESS,145,Daviess County,070,Sorgho Elementary School,145070,030145070,210147000303,GRREC,902,PS,15,26,0,0,0,0,0,0,0,0,0,3,2,5,0,0,0,2,2,4,21,11,32,41
20192020,030,DAVIESS,145,Daviess County,070,Sorgho Elementary School,145070,030145070,210147000303,GRREC,902,KG,31,29,2,2,4,0,2,2,0,1,1,3,4,7,0,0,0,0,0,0,24,22,46,60
20192020,030,DAVIESS,145,Daviess County,070,Sorgho Elementary School,145070,030145070,210147000303,GRREC,902,01,32,32,0,1,1,0,0,0,0,0,0,4,2,6,0,0,0,0,5,5,28,24,52,64
20192020,030,DAVIESS,145,Daviess County,070,Sorgho Elementary School,145070,030145070,210147000303,GRREC,902,02,28,30,0,2,2,0,0,0,0,0,0,3,1,4,0,0,0,1,2,3,26,23,49,58
20192020,030,DAVIESS,145,Daviess County,070,Sorgho Elementary School,145070,030145070,210147000303,GRREC,902,03,30,40,0,4,4,0,0,0,0,0,0,3,3,6,0,0,0,3,5,8,34,18,52,70
20192020,030,DAVIESS,145,Daviess County,070,Sorgho Elementary School,145070,030145070,210147000303,GRREC,902,04,32,46,1,1,2,0,0,0,1,0,1,6,7,13,0,0,0,3,2,5,35,22,57,78
20192020,030,DAVIESS,145,Daviess County,085,Audubon Elementary School,145085,030145085,210147000054,GRREC,902,04,37,34,0,1,1,0,0,0,0,1,1,1,0,1,0,0,0,1,3,4,32,32,64,71
20192020,030,DAVIESS,145,Daviess County,085,Audubon Elementary School,145085,030145085,210147000054,GRREC,902,All Students,201,202,14,13,27,0,0,0,4,8,12,4,7,11,0,0,0,15,17,32,165,156,321,403
20192020,030,DAVIESS,145,Daviess County,085,Audubon Elementary School,145085,030145085,210147000054,GRREC,902,PS,36,43,3,2,5,0,0,0,3,1,4,1,2,3,0,0,0,4,0,4,32,31,63,79
20192020,030,DAVIESS,145,Daviess County,085,Audubon Elementary School,145085,030145085,210147000054,GRREC,902,KG,39,32,2,2,4,0,0,0,0,0,0,2,1,3,0,0,0,3,3,6,25,33,58,71
20192020,030,DAVIESS,145,Daviess County,085,Audubon Elementary School,145085,030145085,210147000054,GRREC,902,01,37,37,3,2,5,0,0,0,1,1,2,0,3,3,0,0,0,2,3,5,31,28,59,74
20192020,030,DAVIESS,145,Daviess County,085,Audubon Elementary School,145085,030145085,210147000054,GRREC,902,02,30,17,2,2,4,0,0,0,0,4,4,0,0,0,0,0,0,1,3,4,14,21,35,47
20192020,030,DAVIESS,145,Daviess County,085,Audubon Elementary School,145085,030145085,210147000054,GRREC,902,03,32,47,6,4,10,0,0,0,2,2,4,0,0,0,0,0,0,5,0,5,34,26,60,79
20192020,030,DAVIESS,145,Daviess County,085,Audubon Elementary School,145085,030145085,210147000054,GRREC,902,05,26,35,1,2,3,0,0,0,1,0,1,1,3,4,0,0,0,3,5,8,29,16,45,61
20192020,030,DAVIESS,145,Daviess County,095,Tamarack Elementary School,145095,030145095,210147000306,GRREC,902,04,32,40,2,0,2,0,0,0,3,3,6,2,2,4,0,0,0,4,2,6,29,25,54,72
20192020,030,DAVIESS,145,Daviess County,095,Tamarack Elementary School,145095,030145095,210147000306,GRREC,902,All Students,246,254,18,16,34,1,1,2,11,23,34,12,19,31,1,2,3,20,13,33,191,172,363,500
20192020,030,DAVIESS,145,Daviess County,095,Tamarack Elementary School,145095,030145095,210147000306,GRREC,902,PS,51,45,2,2,4,0,0,0,3,4,7,2,3,5,1,0,1,10,3,13,27,39,66,96
20192020,030,DAVIESS,145,Daviess County,095,Tamarack Elementary School,145095,030145095,210147000306,GRREC,902,KG,43,45,2,3,5,0,1,1,1,6,7,2,1,3,0,1,1,5,3,8,35,28,63,88
20192020,030,DAVIESS,145,Daviess County,095,Tamarack Elementary School,145095,030145095,210147000306,GRREC,902,01,49,51,4,4,8,1,0,1,2,4,6,3,3,6,1,1,2,4,3,7,36,34,70,100
20192020,030,DAVIESS,145,Daviess County,095,Tamarack Elementary School,145095,030145095,210147000306,GRREC,902,02,40,35,3,4,7,0,0,0,2,3,5,1,4,5,0,0,0,3,2,5,26,27,53,75
20192020,030,DAVIESS,145,Daviess County,095,Tamarack Elementary School,145095,030145095,210147000306,GRREC,902,03,41,45,4,2,6,0,0,0,2,2,4,3,8,11,0,0,0,3,0,3,33,29,62,86
20192020,030,DAVIESS,145,Daviess County,095,Tamarack Elementary School,145095,030145095,210147000306,GRREC,902,05,41,38,3,3,6,0,0,0,1,5,6,1,1,2,0,0,0,1,3,4,32,29,61,79
20192020,030,DAVIESS,145,Daviess County,130,West Louisville Elementary School,145130,030145130,210147000309,GRREC,902,04,28,22,0,0,0,0,0,0,0,0,0,1,1,2,0,0,0,0,0,0,21,27,48,50
20192020,030,DAVIESS,145,Daviess County,130,West Louisville Elementary School,145130,030145130,210147000309,GRREC,902,All Students,153,149,1,0,1,0,0,0,0,0,0,11,8,19,0,0,0,7,4,11,130,141,271,302
20192020,030,DAVIESS,145,Daviess County,130,West Louisville Elementary School,145130,030145130,210147000309,GRREC,902,PS,19,20,0,0,0,0,0,0,0,0,0,2,4,6,0,0,0,0,0,0,18,15,33,39
20192020,030,DAVIESS,145,Daviess County,130,West Louisville Elementary School,145130,030145130,210147000309,GRREC,902,KG,26,20,0,0,0,0,0,0,0,0,0,2,0,2,0,0,0,2,0,2,16,26,42,46
20192020,030,DAVIESS,145,Daviess County,130,West Louisville Elementary School,145130,030145130,210147000309,GRREC,902,01,30,38,0,0,0,0,0,0,0,0,0,2,1,3,0,0,0,2,2,4,34,27,61,68
20192020,030,DAVIESS,145,Daviess County,130,West Louisville Elementary School,145130,030145130,210147000309,GRREC,902,02,27,34,1,0,1,0,0,0,0,0,0,2,3,5,0,0,0,2,0,2,29,24,53,61
20192020,030,DAVIESS,145,Daviess County,130,West Louisville Elementary School,145130,030145130,210147000309,GRREC,902,03,18,17,0,0,0,0,0,0,0,0,0,1,2,3,0,0,0,1,0,1,15,16,31,35
20192020,030,DAVIESS,145,Daviess County,130,West Louisville Elementary School,145130,030145130,210147000309,GRREC,902,05,24,18,0,0,0,0,0,0,0,0,0,3,1,4,0,0,0,0,2,2,15,21,36,42
20192020,030,DAVIESS,145,Daviess County,140,Whitesville Elementary School,145140,030145140,210147000310,GRREC,902,04,28,22,0,0,0,0,0,0,0,0,0,2,0,2,0,0,0,3,1,4,17,27,44,50
20192020,030,DAVIESS,145,Daviess County,140,Whitesville Elementary School,145140,030145140,210147000310,GRREC,902,All Students,147,159,1,1,2,2,0,2,0,0,0,3,3,6,0,0,0,8,7,15,145,136,281,306
20192020,030,DAVIESS,145,Daviess County,140,Whitesville Elementary School,145140,030145140,210147000310,GRREC,902,PS,10,28,0,0,0,0,0,0,0,0,0,0,0,0,0,0,0,0,0,0,28,10,38,38
20192020,030,DAVIESS,145,Daviess County,140,Whitesville Elementary School,145140,030145140,210147000310,GRREC,902,KG,21,29,0,0,0,2,0,2,0,0,0,1,0,1,0,0,0,1,1,2,25,20,45,50
20192020,030,DAVIESS,145,Daviess County,140,Whitesville Elementary School,145140,030145140,210147000310,GRREC,902,01,32,29,0,1,1,0,0,0,0,0,0,0,2,2,0,0,0,3,1,4,26,28,54,61
20192020,030,DAVIESS,145,Daviess County,140,Whitesville Elementary School,145140,030145140,210147000310,GRREC,902,02,29,21,1,0,1,0,0,0,0,0,0,0,0,0,0,0,0,0,2,2,20,27,47,50
20192020,030,DAVIESS,145,Daviess County,140,Whitesville Elementary School,145140,030145140,210147000310,GRREC,902,03,19,33,0,0,0,0,0,0,0,0,0,0,1,1,0,0,0,1,1,2,32,17,49,52
20192020,030,DAVIESS,145,Daviess County,140,Whitesville Elementary School,145140,030145140,210147000310,GRREC,902,05,18,25,0,0,0,0,0,0,0,0,0,0,0,0,0,0,0,0,1,1,25,17,42,43
20192020,030,DAVIESS,145,Daviess County,145,F T Burns Elementary School,145145,030145145,210147000311,GRREC,902,KG,37,39,0,1,1,0,0,0,4,2,6,4,5,9,0,0,0,5,2,7,26,27,53,76
20192020,030,DAVIESS,145,Daviess County,145,F T Burns Elementary School,145145,030145145,210147000311,GRREC,902,All Students,241,222,11,12,23,1,4,5,18,21,39,25,29,54,1,2,3,19,23,42,147,150,297,463
20192020,030,DAVIESS,145,Daviess County,145,F T Burns Elementary School,145145,030145145,210147000311,GRREC,902,PS,31,40,2,1,3,0,0,0,2,4,6,2,5,7,0,0,0,0,1,1,34,20,54,71
20192020,030,DAVIESS,145,Daviess County,145,F T Burns Elementary School,145145,030145145,210147000311,GRREC,902,01,45,44,2,5,7,0,2,2,2,4,6,2,8,10,0,0,0,3,4,7,35,22,57,89
20192020,030,DAVIESS,145,Daviess County,145,F T Burns Elementary School,145145,030145145,210147000311,GRREC,902,02,34,33,4,1,5,0,1,1,2,4,6,4,4,8,0,0,0,1,1,2,22,23,45,67
20192020,030,DAVIESS,145,Daviess County,145,F T Burns Elementary School,145145,030145145,210147000311,GRREC,902,03,43,33,1,2,3,1,1,2,5,3,8,7,3,10,0,1,1,4,5,9,15,28,43,76
20192020,030,DAVIESS,145,Daviess County,145,F T Burns Elementary School,145145,030145145,210147000311,GRREC,902,04,40,40,4,1,5,0,0,0,2,4,6,6,2,8,1,1,2,4,5,9,23,27,50,80
20192020,030,DAVIESS,145,Daviess County,145,F T Burns Elementary School,145145,030145145,210147000311,GRREC,902,05,42,33,0,2,2,0,0,0,3,4,7,2,7,9,0,0,0,2,6,8,26,23,49,75
20192020,030,DAVIESS,145,Daviess County,150,Country Heights Elementary School,145150,030145150,210147001581,GRREC,902,05,47,37,0,2,2,0,0,0,0,1,1,2,1,3,0,0,0,0,3,3,35,40,75,84
20192020,030,DAVIESS,145,Daviess County,150,Country Heights Elementary School,145150,030145150,210147001581,GRREC,902,All Students,241,212,1,3,4,0,0,0,0,4,4,7,8,15,0,0,0,5,13,18,199,213,412,453
20192020,030,DAVIESS,145,Daviess County,150,Country Heights Elementary School,145150,030145150,210147001581,GRREC,902,PS,16,22,0,1,1,0,0,0,2,1,3,0,0,0,0,0,0,0,0,0,20,14,34,38
20192020,030,DAVIESS,145,Daviess County,150,Country Heights Elementary School,145150,030145150,210147001581,GRREC,902,KG,42,31,0,0,0,0,0,0,0,1,1,0,1,1,0,0,0,0,1,1,31,39,70,73
20192020,030,DAVIESS,145,Daviess County,150,Country Heights Elementary School,145150,030145150,210147001581,GRREC,902,01,31,38,0,0,0,0,0,0,0,0,0,1,0,1,0,0,0,2,4,6,35,27,62,69
20192020,030,DAVIESS,145,Daviess County,150,Country Heights Elementary School,145150,030145150,210147001581,GRREC,902,02,43,34,0,1,1,0,0,0,0,0,0,0,3,3,0,0,0,0,4,4,34,35,69,77
20192020,030,DAVIESS,145,Daviess County,150,Country Heights Elementary School,145150,030145150,210147001581,GRREC,902,03,35,33,0,0,0,0,0,0,0,1,1,0,2,2,0,0,0,0,0,0,33,32,65,68
20192020,030,DAVIESS,145,Daviess County,150,Country Heights Elementary School,145150,030145150,210147001581,GRREC,902,04,43,39,1,0,1,0,0,0,0,1,1,4,1,5,0,0,0,3,1,4,31,40,71,82
20192020,030,DAVIESS,145,Daviess County,155,College View Middle School,145155,030145155,210147000961,GRREC,902,07,123,156,6,2,8,0,0,0,8,4,12,11,12,23,0,0,0,2,2,4,129,103,232,279
20192020,030,DAVIESS,145,Daviess County,155,College View Middle School,145155,030145155,210147000961,GRREC,902,All Students,431,428,14,11,25,0,1,1,22,21,43,27,31,58,0,0,0,14,11,25,351,356,707,859
20192020,030,DAVIESS,145,Daviess County,155,College View Middle School,145155,030145155,210147000961,GRREC,902,06,172,136,5,7,12,0,1,1,4,12,16,8,9,17,0,0,0,7,7,14,112,136,248,308
20192020,030,DAVIESS,145,Daviess County,155,College View Middle School,145155,030145155,210147000961,GRREC,902,08,136,136,3,2,5,0,0,0,10,5,15,8,10,18,0,0,0,5,2,7,110,117,227,272
20192020,030,DAVIESS,145,Daviess County,160,Owensboro Day Treatment,145160,030145160,210147000312,GRREC,902,09,3,7,0,0,0,0,0,0,0,0,0,0,0,0,0,0,0,1,1,2,6,2,8,10
20192020,030,DAVIESS,145,Daviess County,160,Owensboro Day Treatment,145160,030145160,210147000312,GRREC,902,All Students,6,19,1,1,2,0,0,0,0,0,0,0,0,0,0,0,0,2,2,4,16,3,19,25
20192020,030,DAVIESS,145,Daviess County,160,Owensboro Day Treatment,145160,030145160,210147000312,GRREC,902,07,0,1,0,0,0,0,0,0,0,0,0,0,0,0,0,0,0,0,0,0,1,0,1,1
20192020,030,DAVIESS,145,Daviess County,160,Owensboro Day Treatment,145160,030145160,210147000312,GRREC,902,08,0,2,0,0,0,0,0,0,0,0,0,0,0,0,0,0,0,0,0,0,2,0,2,2
20192020,030,DAVIESS,145,Daviess County,160,Owensboro Day Treatment,145160,030145160,210147000312,GRREC,902,10,3,3,0,1,1,0,0,0,0,0,0,0,0,0,0,0,0,0,1,1,3,1,4,6
20192020,030,DAVIESS,145,Daviess County,160,Owensboro Day Treatment,145160,030145160,210147000312,GRREC,902,11,0,5,1,0,1,0,0,0,0,0,0,0,0,0,0,0,0,0,0,0,4,0,4,5
20192020,030,DAVIESS,145,Daviess County,160,Owensboro Day Treatment,145160,030145160,210147000312,GRREC,902,12,0,1,0,0,0,0,0,0,0,0,0,0,0,0,0,0,0,1,0,1,0,0,0,1
20192020,030,DAVIESS,145,Daviess County,170,Valley High School,145170,030145170,210147001700,GRREC,902,11,2,1,0,0,0,0,0,0,0,0,0,0,0,0,0,0,0,0,0,0,1,2,3,3
20192020,030,DAVIESS,145,Daviess County,170,Valley High School,145170,030145170,210147001700,GRREC,902,12,1,0,0,0,0,0,0,0,0,0,0,0,0,0,0,0,0,0,0,0,0,1,1,1
20192020,030,DAVIESS,145,Daviess County,170,Valley High School,145170,030145170,210147001700,GRREC,902,All Students,4,7,1,0,1,0,0,0,0,0,0,0,0,0,0,0,0,0,0,0,6,4,10,11
20192020,030,DAVIESS,145,Daviess County,170,Valley High School,145170,030145170,210147001700,GRREC,902,09,0,5,1,0,1,0,0,0,0,0,0,0,0,0,0,0,0,0,0,0,4,0,4,5
20192020,030,DAVIESS,145,Daviess County,170,Valley High School,145170,030145170,210147001700,GRREC,902,10,1,1,0,0,0,0,0,0,0,0,0,0,0,0,0,0,0,0,0,0,1,1,2,2
20192020,030,DAVIESS,145,Daviess County,175,Valley Elementary School,145175,030145175,210147000964,GRREC,902,04,0,3,0,0,0,0,0,0,0,0,0,0,0,0,0,0,0,0,0,0,3,0,3,3
20192020,030,DAVIESS,145,Daviess County,175,Valley Elementary School,145175,030145175,210147000964,GRREC,902,08,0,3,0,0,0,0,0,0,0,0,0,0,0,0,0,0,0,0,0,0,3,0,3,3
20192020,030,DAVIESS,145,Daviess County,175,Valley Elementary School,145175,030145175,210147000964,GRREC,902,05,1,0,0,0,0,0,0,0,0,0,0,0,0,0,0,0,0,0,0,0,0,1,1,1
20192020,030,DAVIESS,145,Daviess County,175,Valley Elementary School,145175,030145175,210147000964,GRREC,902,07,2,0,0,0,0,0,0,0,0,0,0,0,0,0,0,0,0,0,1,1,0,1,1,2
20192020,030,DAVIESS,145,Daviess County,175,Valley Elementary School,145175,030145175,210147000964,GRREC,902,06,0,3,1,0,1,0,0,0,0,0,0,0,0,0,0,0,0,0,0,0,2,0,2,3
20192020,030,DAVIESS,145,Daviess County,175,Valley Elementary School,145175,030145175,210147000964,GRREC,902,All Students,4,13,1,0,1,0,0,0,0,0,0,0,0,0,0,0,0,0,1,1,12,3,15,17
20192020,030,DAVIESS,145,Daviess County,175,Valley Elementary School,145175,030145175,210147000964,GRREC,902,KG,0,2,0,0,0,0,0,0,0,0,0,0,0,0,0,0,0,0,0,0,2,0,2,2
20192020,030,DAVIESS,145,Daviess County,175,Valley Elementary School,145175,030145175,210147000964,GRREC,902,02,1,0,0,0,0,0,0,0,0,0,0,0,0,0,0,0,0,0,0,0,0,1,1,1
20192020,030,DAVIESS,145,Daviess County,175,Valley Elementary School,145175,030145175,210147000964,GRREC,902,03,0,2,0,0,0,0,0,0,0,0,0,0,0,0,0,0,0,0,0,0,2,0,2,2
20192020,030,DAVIESS,145,Daviess County,180,Heritage Park High School,145180,030145180,210147000969,GRREC,902,10,13,32,3,1,4,0,0,0,0,0,0,0,1,1,0,0,0,4,1,5,25,10,35,45
20192020,030,DAVIESS,145,Daviess County,180,Heritage Park High School,145180,030145180,210147000969,GRREC,902,12,41,72,3,3,6,0,0,0,0,1,1,2,4,6,0,0,0,2,4,6,65,29,94,113
20192020,030,DAVIESS,145,Daviess County,180,Heritage Park High School,145180,030145180,210147000969,GRREC,902,All Students,76,149,9,4,13,0,0,0,0,1,1,4,5,9,0,0,0,6,7,13,130,59,189,225
20192020,030,DAVIESS,145,Daviess County,180,Heritage Park High School,145180,030145180,210147000969,GRREC,902,09,1,5,0,0,0,0,0,0,0,0,0,1,0,1,0,0,0,0,1,1,4,0,4,6
20192020,030,DAVIESS,145,Daviess County,180,Heritage Park High School,145180,030145180,210147000969,GRREC,902,11,21,40,3,0,3,0,0,0,0,0,0,1,0,1,0,0,0,0,1,1,36,20,56,61
20192020,054,HOPKINS,146,Dawson Springs Independent,"",---District Total---,146,"","",WKEC,908,08,11,21,0,0,0,0,0,0,0,0,0,0,2,2,0,0,0,1,0,1,20,9,29,32
20192020,054,HOPKINS,146,Dawson Springs Independent,"",---District Total---,146,"","",WKEC,908,All Students,263,285,2,0,2,0,0,0,0,1,1,2,4,6,0,0,0,12,4,16,269,254,523,548
20192020,054,HOPKINS,146,Dawson Springs Independent,"",---District Total---,146,"","",WKEC,908,PS,23,20,0,1,1,0,0,0,0,0,0,0,0,0,0,0,0,2,1,3,18,21,39,43
20192020,054,HOPKINS,146,Dawson Springs Independent,"",---District Total---,146,"","",WKEC,908,KG,19,18,0,0,0,0,0,0,0,0,0,0,0,0,0,0,0,3,2,5,15,17,32,37
20192020,054,HOPKINS,146,Dawson Springs Independent,"",---District Total---,146,"","",WKEC,908,01,27,22,0,0,0,0,0,0,0,0,0,0,0,0,0,0,0,0,0,0,22,27,49,49
20192020,054,HOPKINS,146,Dawson Springs Independent,"",---District Total---,146,"","",WKEC,908,02,17,16,0,0,0,0,0,0,0,0,0,0,0,0,0,0,0,0,1,1,16,16,32,33
20192020,054,HOPKINS,146,Dawson Springs Independent,"",---District Total---,146,"","",WKEC,908,03,14,26,0,0,0,0,0,0,0,0,0,0,0,0,0,0,0,1,0,1,25,14,39,40
20192020,054,HOPKINS,146,Dawson Springs Independent,"",---District Total---,146,"","",WKEC,908,04,27,22,0,0,0,0,0,0,0,1,1,0,1,1,0,0,0,2,1,3,20,24,44,49
20192020,054,HOPKINS,146,Dawson Springs Independent,"",---District Total---,146,"","",WKEC,908,05,21,19,0,0,0,0,0,0,0,0,0,0,0,0,0,0,0,1,0,1,18,21,39,40
20192020,054,HOPKINS,146,Dawson Springs Independent,"",---District Total---,146,"","",WKEC,908,06,6,28,1,0,1,0,0,0,0,0,0,1,0,1,0,0,0,0,0,0,26,6,32,34
20192020,054,HOPKINS,146,Dawson Springs Independent,"",---District Total---,146,"","",WKEC,908,07,25,17,1,0,1,0,0,0,0,0,0,0,0,0,0,0,0,2,0,2,14,25,39,42
20192020,054,HOPKINS,146,Dawson Springs Independent,"",---District Total---,146,"","",WKEC,908,09,25,26,0,0,0,0,0,0,0,0,0,0,1,1,0,0,0,2,0,2,24,24,48,51
20192020,054,HOPKINS,146,Dawson Springs Independent,"",---District Total---,146,"","",WKEC,908,10,28,22,0,0,0,0,0,0,0,0,0,0,0,0,0,0,0,0,0,0,22,28,50,50
20192020,054,HOPKINS,146,Dawson Springs Independent,"",---District Total---,146,"","",WKEC,908,11,21,26,0,0,0,0,0,0,0,0,0,1,0,1,0,0,0,0,0,0,25,21,46,47
20192020,054,HOPKINS,146,Dawson Springs Independent,"",---District Total---,146,"","",WKEC,908,12,22,21,0,0,0,0,0,0,0,0,0,0,0,0,0,0,0,0,0,0,21,22,43,43
20192020,054,HOPKINS,146,Dawson Springs Independent,"",---District Total---,146,"","",WKEC,908,14,0,1,0,0,0,0,0,0,0,0,0,0,0,0,0,0,0,0,0,0,1,0,1,1
20192020,054,HOPKINS,146,Dawson Springs Independent,017,Dawson Springs Elementary,146017,054146017,210150002200,WKEC,908,06,6,28,1,0,1,0,0,0,0,0,0,1,0,1,0,0,0,0,0,0,26,6,32,34
20192020,054,HOPKINS,146,Dawson Springs Independent,017,Dawson Springs Elementary,146017,054146017,210150002200,WKEC,908,All Students,131,151,1,0,1,0,0,0,0,1,1,1,1,2,0,0,0,7,4,11,142,125,267,282
20192020,054,HOPKINS,146,Dawson Springs Independent,017,Dawson Springs Elementary,146017,054146017,210150002200,WKEC,908,PS,23,20,0,1,1,0,0,0,0,0,0,0,0,0,0,0,0,2,1,3,18,21,39,43
20192020,054,HOPKINS,146,Dawson Springs Independent,017,Dawson Springs Elementary,146017,054146017,210150002200,WKEC,908,KG,19,18,0,0,0,0,0,0,0,0,0,0,0,0,0,0,0,3,2,5,15,17,32,37
20192020,054,HOPKINS,146,Dawson Springs Independent,017,Dawson Springs Elementary,146017,054146017,210150002200,WKEC,908,01,27,22,0,0,0,0,0,0,0,0,0,0,0,0,0,0,0,0,0,0,22,27,49,49
20192020,054,HOPKINS,146,Dawson Springs Independent,017,Dawson Springs Elementary,146017,054146017,210150002200,WKEC,908,02,17,16,0,0,0,0,0,0,0,0,0,0,0,0,0,0,0,0,1,1,16,16,32,33
20192020,054,HOPKINS,146,Dawson Springs Independent,017,Dawson Springs Elementary,146017,054146017,210150002200,WKEC,908,03,14,26,0,0,0,0,0,0,0,0,0,0,0,0,0,0,0,1,0,1,25,14,39,40
20192020,054,HOPKINS,146,Dawson Springs Independent,017,Dawson Springs Elementary,146017,054146017,210150002200,WKEC,908,04,27,22,0,0,0,0,0,0,0,1,1,0,1,1,0,0,0,2,1,3,20,24,44,49
20192020,054,HOPKINS,146,Dawson Springs Independent,017,Dawson Springs Elementary,146017,054146017,210150002200,WKEC,908,05,21,19,0,0,0,0,0,0,0,0,0,0,0,0,0,0,0,1,0,1,18,21,39,40
20192020,054,HOPKINS,146,Dawson Springs Independent,018,Dawson Springs Jr/Sr High School,146018,054146018,210150002203,WKEC,908,12,22,21,0,0,0,0,0,0,0,0,0,0,0,0,0,0,0,0,0,0,21,22,43,43
20192020,054,HOPKINS,146,Dawson Springs Independent,018,Dawson Springs Jr/Sr High School,146018,054146018,210150002203,WKEC,908,All Students,132,134,1,0,1,0,0,0,0,0,0,1,3,4,0,0,0,5,0,5,127,129,256,266
20192020,054,HOPKINS,146,Dawson Springs Independent,018,Dawson Springs Jr/Sr High School,146018,054146018,210150002203,WKEC,908,07,25,17,1,0,1,0,0,0,0,0,0,0,0,0,0,0,0,2,0,2,14,25,39,42
20192020,054,HOPKINS,146,Dawson Springs Independent,018,Dawson Springs Jr/Sr High School,146018,054146018,210150002203,WKEC,908,08,11,21,0,0,0,0,0,0,0,0,0,0,2,2,0,0,0,1,0,1,20,9,29,32
20192020,054,HOPKINS,146,Dawson Springs Independent,018,Dawson Springs Jr/Sr High School,146018,054146018,210150002203,WKEC,908,09,25,26,0,0,0,0,0,0,0,0,0,0,1,1,0,0,0,2,0,2,24,24,48,51
20192020,054,HOPKINS,146,Dawson Springs Independent,018,Dawson Springs Jr/Sr High School,146018,054146018,210150002203,WKEC,908,10,28,22,0,0,0,0,0,0,0,0,0,0,0,0,0,0,0,0,0,0,22,28,50,50
20192020,054,HOPKINS,146,Dawson Springs Independent,018,Dawson Springs Jr/Sr High School,146018,054146018,210150002203,WKEC,908,11,21,26,0,0,0,0,0,0,0,0,0,1,0,1,0,0,0,0,0,0,25,21,46,47
20192020,054,HOPKINS,146,Dawson Springs Independent,018,Dawson Springs Jr/Sr High School,146018,054146018,210150002203,WKEC,908,14,0,1,0,0,0,0,0,0,0,0,0,0,0,0,0,0,0,0,0,0,1,0,1,1
20192020,019,CAMPBELL,147,Dayton Independent,"",---District Total---,147,"","",NKCES,905,11,23,33,2,2,4,0,0,0,0,0,0,4,1,5,0,0,0,0,0,0,27,20,47,56
20192020,019,CAMPBELL,147,Dayton Independent,"",---District Total---,147,"","",NKCES,905,All Students,429,496,19,15,34,0,0,0,1,2,3,37,20,57,0,0,0,19,21,40,420,371,791,925
20192020,019,CAMPBELL,147,Dayton Independent,"",---District Total---,147,"","",NKCES,905,PS,59,51,1,1,2,0,0,0,0,0,0,4,6,10,0,0,0,1,5,6,45,47,92,110
20192020,019,CAMPBELL,147,Dayton Independent,"",---District Total---,147,"","",NKCES,905,KG,38,39,1,1,2,0,0,0,0,1,1,2,1,3,0,0,0,3,3,6,33,32,65,77
20192020,019,CAMPBELL,147,Dayton Independent,"",---District Total---,147,"","",NKCES,905,01,50,34,2,3,5,0,0,0,0,0,0,4,3,7,0,0,0,3,2,5,25,42,67,84
20192020,019,CAMPBELL,147,Dayton Independent,"",---District Total---,147,"","",NKCES,905,02,34,41,1,1,2,0,0,0,1,0,1,2,2,4,0,0,0,1,4,5,36,27,63,75
20192020,019,CAMPBELL,147,Dayton Independent,"",---District Total---,147,"","",NKCES,905,03,26,42,0,1,1,0,0,0,0,0,0,4,1,5,0,0,0,2,0,2,36,24,60,68
20192020,019,CAMPBELL,147,Dayton Independent,"",---District Total---,147,"","",NKCES,905,04,30,27,1,0,1,0,0,0,0,0,0,3,1,4,0,0,0,2,3,5,21,26,47,57
20192020,019,CAMPBELL,147,Dayton Independent,"",---District Total---,147,"","",NKCES,905,05,33,38,4,0,4,0,0,0,0,0,0,4,2,6,0,0,0,0,1,1,30,30,60,71
20192020,019,CAMPBELL,147,Dayton Independent,"",---District Total---,147,"","",NKCES,905,06,29,37,0,0,0,0,0,0,0,0,0,0,2,2,0,0,0,2,0,2,35,27,62,66
20192020,019,CAMPBELL,147,Dayton Independent,"",---District Total---,147,"","",NKCES,905,07,38,46,2,2,4,0,0,0,0,1,1,1,2,3,0,0,0,4,3,7,39,30,69,84
20192020,019,CAMPBELL,147,Dayton Independent,"",---District Total---,147,"","",NKCES,905,08,38,42,2,1,3,0,0,0,0,0,0,6,2,8,0,0,0,2,2,4,32,33,65,80
20192020,019,CAMPBELL,147,Dayton Independent,"",---District Total---,147,"","",NKCES,905,09,32,47,1,1,2,0,0,0,0,0,0,2,2,4,0,0,0,0,1,1,44,28,72,79
20192020,019,CAMPBELL,147,Dayton Independent,"",---District Total---,147,"","",NKCES,905,10,21,38,1,2,3,0,0,0,0,0,0,4,1,5,0,0,0,0,2,2,33,16,49,59
20192020,019,CAMPBELL,147,Dayton Independent,"",---District Total---,147,"","",NKCES,905,12,37,32,2,1,3,0,0,0,0,0,0,1,0,1,0,0,0,0,0,0,29,36,65,69
20192020,019,CAMPBELL,147,Dayton Independent,010,Dayton High School,147010,019147010,210153000316,NKCES,905,11,22,30,2,2,4,0,0,0,0,0,0,3,1,4,0,0,0,0,0,0,25,19,44,52
20192020,019,CAMPBELL,147,Dayton Independent,010,Dayton High School,147010,019147010,210153000316,NKCES,905,All Students,183,218,6,9,15,0,0,0,0,1,1,17,8,25,0,0,0,4,8,12,191,157,348,401
20192020,019,CAMPBELL,147,Dayton Independent,010,Dayton High School,147010,019147010,210153000316,NKCES,905,07,37,42,2,2,4,0,0,0,0,1,1,1,2,3,0,0,0,3,3,6,36,29,65,79
20192020,019,CAMPBELL,147,Dayton Independent,010,Dayton High School,147010,019147010,210153000316,NKCES,905,08,38,38,1,1,2,0,0,0,0,0,0,6,2,8,0,0,0,1,2,3,30,33,63,76
20192020,019,CAMPBELL,147,Dayton Independent,010,Dayton High School,147010,019147010,210153000316,NKCES,905,09,30,45,0,1,1,0,0,0,0,0,0,2,2,4,0,0,0,0,1,1,43,26,69,75
20192020,019,CAMPBELL,147,Dayton Independent,010,Dayton High School,147010,019147010,210153000316,NKCES,905,10,21,36,1,2,3,0,0,0,0,0,0,4,1,5,0,0,0,0,2,2,31,16,47,57
20192020,019,CAMPBELL,147,Dayton Independent,010,Dayton High School,147010,019147010,210153000316,NKCES,905,12,35,27,0,1,1,0,0,0,0,0,0,1,0,1,0,0,0,0,0,0,26,34,60,62
20192020,019,CAMPBELL,147,Dayton Independent,030,Lincoln Elementary School,147030,019147030,210153000317,NKCES,905,PS,59,51,1,1,2,0,0,0,0,0,0,4,6,10,0,0,0,1,5,6,45,47,92,110
20192020,019,CAMPBELL,147,Dayton Independent,030,Lincoln Elementary School,147030,019147030,210153000317,NKCES,905,All Students,239,242,5,6,11,0,0,0,1,1,2,19,12,31,0,0,0,13,12,25,204,208,412,481
20192020,019,CAMPBELL,147,Dayton Independent,030,Lincoln Elementary School,147030,019147030,210153000317,NKCES,905,KG,38,38,1,1,2,0,0,0,0,1,1,2,1,3,0,0,0,3,3,6,32,32,64,76
20192020,019,CAMPBELL,147,Dayton Independent,030,Lincoln Elementary School,147030,019147030,210153000317,NKCES,905,01,50,30,1,3,4,0,0,0,0,0,0,4,3,7,0,0,0,3,2,5,22,42,64,80
20192020,019,CAMPBELL,147,Dayton Independent,030,Lincoln Elementary School,147030,019147030,210153000317,NKCES,905,02,34,38,1,1,2,0,0,0,1,0,1,2,2,4,0,0,0,1,4,5,33,27,60,72
20192020,019,CAMPBELL,147,Dayton Independent,030,Lincoln Elementary School,147030,019147030,210153000317,NKCES,905,03,26,41,0,1,1,0,0,0,0,0,0,4,1,5,0,0,0,2,0,2,35,24,59,67
20192020,019,CAMPBELL,147,Dayton Independent,030,Lincoln Elementary School,147030,019147030,210153000317,NKCES,905,04,30,27,1,0,1,0,0,0,0,0,0,3,1,4,0,0,0,2,3,5,21,26,47,57
20192020,019,CAMPBELL,147,Dayton Independent,030,Lincoln Elementary School,147030,019147030,210153000317,NKCES,905,05,32,33,1,0,1,0,0,0,0,0,0,4,2,6,0,0,0,0,0,0,28,30,58,65
20192020,019,CAMPBELL,147,Dayton Independent,030,Lincoln Elementary School,147030,019147030,210153000317,NKCES,905,06,29,35,0,0,0,0,0,0,0,0,0,0,2,2,0,0,0,2,0,2,33,27,60,64
20192020,019,CAMPBELL,147,Dayton Independent,120,Regional Programs School,147120,019147120,210153002413,NKCES,905,12,2,5,2,0,2,0,0,0,0,0,0,0,0,0,0,0,0,0,0,0,3,2,5,7
20192020,019,CAMPBELL,147,Dayton Independent,120,Regional Programs School,147120,019147120,210153002413,NKCES,905,All Students,7,36,8,0,8,0,0,0,0,0,0,1,0,1,0,0,0,2,1,3,25,6,31,43
20192020,019,CAMPBELL,147,Dayton Independent,120,Regional Programs School,147120,019147120,210153002413,NKCES,905,KG,0,1,0,0,0,0,0,0,0,0,0,0,0,0,0,0,0,0,0,0,1,0,1,1
20192020,019,CAMPBELL,147,Dayton Independent,120,Regional Programs School,147120,019147120,210153002413,NKCES,905,01,0,4,1,0,1,0,0,0,0,0,0,0,0,0,0,0,0,0,0,0,3,0,3,4
20192020,019,CAMPBELL,147,Dayton Independent,120,Regional Programs School,147120,019147120,210153002413,NKCES,905,02,0,3,0,0,0,0,0,0,0,0,0,0,0,0,0,0,0,0,0,0,3,0,3,3
20192020,019,CAMPBELL,147,Dayton Independent,120,Regional Programs School,147120,019147120,210153002413,NKCES,905,03,0,1,0,0,0,0,0,0,0,0,0,0,0,0,0,0,0,0,0,0,1,0,1,1
20192020,019,CAMPBELL,147,Dayton Independent,120,Regional Programs School,147120,019147120,210153002413,NKCES,905,05,1,5,3,0,3,0,0,0,0,0,0,0,0,0,0,0,0,0,1,1,2,0,2,6
20192020,019,CAMPBELL,147,Dayton Independent,120,Regional Programs School,147120,019147120,210153002413,NKCES,905,06,0,2,0,0,0,0,0,0,0,0,0,0,0,0,0,0,0,0,0,0,2,0,2,2
20192020,019,CAMPBELL,147,Dayton Independent,120,Regional Programs School,147120,019147120,210153002413,NKCES,905,07,1,4,0,0,0,0,0,0,0,0,0,0,0,0,0,0,0,1,0,1,3,1,4,5
20192020,019,CAMPBELL,147,Dayton Independent,120,Regional Programs School,147120,019147120,210153002413,NKCES,905,08,0,4,1,0,1,0,0,0,0,0,0,0,0,0,0,0,0,1,0,1,2,0,2,4
20192020,019,CAMPBELL,147,Dayton Independent,120,Regional Programs School,147120,019147120,210153002413,NKCES,905,09,2,2,1,0,1,0,0,0,0,0,0,0,0,0,0,0,0,0,0,0,1,2,3,4
20192020,019,CAMPBELL,147,Dayton Independent,120,Regional Programs School,147120,019147120,210153002413,NKCES,905,10,0,2,0,0,0,0,0,0,0,0,0,0,0,0,0,0,0,0,0,0,2,0,2,2
20192020,019,CAMPBELL,147,Dayton Independent,120,Regional Programs School,147120,019147120,210153002413,NKCES,905,11,1,3,0,0,0,0,0,0,0,0,0,1,0,1,0,0,0,0,0,0,2,1,3,4
20192020,063,LAUREL,149,East Bernstadt Independent,"",---District Total---,149,"","",SESC,907,07,14,19,0,0,0,0,0,0,0,0,0,0,0,0,0,0,0,0,0,0,19,14,33,33
20192020,063,LAUREL,149,East Bernstadt Independent,"",---District Total---,149,"","",SESC,907,All Students,245,238,2,4,6,0,0,0,0,4,4,2,2,4,0,1,1,1,2,3,233,232,465,483
20192020,063,LAUREL,149,East Bernstadt Independent,"",---District Total---,149,"","",SESC,907,PS,34,26,0,0,0,0,0,0,0,0,0,2,1,3,0,0,0,2,1,3,22,32,54,60
20192020,063,LAUREL,149,East Bernstadt Independent,"",---District Total---,149,"","",SESC,907,KG,31,32,1,0,1,0,0,0,0,1,1,1,0,1,0,0,0,0,1,1,30,29,59,63
20192020,063,LAUREL,149,East Bernstadt Independent,"",---District Total---,149,"","",SESC,907,01,27,34,0,0,0,0,0,0,0,0,0,0,0,0,0,0,0,1,0,1,33,27,60,61
20192020,063,LAUREL,149,East Bernstadt Independent,"",---District Total---,149,"","",SESC,907,02,32,33,0,1,1,0,0,0,0,0,0,0,1,1,0,0,0,0,0,0,33,30,63,65
20192020,063,LAUREL,149,East Bernstadt Independent,"",---District Total---,149,"","",SESC,907,03,21,26,0,0,0,0,0,0,0,0,0,0,0,0,0,0,0,0,0,0,26,21,47,47
20192020,063,LAUREL,149,East Bernstadt Independent,"",---District Total---,149,"","",SESC,907,04,31,27,0,3,3,0,0,0,0,1,1,0,1,1,0,1,1,0,0,0,27,25,52,58
20192020,063,LAUREL,149,East Bernstadt Independent,"",---District Total---,149,"","",SESC,907,05,40,34,1,0,1,0,0,0,0,2,2,1,0,1,0,0,0,0,0,0,32,38,70,74
20192020,063,LAUREL,149,East Bernstadt Independent,"",---District Total---,149,"","",SESC,907,06,29,25,0,0,0,0,0,0,0,0,0,0,0,0,0,0,0,0,0,0,25,29,54,54
20192020,063,LAUREL,149,East Bernstadt Independent,"",---District Total---,149,"","",SESC,907,08,20,8,0,0,0,0,0,0,0,0,0,0,0,0,0,0,0,0,1,1,8,19,27,28
20192020,063,LAUREL,149,East Bernstadt Independent,010,East Bernstadt Elementary School,149010,063149010,210159000318,SESC,907,06,29,25,0,0,0,0,0,0,0,0,0,0,0,0,0,0,0,0,0,0,25,29,54,54
20192020,063,LAUREL,149,East Bernstadt Independent,010,East Bernstadt Elementary School,149010,063149010,210159000318,SESC,907,All Students,245,238,2,4,6,0,0,0,0,4,4,2,2,4,0,1,1,1,2,3,233,232,465,483
20192020,063,LAUREL,149,East Bernstadt Independent,010,East Bernstadt Elementary School,149010,063149010,210159000318,SESC,907,PS,34,26,0,0,0,0,0,0,0,0,0,2,1,3,0,0,0,2,1,3,22,32,54,60
20192020,063,LAUREL,149,East Bernstadt Independent,010,East Bernstadt Elementary School,149010,063149010,210159000318,SESC,907,KG,31,32,1,0,1,0,0,0,0,1,1,1,0,1,0,0,0,0,1,1,30,29,59,63
20192020,063,LAUREL,149,East Bernstadt Independent,010,East Bernstadt Elementary School,149010,063149010,210159000318,SESC,907,08,20,8,0,0,0,0,0,0,0,0,0,0,0,0,0,0,0,0,1,1,8,19,27,28
20192020,063,LAUREL,149,East Bernstadt Independent,010,East Bernstadt Elementary School,149010,063149010,210159000318,SESC,907,01,27,34,0,0,0,0,0,0,0,0,0,0,0,0,0,0,0,1,0,1,33,27,60,61
20192020,063,LAUREL,149,East Bernstadt Independent,010,East Bernstadt Elementary School,149010,063149010,210159000318,SESC,907,02,32,33,0,1,1,0,0,0,0,0,0,0,1,1,0,0,0,0,0,0,33,30,63,65
20192020,063,LAUREL,149,East Bernstadt Independent,010,East Bernstadt Elementary School,149010,063149010,210159000318,SESC,907,03,21,26,0,0,0,0,0,0,0,0,0,0,0,0,0,0,0,0,0,0,26,21,47,47
20192020,063,LAUREL,149,East Bernstadt Independent,010,East Bernstadt Elementary School,149010,063149010,210159000318,SESC,907,04,31,27,0,3,3,0,0,0,0,1,1,0,1,1,0,1,1,0,0,0,27,25,52,58
20192020,063,LAUREL,149,East Bernstadt Independent,010,East Bernstadt Elementary School,149010,063149010,210159000318,SESC,907,05,40,34,1,0,1,0,0,0,0,2,2,1,0,1,0,0,0,0,0,0,32,38,70,74
20192020,063,LAUREL,149,East Bernstadt Independent,010,East Bernstadt Elementary School,149010,063149010,210159000318,SESC,907,07,14,19,0,0,0,0,0,0,0,0,0,0,0,0,0,0,0,0,0,0,19,14,33,33
20192020,031,EDMONSON,151,Edmonson County,"",---District Total---,151,"","",GRREC,902,03,65,63,0,0,0,0,0,0,0,0,0,1,2,3,0,0,0,2,0,2,60,63,123,128
20192020,031,EDMONSON,151,Edmonson County,"",---District Total---,151,"","",GRREC,902,All Students,866,924,0,0,0,0,2,2,2,3,5,15,31,46,1,1,2,21,23,44,885,806,1691,1790
20192020,031,EDMONSON,151,Edmonson County,"",---District Total---,151,"","",GRREC,902,PS,59,40,0,0,0,0,1,1,0,0,0,0,0,0,0,0,0,1,3,4,39,55,94,99
20192020,031,EDMONSON,151,Edmonson County,"",---District Total---,151,"","",GRREC,902,KG,80,69,0,0,0,0,0,0,0,0,0,1,1,2,0,0,0,0,4,4,68,75,143,149
20192020,031,EDMONSON,151,Edmonson County,"",---District Total---,151,"","",GRREC,902,01,60,75,0,0,0,0,0,0,0,0,0,0,1,1,0,0,0,2,2,4,73,57,130,135
20192020,031,EDMONSON,151,Edmonson County,"",---District Total---,151,"","",GRREC,902,02,60,61,0,0,0,0,0,0,1,0,1,1,1,2,0,0,0,3,1,4,56,58,114,121
20192020,031,EDMONSON,151,Edmonson County,"",---District Total---,151,"","",GRREC,902,04,57,68,0,0,0,0,0,0,0,0,0,1,1,2,1,0,1,0,2,2,66,54,120,125
20192020,031,EDMONSON,151,Edmonson County,"",---District Total---,151,"","",GRREC,902,05,79,81,0,0,0,0,0,0,0,0,0,3,1,4,0,0,0,1,1,2,77,77,154,160
20192020,031,EDMONSON,151,Edmonson County,"",---District Total---,151,"","",GRREC,902,06,59,72,0,0,0,0,0,0,0,0,0,2,2,4,0,0,0,4,0,4,66,57,123,131
20192020,031,EDMONSON,151,Edmonson County,"",---District Total---,151,"","",GRREC,902,07,57,76,0,0,0,0,0,0,0,0,0,0,4,4,0,0,0,3,1,4,73,52,125,133
20192020,031,EDMONSON,151,Edmonson County,"",---District Total---,151,"","",GRREC,902,08,75,80,0,0,0,0,1,1,0,0,0,2,6,8,0,1,1,0,3,3,78,64,142,155
20192020,031,EDMONSON,151,Edmonson County,"",---District Total---,151,"","",GRREC,902,09,72,79,0,0,0,0,1,1,1,0,1,2,3,5,0,0,0,2,3,5,74,65,139,151
20192020,031,EDMONSON,151,Edmonson County,"",---District Total---,151,"","",GRREC,902,10,71,74,0,0,0,0,0,0,0,1,1,2,1,3,0,0,0,0,1,1,72,68,140,145
20192020,031,EDMONSON,151,Edmonson County,"",---District Total---,151,"","",GRREC,902,11,69,66,0,0,0,0,0,0,0,0,0,0,2,2,0,0,0,3,4,7,63,63,126,135
20192020,031,EDMONSON,151,Edmonson County,"",---District Total---,151,"","",GRREC,902,12,62,60,0,0,0,0,0,0,0,2,2,0,6,6,0,0,0,1,1,2,59,53,112,122
20192020,031,EDMONSON,151,Edmonson County,020,South Edmonson Elementary School,151020,031151020,210162000319,GRREC,902,04,30,42,0,0,0,0,0,0,0,0,0,1,1,2,0,0,0,0,1,1,41,28,69,72
20192020,031,EDMONSON,151,Edmonson County,020,South Edmonson Elementary School,151020,031151020,210162000319,GRREC,902,All Students,183,204,0,0,0,0,0,0,1,0,1,2,3,5,0,0,0,5,6,11,196,174,370,387
20192020,031,EDMONSON,151,Edmonson County,020,South Edmonson Elementary School,151020,031151020,210162000319,GRREC,902,PS,34,22,0,0,0,0,1,1,0,0,0,0,0,0,0,0,0,1,1,2,21,32,53,56
20192020,031,EDMONSON,151,Edmonson County,020,South Edmonson Elementary School,151020,031151020,210162000319,GRREC,902,KG,50,39,0,0,0,0,0,0,0,0,0,0,0,0,0,0,0,0,2,2,39,48,87,89
20192020,031,EDMONSON,151,Edmonson County,020,South Edmonson Elementary School,151020,031151020,210162000319,GRREC,902,01,31,47,0,0,0,0,0,0,0,0,0,0,0,0,0,0,0,2,2,4,45,29,74,78
20192020,031,EDMONSON,151,Edmonson County,020,South Edmonson Elementary School,151020,031151020,210162000319,GRREC,902,02,34,34,0,0,0,0,0,0,1,0,1,1,1,2,0,0,0,2,1,3,30,32,62,68
20192020,031,EDMONSON,151,Edmonson County,020,South Edmonson Elementary School,151020,031151020,210162000319,GRREC,902,03,38,42,0,0,0,0,0,0,0,0,0,0,1,1,0,0,0,1,0,1,41,37,78,80
20192020,031,EDMONSON,151,Edmonson County,022,Edmonson County 5/6 Center,151022,031151022,210162001985,GRREC,902,06,59,72,0,0,0,0,0,0,0,0,0,2,2,4,0,0,0,4,0,4,66,57,123,131
20192020,031,EDMONSON,151,Edmonson County,022,Edmonson County 5/6 Center,151022,031151022,210162001985,GRREC,902,All Students,139,154,0,0,0,0,0,0,0,0,0,5,3,8,0,0,0,5,1,6,144,135,279,293
20192020,031,EDMONSON,151,Edmonson County,022,Edmonson County 5/6 Center,151022,031151022,210162001985,GRREC,902,03,1,0,0,0,0,0,0,0,0,0,0,0,0,0,0,0,0,0,0,0,0,1,1,1
20192020,031,EDMONSON,151,Edmonson County,022,Edmonson County 5/6 Center,151022,031151022,210162001985,GRREC,902,05,79,81,0,0,0,0,0,0,0,0,0,3,1,4,0,0,0,1,1,2,77,77,154,160
20192020,031,EDMONSON,151,Edmonson County,022,Edmonson County 5/6 Center,151022,031151022,210162001985,GRREC,902,08,0,1,0,0,0,0,0,0,0,0,0,0,0,0,0,0,0,0,0,0,1,0,1,1
20192020,031,EDMONSON,151,Edmonson County,050,Edmonson County Middle School,151050,031151050,210162000321,GRREC,902,07,57,76,0,0,0,0,0,0,0,0,0,0,4,4,0,0,0,3,1,4,73,52,125,133
20192020,031,EDMONSON,151,Edmonson County,050,Edmonson County Middle School,151050,031151050,210162000321,GRREC,902,All Students,132,155,0,0,0,0,1,1,0,0,0,2,10,12,0,1,1,3,4,7,150,116,266,287
20192020,031,EDMONSON,151,Edmonson County,050,Edmonson County Middle School,151050,031151050,210162000321,GRREC,902,08,75,79,0,0,0,0,1,1,0,0,0,2,6,8,0,1,1,0,3,3,77,64,141,154
20192020,031,EDMONSON,151,Edmonson County,060,Edmonson County High School,151060,031151060,210162001442,GRREC,902,11,69,66,0,0,0,0,0,0,0,0,0,0,2,2,0,0,0,3,4,7,63,63,126,135
20192020,031,EDMONSON,151,Edmonson County,060,Edmonson County High School,151060,031151060,210162001442,GRREC,902,All Students,274,279,0,0,0,0,1,1,1,3,4,4,12,16,0,0,0,6,9,15,268,249,517,553
20192020,031,EDMONSON,151,Edmonson County,060,Edmonson County High School,151060,031151060,210162001442,GRREC,902,09,72,79,0,0,0,0,1,1,1,0,1,2,3,5,0,0,0,2,3,5,74,65,139,151
20192020,031,EDMONSON,151,Edmonson County,060,Edmonson County High School,151060,031151060,210162001442,GRREC,902,10,71,74,0,0,0,0,0,0,0,1,1,2,1,3,0,0,0,0,1,1,72,68,140,145
20192020,031,EDMONSON,151,Edmonson County,060,Edmonson County High School,151060,031151060,210162001442,GRREC,902,12,62,60,0,0,0,0,0,0,0,2,2,0,6,6,0,0,0,1,1,2,59,53,112,122
20192020,031,EDMONSON,151,Edmonson County,080,Kyrock Elementary School,151080,031151080,210162000322,GRREC,902,03,26,21,0,0,0,0,0,0,0,0,0,1,1,2,0,0,0,1,0,1,19,25,44,47
20192020,031,EDMONSON,151,Edmonson County,080,Kyrock Elementary School,151080,031151080,210162000322,GRREC,902,All Students,138,132,0,0,0,0,0,0,0,0,0,2,3,5,1,0,1,2,3,5,127,132,259,270
20192020,031,EDMONSON,151,Edmonson County,080,Kyrock Elementary School,151080,031151080,210162000322,GRREC,902,PS,25,18,0,0,0,0,0,0,0,0,0,0,0,0,0,0,0,0,2,2,18,23,41,43
20192020,031,EDMONSON,151,Edmonson County,080,Kyrock Elementary School,151080,031151080,210162000322,GRREC,902,KG,30,30,0,0,0,0,0,0,0,0,0,1,1,2,0,0,0,0,2,2,29,27,56,60
20192020,031,EDMONSON,151,Edmonson County,080,Kyrock Elementary School,151080,031151080,210162000322,GRREC,902,01,29,28,0,0,0,0,0,0,0,0,0,0,1,1,0,0,0,0,0,0,28,28,56,57
20192020,031,EDMONSON,151,Edmonson County,080,Kyrock Elementary School,151080,031151080,210162000322,GRREC,902,02,26,27,0,0,0,0,0,0,0,0,0,0,0,0,0,0,0,1,0,1,26,26,52,53
20192020,031,EDMONSON,151,Edmonson County,080,Kyrock Elementary School,151080,031151080,210162000322,GRREC,902,04,27,26,0,0,0,0,0,0,0,0,0,0,0,0,1,0,1,0,1,1,25,26,51,53
20192020,047,HARDIN,152,Elizabethtown Independent,"",---District Total---,152,"","",GRREC,902,KG,92,100,13,11,24,0,1,1,1,2,3,5,6,11,0,0,0,9,16,25,72,56,128,192
20192020,047,HARDIN,152,Elizabethtown Independent,"",---District Total---,152,"","",GRREC,902,All Students,1133,1246,135,128,263,3,3,6,36,44,80,90,87,177,1,2,3,132,118,250,849,751,1600,2379
20192020,047,HARDIN,152,Elizabethtown Independent,"",---District Total---,152,"","",GRREC,902,PS,40,66,10,5,15,0,0,0,0,0,0,2,2,4,1,0,1,4,6,10,49,27,76,106
20192020,047,HARDIN,152,Elizabethtown Independent,"",---District Total---,152,"","",GRREC,902,01,61,90,11,9,20,0,0,0,1,1,2,11,4,15,0,0,0,11,6,17,56,41,97,151
20192020,047,HARDIN,152,Elizabethtown Independent,"",---District Total---,152,"","",GRREC,902,02,69,74,7,9,16,1,0,1,3,2,5,9,5,14,0,0,0,9,10,19,45,43,88,143
20192020,047,HARDIN,152,Elizabethtown Independent,"",---District Total---,152,"","",GRREC,902,03,86,94,7,10,17,0,0,0,3,2,5,10,6,16,1,1,2,5,8,13,68,59,127,180
20192020,047,HARDIN,152,Elizabethtown Independent,"",---District Total---,152,"","",GRREC,902,04,81,89,7,8,15,0,0,0,3,3,6,6,7,13,0,0,0,17,14,31,56,49,105,170
20192020,047,HARDIN,152,Elizabethtown Independent,"",---District Total---,152,"","",GRREC,902,05,68,77,10,4,14,0,0,0,1,1,2,5,7,12,0,1,1,9,6,15,52,49,101,145
20192020,047,HARDIN,152,Elizabethtown Independent,"",---District Total---,152,"","",GRREC,902,06,101,108,14,12,26,0,0,0,3,5,8,9,5,14,0,0,0,11,7,18,71,72,143,209
20192020,047,HARDIN,152,Elizabethtown Independent,"",---District Total---,152,"","",GRREC,902,07,108,116,11,14,25,0,1,1,3,6,9,7,6,13,0,0,0,13,8,21,82,73,155,224
20192020,047,HARDIN,152,Elizabethtown Independent,"",---District Total---,152,"","",GRREC,902,08,91,103,14,9,23,2,0,2,2,5,7,5,8,13,0,0,0,10,10,20,70,59,129,194
20192020,047,HARDIN,152,Elizabethtown Independent,"",---District Total---,152,"","",GRREC,902,09,106,121,13,16,29,0,0,0,2,5,7,8,12,20,0,0,0,9,10,19,89,63,152,227
20192020,047,HARDIN,152,Elizabethtown Independent,"",---District Total---,152,"","",GRREC,902,10,94,89,10,9,19,0,0,0,4,4,8,5,5,10,0,0,0,9,9,18,61,67,128,183
20192020,047,HARDIN,152,Elizabethtown Independent,"",---District Total---,152,"","",GRREC,902,11,86,110,7,8,15,0,0,0,4,4,8,8,8,16,0,0,0,14,7,21,77,59,136,196
20192020,047,HARDIN,152,Elizabethtown Independent,"",---District Total---,152,"","",GRREC,902,12,89,71,9,9,18,0,1,1,6,4,10,2,8,10,0,0,0,6,7,13,48,60,108,160
20192020,047,HARDIN,152,Elizabethtown Independent,"",---District Total---,152,"","",GRREC,902,14,1,4,2,0,2,0,0,0,0,0,0,0,0,0,0,0,0,0,0,0,2,1,3,5
20192020,047,HARDIN,152,Elizabethtown Independent,010,Elizabethtown High School,152010,047152010,210165000323,GRREC,902,14,1,4,2,0,2,0,0,0,0,0,0,0,0,0,0,0,0,0,0,0,2,1,3,5
20192020,047,HARDIN,152,Elizabethtown Independent,010,Elizabethtown High School,152010,047152010,210165000323,GRREC,902,All Students,348,383,39,39,78,0,1,1,16,17,33,22,30,52,0,0,0,35,32,67,271,229,500,731
20192020,047,HARDIN,152,Elizabethtown Independent,010,Elizabethtown High School,152010,047152010,210165000323,GRREC,902,09,99,118,13,13,26,0,0,0,2,5,7,8,12,20,0,0,0,8,10,18,87,59,146,217
20192020,047,HARDIN,152,Elizabethtown Independent,010,Elizabethtown High School,152010,047152010,210165000323,GRREC,902,10,88,85,9,9,18,0,0,0,4,4,8,5,5,10,0,0,0,8,8,16,59,62,121,173
20192020,047,HARDIN,152,Elizabethtown Independent,010,Elizabethtown High School,152010,047152010,210165000323,GRREC,902,11,77,107,7,8,15,0,0,0,4,4,8,7,6,13,0,0,0,14,7,21,75,52,127,184
20192020,047,HARDIN,152,Elizabethtown Independent,010,Elizabethtown High School,152010,047152010,210165000323,GRREC,902,12,83,69,8,9,17,0,1,1,6,4,10,2,7,9,0,0,0,5,7,12,48,55,103,152
20192020,047,HARDIN,152,Elizabethtown Independent,015,Helmwood Heights Elementary School,152015,047152015,210165000324,GRREC,902,05,30,37,3,0,3,0,0,0,1,1,2,2,2,4,0,1,1,5,5,10,26,21,47,67
20192020,047,HARDIN,152,Elizabethtown Independent,015,Helmwood Heights Elementary School,152015,047152015,210165000324,GRREC,902,All Students,165,177,17,16,33,1,0,1,7,5,12,14,14,28,1,2,3,23,23,46,114,105,219,342
20192020,047,HARDIN,152,Elizabethtown Independent,015,Helmwood Heights Elementary School,152015,047152015,210165000324,GRREC,902,01,31,39,5,6,11,0,0,0,1,0,1,8,2,10,0,0,0,5,5,10,20,18,38,70
20192020,047,HARDIN,152,Elizabethtown Independent,015,Helmwood Heights Elementary School,152015,047152015,210165000324,GRREC,902,02,32,30,4,4,8,1,0,1,2,2,4,1,4,5,0,0,0,4,4,8,18,18,36,62
20192020,047,HARDIN,152,Elizabethtown Independent,015,Helmwood Heights Elementary School,152015,047152015,210165000324,GRREC,902,03,44,40,4,4,8,0,0,0,1,2,3,2,4,6,1,1,2,4,4,8,28,29,57,84
20192020,047,HARDIN,152,Elizabethtown Independent,015,Helmwood Heights Elementary School,152015,047152015,210165000324,GRREC,902,04,28,31,1,2,3,0,0,0,2,0,2,1,2,3,0,0,0,5,5,10,22,19,41,59
20192020,047,HARDIN,152,Elizabethtown Independent,020,Morningside Elementary School,152020,047152020,210165000325,GRREC,902,05,38,40,7,4,11,0,0,0,0,0,0,3,5,8,0,0,0,4,1,5,26,28,54,78
20192020,047,HARDIN,152,Elizabethtown Independent,020,Morningside Elementary School,152020,047152020,210165000325,GRREC,902,All Students,200,244,25,24,49,0,0,0,4,4,8,27,15,42,0,0,0,28,21,49,160,136,296,444
20192020,047,HARDIN,152,Elizabethtown Independent,020,Morningside Elementary School,152020,047152020,210165000325,GRREC,902,01,30,50,6,3,9,0,0,0,0,1,1,3,2,5,0,0,0,6,1,7,35,23,58,80
20192020,047,HARDIN,152,Elizabethtown Independent,020,Morningside Elementary School,152020,047152020,210165000325,GRREC,902,02,37,43,3,5,8,0,0,0,1,0,1,8,1,9,0,0,0,5,6,11,26,25,51,80
20192020,047,HARDIN,152,Elizabethtown Independent,020,Morningside Elementary School,152020,047152020,210165000325,GRREC,902,03,42,53,3,6,9,0,0,0,2,0,2,8,2,10,0,0,0,1,4,5,39,30,69,95
20192020,047,HARDIN,152,Elizabethtown Independent,020,Morningside Elementary School,152020,047152020,210165000325,GRREC,902,04,53,58,6,6,12,0,0,0,1,3,4,5,5,10,0,0,0,12,9,21,34,30,64,111
20192020,047,HARDIN,152,Elizabethtown Independent,025,Panther Academy,152025,047152025,210165002319,GRREC,902,PS,40,66,10,5,15,0,0,0,0,0,0,2,2,4,1,0,1,4,6,10,49,27,76,106
20192020,047,HARDIN,152,Elizabethtown Independent,025,Panther Academy,152025,047152025,210165002319,GRREC,902,All Students,92,99,12,11,23,0,1,1,1,2,3,5,6,11,0,0,0,9,16,25,72,56,128,191
20192020,047,HARDIN,152,Elizabethtown Independent,025,Panther Academy,152025,047152025,210165002319,GRREC,902,KG,92,99,12,11,23,0,1,1,1,2,3,5,6,11,0,0,0,9,16,25,72,56,128,191
20192020,047,HARDIN,152,Elizabethtown Independent,035,Talton K Stone Middle School,152035,047152035,210165000326,GRREC,902,08,90,102,14,9,23,2,0,2,2,5,7,5,8,13,0,0,0,9,9,18,70,59,129,192
20192020,047,HARDIN,152,Elizabethtown Independent,035,Talton K Stone Middle School,152035,047152035,210165000326,GRREC,902,All Students,298,322,38,34,72,2,1,3,8,16,24,21,19,40,0,0,0,33,24,57,220,204,424,620
20192020,047,HARDIN,152,Elizabethtown Independent,035,Talton K Stone Middle School,152035,047152035,210165000326,GRREC,902,06,101,105,13,12,25,0,0,0,3,5,8,9,5,14,0,0,0,11,7,18,69,72,141,206
20192020,047,HARDIN,152,Elizabethtown Independent,035,Talton K Stone Middle School,152035,047152035,210165000326,GRREC,902,07,107,115,11,13,24,0,1,1,3,6,9,7,6,13,0,0,0,13,8,21,81,73,154,222
20192020,047,HARDIN,152,Elizabethtown Independent,041,Valley View Education Center,152041,047152041,210165002355,GRREC,902,03,0,1,0,0,0,0,0,0,0,0,0,0,0,0,0,0,0,0,0,0,1,0,1,1
20192020,047,HARDIN,152,Elizabethtown Independent,041,Valley View Education Center,152041,047152041,210165002355,GRREC,902,07,1,1,0,1,1,0,0,0,0,0,0,0,0,0,0,0,0,0,0,0,1,0,1,2
20192020,047,HARDIN,152,Elizabethtown Independent,041,Valley View Education Center,152041,047152041,210165002355,GRREC,902,All Students,30,21,4,4,8,0,0,0,0,0,0,1,3,4,0,0,0,4,2,6,12,21,33,51
20192020,047,HARDIN,152,Elizabethtown Independent,041,Valley View Education Center,152041,047152041,210165002355,GRREC,902,10,6,4,1,0,1,0,0,0,0,0,0,0,0,0,0,0,0,1,1,2,2,5,7,10
20192020,047,HARDIN,152,Elizabethtown Independent,041,Valley View Education Center,152041,047152041,210165002355,GRREC,902,08,1,1,0,0,0,0,0,0,0,0,0,0,0,0,0,0,0,1,1,2,0,0,0,2
20192020,047,HARDIN,152,Elizabethtown Independent,041,Valley View Education Center,152041,047152041,210165002355,GRREC,902,KG,0,1,1,0,1,0,0,0,0,0,0,0,0,0,0,0,0,0,0,0,0,0,0,1
20192020,047,HARDIN,152,Elizabethtown Independent,041,Valley View Education Center,152041,047152041,210165002355,GRREC,902,01,0,1,0,0,0,0,0,0,0,0,0,0,0,0,0,0,0,0,0,0,1,0,1,1
20192020,047,HARDIN,152,Elizabethtown Independent,041,Valley View Education Center,152041,047152041,210165002355,GRREC,902,02,0,1,0,0,0,0,0,0,0,0,0,0,0,0,0,0,0,0,0,0,1,0,1,1
20192020,047,HARDIN,152,Elizabethtown Independent,041,Valley View Education Center,152041,047152041,210165002355,GRREC,902,12,6,2,1,0,1,0,0,0,0,0,0,0,1,1,0,0,0,1,0,1,0,5,5,8
20192020,047,HARDIN,152,Elizabethtown Independent,041,Valley View Education Center,152041,047152041,210165002355,GRREC,902,09,7,3,0,3,3,0,0,0,0,0,0,0,0,0,0,0,0,1,0,1,2,4,6,10
20192020,047,HARDIN,152,Elizabethtown Independent,041,Valley View Education Center,152041,047152041,210165002355,GRREC,902,11,9,3,0,0,0,0,0,0,0,0,0,1,2,3,0,0,0,0,0,0,2,7,9,12
20192020,047,HARDIN,152,Elizabethtown Independent,041,Valley View Education Center,152041,047152041,210165002355,GRREC,902,06,0,3,1,0,1,0,0,0,0,0,0,0,0,0,0,0,0,0,0,0,2,0,2,3
20192020,032,ELLIOTT,155,Elliott County,"",---District Total---,155,"","",KEDC,903,07,25,46,0,0,0,0,0,0,0,0,0,2,0,2,0,0,0,0,0,0,44,25,69,71
20192020,032,ELLIOTT,155,Elliott County,"",---District Total---,155,"","",KEDC,903,All Students,463,542,2,3,5,0,1,1,0,0,0,5,2,7,0,0,0,2,1,3,533,456,989,1005
20192020,032,ELLIOTT,155,Elliott County,"",---District Total---,155,"","",KEDC,903,PS,5,4,0,0,0,0,0,0,0,0,0,0,0,0,0,0,0,0,0,0,4,5,9,9
20192020,032,ELLIOTT,155,Elliott County,"",---District Total---,155,"","",KEDC,903,KG,41,37,0,0,0,0,0,0,0,0,0,1,0,1,0,0,0,1,0,1,35,41,76,78
20192020,032,ELLIOTT,155,Elliott County,"",---District Total---,155,"","",KEDC,903,01,32,44,0,0,0,0,0,0,0,0,0,0,0,0,0,0,0,0,0,0,44,32,76,76
20192020,032,ELLIOTT,155,Elliott County,"",---District Total---,155,"","",KEDC,903,02,37,41,0,2,2,0,0,0,0,0,0,1,0,1,0,0,0,1,0,1,39,35,74,78
20192020,032,ELLIOTT,155,Elliott County,"",---District Total---,155,"","",KEDC,903,03,33,39,0,0,0,0,0,0,0,0,0,0,0,0,0,0,0,0,0,0,39,33,72,72
20192020,032,ELLIOTT,155,Elliott County,"",---District Total---,155,"","",KEDC,903,04,28,45,1,0,1,0,0,0,0,0,0,0,0,0,0,0,0,0,0,0,44,28,72,73
20192020,032,ELLIOTT,155,Elliott County,"",---District Total---,155,"","",KEDC,903,05,33,60,0,1,1,0,0,0,0,0,0,1,0,1,0,0,0,0,0,0,59,32,91,93
20192020,032,ELLIOTT,155,Elliott County,"",---District Total---,155,"","",KEDC,903,06,28,38,1,0,1,0,0,0,0,0,0,0,1,1,0,0,0,0,1,1,37,26,63,66
20192020,032,ELLIOTT,155,Elliott County,"",---District Total---,155,"","",KEDC,903,08,51,39,0,0,0,0,0,0,0,0,0,0,1,1,0,0,0,0,0,0,39,50,89,90
20192020,032,ELLIOTT,155,Elliott County,"",---District Total---,155,"","",KEDC,903,09,47,40,0,0,0,0,0,0,0,0,0,0,0,0,0,0,0,0,0,0,40,47,87,87
20192020,032,ELLIOTT,155,Elliott County,"",---District Total---,155,"","",KEDC,903,10,29,31,0,0,0,0,0,0,0,0,0,0,0,0,0,0,0,0,0,0,31,29,60,60
20192020,032,ELLIOTT,155,Elliott County,"",---District Total---,155,"","",KEDC,903,11,44,44,0,0,0,0,1,1,0,0,0,0,0,0,0,0,0,0,0,0,44,43,87,88
20192020,032,ELLIOTT,155,Elliott County,"",---District Total---,155,"","",KEDC,903,12,35,38,0,0,0,0,0,0,0,0,0,0,0,0,0,0,0,0,0,0,38,35,73,73
20192020,032,ELLIOTT,155,Elliott County,140,Isonville Elementary School,155140,032155140,210168000328,KEDC,903,All Students,25,42,0,0,0,0,0,0,0,0,0,0,0,0,0,0,0,1,0,1,41,25,66,67
20192020,032,ELLIOTT,155,Elliott County,140,Isonville Elementary School,155140,032155140,210168000328,KEDC,903,KG,5,3,0,0,0,0,0,0,0,0,0,0,0,0,0,0,0,0,0,0,3,5,8,8
20192020,032,ELLIOTT,155,Elliott County,140,Isonville Elementary School,155140,032155140,210168000328,KEDC,903,01,2,6,0,0,0,0,0,0,0,0,0,0,0,0,0,0,0,0,0,0,6,2,8,8
20192020,032,ELLIOTT,155,Elliott County,140,Isonville Elementary School,155140,032155140,210168000328,KEDC,903,02,8,8,0,0,0,0,0,0,0,0,0,0,0,0,0,0,0,1,0,1,7,8,15,16
20192020,032,ELLIOTT,155,Elliott County,140,Isonville Elementary School,155140,032155140,210168000328,KEDC,903,03,1,5,0,0,0,0,0,0,0,0,0,0,0,0,0,0,0,0,0,0,5,1,6,6
20192020,032,ELLIOTT,155,Elliott County,140,Isonville Elementary School,155140,032155140,210168000328,KEDC,903,04,1,5,0,0,0,0,0,0,0,0,0,0,0,0,0,0,0,0,0,0,5,1,6,6
20192020,032,ELLIOTT,155,Elliott County,140,Isonville Elementary School,155140,032155140,210168000328,KEDC,903,05,3,11,0,0,0,0,0,0,0,0,0,0,0,0,0,0,0,0,0,0,11,3,14,14
20192020,032,ELLIOTT,155,Elliott County,140,Isonville Elementary School,155140,032155140,210168000328,KEDC,903,06,5,4,0,0,0,0,0,0,0,0,0,0,0,0,0,0,0,0,0,0,4,5,9,9
20192020,032,ELLIOTT,155,Elliott County,160,Lakeside Elementary School,155160,032155160,210168000329,KEDC,903,06,8,12,0,0,0,0,0,0,0,0,0,0,0,0,0,0,0,0,1,1,12,7,19,20
20192020,032,ELLIOTT,155,Elliott County,160,Lakeside Elementary School,155160,032155160,210168000329,KEDC,903,05,14,12,0,1,1,0,0,0,0,0,0,1,0,1,0,0,0,0,0,0,11,13,24,26
20192020,032,ELLIOTT,155,Elliott County,160,Lakeside Elementary School,155160,032155160,210168000329,KEDC,903,All Students,91,99,1,2,3,0,0,0,0,0,0,1,0,1,0,0,0,1,1,2,96,88,184,190
20192020,032,ELLIOTT,155,Elliott County,160,Lakeside Elementary School,155160,032155160,210168000329,KEDC,903,PS,2,1,0,0,0,0,0,0,0,0,0,0,0,0,0,0,0,0,0,0,1,2,3,3
20192020,032,ELLIOTT,155,Elliott County,160,Lakeside Elementary School,155160,032155160,210168000329,KEDC,903,KG,21,14,0,0,0,0,0,0,0,0,0,0,0,0,0,0,0,1,0,1,13,21,34,35
20192020,032,ELLIOTT,155,Elliott County,160,Lakeside Elementary School,155160,032155160,210168000329,KEDC,903,01,10,15,0,0,0,0,0,0,0,0,0,0,0,0,0,0,0,0,0,0,15,10,25,25
20192020,032,ELLIOTT,155,Elliott County,160,Lakeside Elementary School,155160,032155160,210168000329,KEDC,903,02,11,16,0,1,1,0,0,0,0,0,0,0,0,0,0,0,0,0,0,0,16,10,26,27
20192020,032,ELLIOTT,155,Elliott County,160,Lakeside Elementary School,155160,032155160,210168000329,KEDC,903,03,12,13,0,0,0,0,0,0,0,0,0,0,0,0,0,0,0,0,0,0,13,12,25,25
20192020,032,ELLIOTT,155,Elliott County,160,Lakeside Elementary School,155160,032155160,210168000329,KEDC,903,04,15,17,1,0,1,0,0,0,0,0,0,0,0,0,0,0,0,0,0,0,16,15,31,32
20192020,032,ELLIOTT,155,Elliott County,270,Sandy Hook Elementary School,155270,032155270,210168000330,KEDC,903,05,16,37,0,0,0,0,0,0,0,0,0,0,0,0,0,0,0,0,0,0,37,16,53,53
20192020,032,ELLIOTT,155,Elliott County,270,Sandy Hook Elementary School,155270,032155270,210168000330,KEDC,903,All Students,116,163,1,1,2,0,0,0,0,0,0,2,1,3,0,0,0,0,0,0,160,114,274,279
20192020,032,ELLIOTT,155,Elliott County,270,Sandy Hook Elementary School,155270,032155270,210168000330,KEDC,903,PS,3,3,0,0,0,0,0,0,0,0,0,0,0,0,0,0,0,0,0,0,3,3,6,6
20192020,032,ELLIOTT,155,Elliott County,270,Sandy Hook Elementary School,155270,032155270,210168000330,KEDC,903,KG,15,20,0,0,0,0,0,0,0,0,0,1,0,1,0,0,0,0,0,0,19,15,34,35
20192020,032,ELLIOTT,155,Elliott County,270,Sandy Hook Elementary School,155270,032155270,210168000330,KEDC,903,01,20,23,0,0,0,0,0,0,0,0,0,0,0,0,0,0,0,0,0,0,23,20,43,43
20192020,032,ELLIOTT,155,Elliott County,270,Sandy Hook Elementary School,155270,032155270,210168000330,KEDC,903,02,18,17,0,1,1,0,0,0,0,0,0,1,0,1,0,0,0,0,0,0,16,17,33,35
20192020,032,ELLIOTT,155,Elliott County,270,Sandy Hook Elementary School,155270,032155270,210168000330,KEDC,903,03,20,21,0,0,0,0,0,0,0,0,0,0,0,0,0,0,0,0,0,0,21,20,41,41
20192020,032,ELLIOTT,155,Elliott County,270,Sandy Hook Elementary School,155270,032155270,210168000330,KEDC,903,04,12,23,0,0,0,0,0,0,0,0,0,0,0,0,0,0,0,0,0,0,23,12,35,35
20192020,032,ELLIOTT,155,Elliott County,270,Sandy Hook Elementary School,155270,032155270,210168000330,KEDC,903,06,15,22,1,0,1,0,0,0,0,0,0,0,1,1,0,0,0,0,0,0,21,14,35,37
20192020,032,ELLIOTT,155,Elliott County,280,Elliott County High School,155280,032155280,210168000331,KEDC,903,11,44,44,0,0,0,0,1,1,0,0,0,0,0,0,0,0,0,0,0,0,44,43,87,88
20192020,032,ELLIOTT,155,Elliott County,280,Elliott County High School,155280,032155280,210168000331,KEDC,903,All Students,231,238,0,0,0,0,1,1,0,0,0,2,1,3,0,0,0,0,0,0,236,229,465,469
20192020,032,ELLIOTT,155,Elliott County,280,Elliott County High School,155280,032155280,210168000331,KEDC,903,07,25,46,0,0,0,0,0,0,0,0,0,2,0,2,0,0,0,0,0,0,44,25,69,71
20192020,032,ELLIOTT,155,Elliott County,280,Elliott County High School,155280,032155280,210168000331,KEDC,903,08,51,39,0,0,0,0,0,0,0,0,0,0,1,1,0,0,0,0,0,0,39,50,89,90
20192020,032,ELLIOTT,155,Elliott County,280,Elliott County High School,155280,032155280,210168000331,KEDC,903,09,47,40,0,0,0,0,0,0,0,0,0,0,0,0,0,0,0,0,0,0,40,47,87,87
20192020,032,ELLIOTT,155,Elliott County,280,Elliott County High School,155280,032155280,210168000331,KEDC,903,10,29,31,0,0,0,0,0,0,0,0,0,0,0,0,0,0,0,0,0,0,31,29,60,60
20192020,032,ELLIOTT,155,Elliott County,280,Elliott County High School,155280,032155280,210168000331,KEDC,903,12,35,38,0,0,0,0,0,0,0,0,0,0,0,0,0,0,0,0,0,0,38,35,73,73
20192020,052,HENRY,156,Eminence Independent,"",---District Total---,156,"","",OVEC,906,07,30,33,3,0,3,0,1,1,0,0,0,8,2,10,0,0,0,2,2,4,20,25,45,63
20192020,052,HENRY,156,Eminence Independent,"",---District Total---,156,"","",OVEC,906,All Students,401,497,36,21,57,0,2,2,2,3,5,51,38,89,0,0,0,36,31,67,372,306,678,898
20192020,052,HENRY,156,Eminence Independent,"",---District Total---,156,"","",OVEC,906,PS,18,27,1,0,1,0,0,0,0,0,0,3,3,6,0,0,0,5,6,11,18,9,27,45
20192020,052,HENRY,156,Eminence Independent,"",---District Total---,156,"","",OVEC,906,KG,24,31,4,0,4,0,0,0,1,0,1,0,3,3,0,0,0,3,1,4,23,20,43,55
20192020,052,HENRY,156,Eminence Independent,"",---District Total---,156,"","",OVEC,906,01,28,37,0,1,1,0,0,0,0,0,0,3,5,8,0,0,0,5,0,5,29,22,51,65
20192020,052,HENRY,156,Eminence Independent,"",---District Total---,156,"","",OVEC,906,02,24,34,1,1,2,0,0,0,0,0,0,4,1,5,0,0,0,4,5,9,25,17,42,58
20192020,052,HENRY,156,Eminence Independent,"",---District Total---,156,"","",OVEC,906,03,36,36,2,1,3,0,0,0,0,0,0,3,3,6,0,0,0,5,3,8,26,29,55,72
20192020,052,HENRY,156,Eminence Independent,"",---District Total---,156,"","",OVEC,906,04,36,25,0,3,3,0,0,0,0,0,0,5,1,6,0,0,0,1,5,6,19,27,46,61
20192020,052,HENRY,156,Eminence Independent,"",---District Total---,156,"","",OVEC,906,05,35,30,1,1,2,0,1,1,1,0,1,1,1,2,0,0,0,2,1,3,25,31,56,65
20192020,052,HENRY,156,Eminence Independent,"",---District Total---,156,"","",OVEC,906,06,35,48,4,2,6,0,0,0,0,3,3,2,5,7,0,0,0,5,3,8,37,22,59,83
20192020,052,HENRY,156,Eminence Independent,"",---District Total---,156,"","",OVEC,906,08,25,38,0,1,1,0,0,0,0,0,0,3,3,6,0,0,0,2,3,5,33,18,51,63
20192020,052,HENRY,156,Eminence Independent,"",---District Total---,156,"","",OVEC,906,09,27,40,3,1,4,0,0,0,0,0,0,7,2,9,0,0,0,1,1,2,29,23,52,67
20192020,052,HENRY,156,Eminence Independent,"",---District Total---,156,"","",OVEC,906,10,34,56,5,5,10,0,0,0,0,0,0,8,6,14,0,0,0,2,2,4,41,21,62,90
20192020,052,HENRY,156,Eminence Independent,"",---District Total---,156,"","",OVEC,906,11,38,40,3,2,5,0,0,0,0,0,0,4,4,8,0,0,0,2,3,5,31,29,60,78
20192020,052,HENRY,156,Eminence Independent,"",---District Total---,156,"","",OVEC,906,12,29,48,9,3,12,0,0,0,0,0,0,3,2,5,0,0,0,2,2,4,34,22,56,77
20192020,052,HENRY,156,Eminence Independent,"",---District Total---,156,"","",OVEC,906,14,0,1,1,0,1,0,0,0,0,0,0,0,0,0,0,0,0,0,0,0,0,0,0,1
20192020,052,HENRY,156,Eminence Independent,010,Eminence High School,156010,052156010,210171000332,OVEC,906,14,0,1,1,0,1,0,0,0,0,0,0,0,0,0,0,0,0,0,0,0,0,0,0,1
20192020,052,HENRY,156,Eminence Independent,010,Eminence High School,156010,052156010,210171000332,OVEC,906,All Students,193,241,15,10,25,0,1,1,0,3,3,30,22,52,0,0,0,15,13,28,181,144,325,434
20192020,052,HENRY,156,Eminence Independent,010,Eminence High School,156010,052156010,210171000332,OVEC,906,06,35,48,4,2,6,0,0,0,0,3,3,2,5,7,0,0,0,5,3,8,37,22,59,83
20192020,052,HENRY,156,Eminence Independent,010,Eminence High School,156010,052156010,210171000332,OVEC,906,07,30,33,3,0,3,0,1,1,0,0,0,8,2,10,0,0,0,2,2,4,20,25,45,63
20192020,052,HENRY,156,Eminence Independent,010,Eminence High School,156010,052156010,210171000332,OVEC,906,08,25,38,0,1,1,0,0,0,0,0,0,3,3,6,0,0,0,2,3,5,33,18,51,63
20192020,052,HENRY,156,Eminence Independent,010,Eminence High School,156010,052156010,210171000332,OVEC,906,09,25,30,0,1,1,0,0,0,0,0,0,6,2,8,0,0,0,1,1,2,23,21,44,55
20192020,052,HENRY,156,Eminence Independent,010,Eminence High School,156010,052156010,210171000332,OVEC,906,10,23,37,3,2,5,0,0,0,0,0,0,5,6,11,0,0,0,2,2,4,27,13,40,60
20192020,052,HENRY,156,Eminence Independent,010,Eminence High School,156010,052156010,210171000332,OVEC,906,11,34,24,1,2,3,0,0,0,0,0,0,3,3,6,0,0,0,1,1,2,19,28,47,58
20192020,052,HENRY,156,Eminence Independent,010,Eminence High School,156010,052156010,210171000332,OVEC,906,12,21,30,3,2,5,0,0,0,0,0,0,3,1,4,0,0,0,2,1,3,22,17,39,51
20192020,052,HENRY,156,Eminence Independent,020,Eminence Elementary School,156020,052156020,210171000333,OVEC,906,04,36,25,0,3,3,0,0,0,0,0,0,5,1,6,0,0,0,1,5,6,19,27,46,61
20192020,052,HENRY,156,Eminence Independent,020,Eminence Elementary School,156020,052156020,210171000333,OVEC,906,All Students,183,193,8,7,15,0,1,1,2,0,2,16,14,30,0,0,0,20,15,35,147,146,293,376
20192020,052,HENRY,156,Eminence Independent,020,Eminence Elementary School,156020,052156020,210171000333,OVEC,906,PS,18,27,1,0,1,0,0,0,0,0,0,3,3,6,0,0,0,5,6,11,18,9,27,45
20192020,052,HENRY,156,Eminence Independent,020,Eminence Elementary School,156020,052156020,210171000333,OVEC,906,KG,24,31,4,0,4,0,0,0,1,0,1,0,3,3,0,0,0,3,1,4,23,20,43,55
20192020,052,HENRY,156,Eminence Independent,020,Eminence Elementary School,156020,052156020,210171000333,OVEC,906,01,28,37,0,1,1,0,0,0,0,0,0,3,5,8,0,0,0,5,0,5,29,22,51,65
20192020,052,HENRY,156,Eminence Independent,020,Eminence Elementary School,156020,052156020,210171000333,OVEC,906,02,24,34,1,1,2,0,0,0,0,0,0,4,1,5,0,0,0,4,5,9,25,17,42,58
20192020,052,HENRY,156,Eminence Independent,020,Eminence Elementary School,156020,052156020,210171000333,OVEC,906,03,36,36,2,1,3,0,0,0,0,0,0,3,3,6,0,0,0,5,3,8,26,29,55,72
20192020,052,HENRY,156,Eminence Independent,020,Eminence Elementary School,156020,052156020,210171000333,OVEC,906,05,35,30,1,1,2,0,1,1,1,0,1,1,1,2,0,0,0,2,1,3,25,31,56,65
20192020,052,HENRY,156,Eminence Independent,025,Bluegrass Challenge Academy,156025,052156025,210171002455,OVEC,906,11,4,16,2,0,2,0,0,0,0,0,0,1,1,2,0,0,0,1,2,3,12,1,13,20
20192020,052,HENRY,156,Eminence Independent,025,Bluegrass Challenge Academy,156025,052156025,210171002455,OVEC,906,All Students,25,63,13,4,17,0,0,0,0,0,0,5,2,7,0,0,0,1,3,4,44,16,60,88
20192020,052,HENRY,156,Eminence Independent,025,Bluegrass Challenge Academy,156025,052156025,210171002455,OVEC,906,09,2,10,3,0,3,0,0,0,0,0,0,1,0,1,0,0,0,0,0,0,6,2,8,12
20192020,052,HENRY,156,Eminence Independent,025,Bluegrass Challenge Academy,156025,052156025,210171002455,OVEC,906,10,11,19,2,3,5,0,0,0,0,0,0,3,0,3,0,0,0,0,0,0,14,8,22,30
20192020,052,HENRY,156,Eminence Independent,025,Bluegrass Challenge Academy,156025,052156025,210171002455,OVEC,906,12,8,18,6,1,7,0,0,0,0,0,0,0,1,1,0,0,0,0,1,1,12,5,17,26
20192020,059,KENTON,157,Erlanger-Elsmere Independent,"",---District Total---,157,"","",NKCES,905,11,86,88,13,9,22,0,0,0,0,0,0,12,11,23,0,1,1,11,9,20,52,56,108,174
20192020,059,KENTON,157,Erlanger-Elsmere Independent,"",---District Total---,157,"","",NKCES,905,All Students,1146,1268,111,91,202,1,0,1,2,5,7,143,147,290,16,18,34,150,132,282,845,753,1598,2414
20192020,059,KENTON,157,Erlanger-Elsmere Independent,"",---District Total---,157,"","",NKCES,905,PS,46,71,4,2,6,0,0,0,0,0,0,7,3,10,0,0,0,8,5,13,52,36,88,117
20192020,059,KENTON,157,Erlanger-Elsmere Independent,"",---District Total---,157,"","",NKCES,905,KG,96,104,11,8,19,0,0,0,0,0,0,15,15,30,1,3,4,10,11,21,67,59,126,200
20192020,059,KENTON,157,Erlanger-Elsmere Independent,"",---District Total---,157,"","",NKCES,905,01,97,78,7,4,11,0,0,0,1,1,2,9,11,20,0,2,2,13,12,25,48,67,115,175
20192020,059,KENTON,157,Erlanger-Elsmere Independent,"",---District Total---,157,"","",NKCES,905,02,79,87,6,6,12,0,0,0,0,0,0,13,11,24,0,0,0,15,10,25,53,52,105,166
20192020,059,KENTON,157,Erlanger-Elsmere Independent,"",---District Total---,157,"","",NKCES,905,03,100,104,9,9,18,0,0,0,0,0,0,11,10,21,3,1,4,9,17,26,72,63,135,204
20192020,059,KENTON,157,Erlanger-Elsmere Independent,"",---District Total---,157,"","",NKCES,905,04,88,109,6,5,11,0,0,0,0,2,2,14,19,33,0,1,1,20,11,31,69,50,119,197
20192020,059,KENTON,157,Erlanger-Elsmere Independent,"",---District Total---,157,"","",NKCES,905,05,83,104,5,6,11,0,0,0,0,0,0,9,13,22,2,1,3,10,15,25,78,48,126,187
20192020,059,KENTON,157,Erlanger-Elsmere Independent,"",---District Total---,157,"","",NKCES,905,06,97,101,6,6,12,0,0,0,0,0,0,11,10,21,3,2,5,14,9,23,67,70,137,198
20192020,059,KENTON,157,Erlanger-Elsmere Independent,"",---District Total---,157,"","",NKCES,905,14,0,2,0,0,0,0,0,0,0,0,0,0,0,0,0,0,0,0,0,0,2,0,2,2
20192020,059,KENTON,157,Erlanger-Elsmere Independent,"",---District Total---,157,"","",NKCES,905,07,97,107,16,10,26,0,0,0,0,0,0,10,11,21,4,1,5,14,8,22,63,67,130,204
20192020,059,KENTON,157,Erlanger-Elsmere Independent,"",---District Total---,157,"","",NKCES,905,08,89,92,7,10,17,0,0,0,1,1,2,5,9,14,0,2,2,12,12,24,67,55,122,181
20192020,059,KENTON,157,Erlanger-Elsmere Independent,"",---District Total---,157,"","",NKCES,905,09,91,102,7,5,12,0,0,0,0,1,1,13,9,22,0,0,0,9,9,18,73,67,140,193
20192020,059,KENTON,157,Erlanger-Elsmere Independent,"",---District Total---,157,"","",NKCES,905,10,80,98,10,6,16,1,0,1,0,0,0,11,8,19,3,2,5,8,6,14,65,58,123,178
20192020,059,KENTON,157,Erlanger-Elsmere Independent,"",---District Total---,157,"","",NKCES,905,12,63,92,8,7,15,0,0,0,0,0,0,10,10,20,0,2,2,5,3,8,69,41,110,155
20192020,059,KENTON,157,Erlanger-Elsmere Independent,003,Lindeman Elementary School,157003,059157003,210174000334,NKCES,905,KG,29,27,5,1,6,0,0,0,0,0,0,7,2,9,1,2,3,2,4,6,12,20,32,56
20192020,059,KENTON,157,Erlanger-Elsmere Independent,003,Lindeman Elementary School,157003,059157003,210174000334,NKCES,905,All Students,150,160,19,13,32,0,0,0,1,2,3,28,19,47,5,6,11,18,25,43,89,85,174,310
20192020,059,KENTON,157,Erlanger-Elsmere Independent,003,Lindeman Elementary School,157003,059157003,210174000334,NKCES,905,01,25,21,3,1,4,0,0,0,1,0,1,3,1,4,0,2,2,4,3,7,10,18,28,46
20192020,059,KENTON,157,Erlanger-Elsmere Independent,003,Lindeman Elementary School,157003,059157003,210174000334,NKCES,905,02,21,27,4,2,6,0,0,0,0,0,0,8,3,11,0,0,0,3,2,5,12,14,26,48
20192020,059,KENTON,157,Erlanger-Elsmere Independent,003,Lindeman Elementary School,157003,059157003,210174000334,NKCES,905,03,31,30,4,3,7,0,0,0,0,0,0,2,5,7,3,0,3,3,8,11,18,15,33,61
20192020,059,KENTON,157,Erlanger-Elsmere Independent,003,Lindeman Elementary School,157003,059157003,210174000334,NKCES,905,04,21,29,3,3,6,0,0,0,0,2,2,5,6,11,0,1,1,4,2,6,17,7,24,50
20192020,059,KENTON,157,Erlanger-Elsmere Independent,003,Lindeman Elementary School,157003,059157003,210174000334,NKCES,905,05,23,26,0,3,3,0,0,0,0,0,0,3,2,5,1,1,2,2,6,8,20,11,31,49
20192020,059,KENTON,157,Erlanger-Elsmere Independent,005,Arnett Elementary School,157005,059157005,210174000335,NKCES,905,05,13,22,3,1,4,0,0,0,0,0,0,0,1,1,1,0,1,1,4,5,17,7,24,35
20192020,059,KENTON,157,Erlanger-Elsmere Independent,005,Arnett Elementary School,157005,059157005,210174000335,NKCES,905,All Students,115,138,9,11,20,0,0,0,0,0,0,6,13,19,1,0,1,15,15,30,107,76,183,253
20192020,059,KENTON,157,Erlanger-Elsmere Independent,005,Arnett Elementary School,157005,059157005,210174000335,NKCES,905,PS,19,38,3,1,4,0,0,0,0,0,0,3,1,4,0,0,0,6,3,9,26,14,40,57
20192020,059,KENTON,157,Erlanger-Elsmere Independent,005,Arnett Elementary School,157005,059157005,210174000335,NKCES,905,KG,19,28,2,4,6,0,0,0,0,0,0,1,4,5,0,0,0,4,1,5,21,10,31,47
20192020,059,KENTON,157,Erlanger-Elsmere Independent,005,Arnett Elementary School,157005,059157005,210174000335,NKCES,905,01,22,17,2,1,3,0,0,0,0,0,0,0,2,2,0,0,0,1,5,6,14,14,28,39
20192020,059,KENTON,157,Erlanger-Elsmere Independent,005,Arnett Elementary School,157005,059157005,210174000335,NKCES,905,02,17,20,1,1,2,0,0,0,0,0,0,0,2,2,0,0,0,3,1,4,16,13,29,37
20192020,059,KENTON,157,Erlanger-Elsmere Independent,005,Arnett Elementary School,157005,059157005,210174000335,NKCES,905,03,21,25,1,3,4,0,0,0,0,0,0,3,0,3,0,0,0,0,1,1,21,17,38,46
20192020,059,KENTON,157,Erlanger-Elsmere Independent,005,Arnett Elementary School,157005,059157005,210174000335,NKCES,905,04,23,26,0,1,1,0,0,0,0,0,0,2,4,6,0,0,0,6,3,9,18,15,33,49
20192020,059,KENTON,157,Erlanger-Elsmere Independent,010,Howell Elementary School,157010,059157010,210174000336,NKCES,905,04,22,28,2,0,2,0,0,0,0,0,0,4,3,7,0,0,0,6,4,10,16,15,31,50
20192020,059,KENTON,157,Erlanger-Elsmere Independent,010,Howell Elementary School,157010,059157010,210174000336,NKCES,905,All Students,141,158,11,10,21,0,0,0,0,1,1,24,23,47,0,1,1,27,23,50,96,83,179,299
20192020,059,KENTON,157,Erlanger-Elsmere Independent,010,Howell Elementary School,157010,059157010,210174000336,NKCES,905,KG,24,22,4,3,7,0,0,0,0,0,0,5,6,11,0,1,1,1,2,3,12,12,24,46
20192020,059,KENTON,157,Erlanger-Elsmere Independent,010,Howell Elementary School,157010,059157010,210174000336,NKCES,905,01,21,21,0,1,1,0,0,0,0,1,1,4,3,7,0,0,0,5,2,7,12,14,26,42
20192020,059,KENTON,157,Erlanger-Elsmere Independent,010,Howell Elementary School,157010,059157010,210174000336,NKCES,905,02,22,24,1,2,3,0,0,0,0,0,0,2,3,5,0,0,0,8,4,12,13,13,26,46
20192020,059,KENTON,157,Erlanger-Elsmere Independent,010,Howell Elementary School,157010,059157010,210174000336,NKCES,905,03,29,27,2,2,4,0,0,0,0,0,0,4,4,8,0,0,0,3,6,9,18,17,35,56
20192020,059,KENTON,157,Erlanger-Elsmere Independent,010,Howell Elementary School,157010,059157010,210174000336,NKCES,905,05,23,36,2,2,4,0,0,0,0,0,0,5,4,9,0,0,0,4,5,9,25,12,37,59
20192020,059,KENTON,157,Erlanger-Elsmere Independent,015,Early Learning Center,157015,059157015,210174002498,NKCES,905,All Students,0,0,0,0,0,0,0,0,0,0,0,0,0,0,0,0,0,0,0,0,0,0,0,0
20192020,059,KENTON,157,Erlanger-Elsmere Independent,015,Early Learning Center,157015,059157015,210174002498,NKCES,905,PS,27,33,1,1,2,0,0,0,0,0,0,4,2,6,0,0,0,2,2,4,26,22,48,60
20192020,059,KENTON,157,Erlanger-Elsmere Independent,030,Lloyd High School,157030,059157030,210174000337,NKCES,905,12,60,80,7,7,14,0,0,0,0,0,0,9,10,19,0,2,2,4,3,7,60,38,98,140
20192020,059,KENTON,157,Erlanger-Elsmere Independent,030,Lloyd High School,157030,059157030,210174000337,NKCES,905,All Students,297,337,31,24,55,1,0,1,0,1,1,42,36,78,3,5,8,26,24,50,234,207,441,634
20192020,059,KENTON,157,Erlanger-Elsmere Independent,030,Lloyd High School,157030,059157030,210174000337,NKCES,905,09,84,94,6,3,9,0,0,0,0,1,1,12,8,20,0,0,0,9,9,18,67,63,130,178
20192020,059,KENTON,157,Erlanger-Elsmere Independent,030,Lloyd High School,157030,059157030,210174000337,NKCES,905,10,74,87,8,6,14,1,0,1,0,0,0,10,8,18,3,2,5,5,6,11,60,52,112,161
20192020,059,KENTON,157,Erlanger-Elsmere Independent,030,Lloyd High School,157030,059157030,210174000337,NKCES,905,11,79,74,10,8,18,0,0,0,0,0,0,11,10,21,0,1,1,8,6,14,45,54,99,153
20192020,059,KENTON,157,Erlanger-Elsmere Independent,030,Lloyd High School,157030,059157030,210174000337,NKCES,905,14,0,2,0,0,0,0,0,0,0,0,0,0,0,0,0,0,0,0,0,0,2,0,2,2
20192020,059,KENTON,157,Erlanger-Elsmere Independent,050,Miles Elementary School,157050,059157050,210174000338,NKCES,905,04,22,26,1,1,2,0,0,0,0,0,0,3,6,9,0,0,0,4,2,6,18,13,31,48
20192020,059,KENTON,157,Erlanger-Elsmere Independent,050,Miles Elementary School,157050,059157050,210174000338,NKCES,905,All Students,137,130,5,4,9,0,0,0,0,0,0,13,24,37,0,1,1,17,13,30,95,95,190,267
20192020,059,KENTON,157,Erlanger-Elsmere Independent,050,Miles Elementary School,157050,059157050,210174000338,NKCES,905,KG,24,27,0,0,0,0,0,0,0,0,0,2,3,5,0,0,0,3,4,7,22,17,39,51
20192020,059,KENTON,157,Erlanger-Elsmere Independent,050,Miles Elementary School,157050,059157050,210174000338,NKCES,905,01,29,19,2,1,3,0,0,0,0,0,0,2,5,7,0,0,0,3,2,5,12,21,33,48
20192020,059,KENTON,157,Erlanger-Elsmere Independent,050,Miles Elementary School,157050,059157050,210174000338,NKCES,905,02,19,16,0,1,1,0,0,0,0,0,0,3,3,6,0,0,0,1,3,4,12,12,24,35
20192020,059,KENTON,157,Erlanger-Elsmere Independent,050,Miles Elementary School,157050,059157050,210174000338,NKCES,905,03,19,22,2,1,3,0,0,0,0,0,0,2,1,3,0,1,1,3,2,5,15,14,29,41
20192020,059,KENTON,157,Erlanger-Elsmere Independent,050,Miles Elementary School,157050,059157050,210174000338,NKCES,905,05,24,20,0,0,0,0,0,0,0,0,0,1,6,7,0,0,0,3,0,3,16,18,34,44
20192020,059,KENTON,157,Erlanger-Elsmere Independent,060,Tichenor Middle School,157060,059157060,210174000339,NKCES,905,07,96,103,15,10,25,0,0,0,0,0,0,9,11,20,3,1,4,13,8,21,63,66,129,199
20192020,059,KENTON,157,Erlanger-Elsmere Independent,060,Tichenor Middle School,157060,059157060,210174000339,NKCES,905,All Students,279,287,27,26,53,0,0,0,1,1,2,24,30,54,6,5,11,36,29,65,193,188,381,566
20192020,059,KENTON,157,Erlanger-Elsmere Independent,060,Tichenor Middle School,157060,059157060,210174000339,NKCES,905,06,96,96,6,6,12,0,0,0,0,0,0,10,10,20,3,2,5,13,9,22,64,69,133,192
20192020,059,KENTON,157,Erlanger-Elsmere Independent,060,Tichenor Middle School,157060,059157060,210174000339,NKCES,905,08,87,88,6,10,16,0,0,0,1,1,2,5,9,14,0,2,2,10,12,22,66,53,119,175
20192020,059,KENTON,157,Erlanger-Elsmere Independent,061,Bartlett Educational Center,157061,059157061,210174002313,NKCES,905,12,3,12,1,0,1,0,0,0,0,0,0,1,0,1,0,0,0,1,0,1,9,3,12,15
20192020,059,KENTON,157,Erlanger-Elsmere Independent,061,Bartlett Educational Center,157061,059157061,210174002313,NKCES,905,All Students,27,58,9,3,12,0,0,0,0,0,0,6,2,8,1,0,1,11,3,14,31,19,50,85
20192020,059,KENTON,157,Erlanger-Elsmere Independent,061,Bartlett Educational Center,157061,059157061,210174002313,NKCES,905,06,1,5,0,0,0,0,0,0,0,0,0,1,0,1,0,0,0,1,0,1,3,1,4,6
20192020,059,KENTON,157,Erlanger-Elsmere Independent,061,Bartlett Educational Center,157061,059157061,210174002313,NKCES,905,07,1,4,1,0,1,0,0,0,0,0,0,1,0,1,1,0,1,1,0,1,0,1,1,5
20192020,059,KENTON,157,Erlanger-Elsmere Independent,061,Bartlett Educational Center,157061,059157061,210174002313,NKCES,905,08,2,4,1,0,1,0,0,0,0,0,0,0,0,0,0,0,0,2,0,2,1,2,3,6
20192020,059,KENTON,157,Erlanger-Elsmere Independent,061,Bartlett Educational Center,157061,059157061,210174002313,NKCES,905,09,7,8,1,2,3,0,0,0,0,0,0,1,1,2,0,0,0,0,0,0,6,4,10,15
20192020,059,KENTON,157,Erlanger-Elsmere Independent,061,Bartlett Educational Center,157061,059157061,210174002313,NKCES,905,10,6,11,2,0,2,0,0,0,0,0,0,1,0,1,0,0,0,3,0,3,5,6,11,17
20192020,059,KENTON,157,Erlanger-Elsmere Independent,061,Bartlett Educational Center,157061,059157061,210174002313,NKCES,905,11,7,14,3,1,4,0,0,0,0,0,0,1,1,2,0,0,0,3,3,6,7,2,9,21
20192020,033,ESTILL,161,Estill County,"",---District Total---,161,"","",SESC,907,14,0,2,0,0,0,0,0,0,0,0,0,0,0,0,0,0,0,0,0,0,2,0,2,2
20192020,033,ESTILL,161,Estill County,"",---District Total---,161,"","",SESC,907,All Students,1055,1131,3,3,6,0,2,2,3,1,4,9,14,23,0,1,1,15,10,25,1101,1024,2125,2186
20192020,033,ESTILL,161,Estill County,"",---District Total---,161,"","",SESC,907,PS,89,95,0,0,0,0,0,0,0,0,0,2,1,3,0,0,0,0,0,0,93,88,181,184
20192020,033,ESTILL,161,Estill County,"",---District Total---,161,"","",SESC,907,KG,90,95,1,0,1,0,0,0,0,0,0,3,3,6,0,0,0,2,2,4,89,85,174,185
20192020,033,ESTILL,161,Estill County,"",---District Total---,161,"","",SESC,907,01,82,81,0,0,0,0,2,2,0,0,0,1,0,1,0,0,0,1,2,3,79,78,157,163
20192020,033,ESTILL,161,Estill County,"",---District Total---,161,"","",SESC,907,02,67,72,0,0,0,0,0,0,0,0,0,1,2,3,0,0,0,1,0,1,70,65,135,139
20192020,033,ESTILL,161,Estill County,"",---District Total---,161,"","",SESC,907,03,59,82,1,0,1,0,0,0,0,0,0,2,0,2,0,1,1,2,0,2,77,58,135,141
20192020,033,ESTILL,161,Estill County,"",---District Total---,161,"","",SESC,907,04,78,78,0,0,0,0,0,0,0,0,0,1,2,3,0,0,0,1,0,1,76,76,152,156
20192020,033,ESTILL,161,Estill County,"",---District Total---,161,"","",SESC,907,05,82,93,0,2,2,0,0,0,0,0,0,0,1,1,0,0,0,3,1,4,90,78,168,175
20192020,033,ESTILL,161,Estill County,"",---District Total---,161,"","",SESC,907,06,94,94,0,0,0,0,0,0,0,0,0,1,0,1,0,0,0,2,3,5,91,91,182,188
20192020,033,ESTILL,161,Estill County,"",---District Total---,161,"","",SESC,907,07,98,88,0,0,0,0,0,0,1,1,2,0,1,1,0,0,0,0,1,1,87,95,182,186
20192020,033,ESTILL,161,Estill County,"",---District Total---,161,"","",SESC,907,08,74,100,1,1,2,0,0,0,0,0,0,0,1,1,0,0,0,1,0,1,98,72,170,174
20192020,033,ESTILL,161,Estill County,"",---District Total---,161,"","",SESC,907,09,86,78,0,0,0,0,0,0,0,0,0,0,0,0,0,0,0,0,1,1,78,85,163,164
20192020,033,ESTILL,161,Estill County,"",---District Total---,161,"","",SESC,907,10,83,108,0,0,0,0,0,0,2,0,2,0,2,2,0,0,0,1,0,1,105,81,186,191
20192020,033,ESTILL,161,Estill County,"",---District Total---,161,"","",SESC,907,11,78,74,0,0,0,0,0,0,0,0,0,0,1,1,0,0,0,0,0,0,74,77,151,152
20192020,033,ESTILL,161,Estill County,"",---District Total---,161,"","",SESC,907,12,84,86,0,0,0,0,0,0,0,0,0,0,1,1,0,0,0,1,0,1,85,83,168,170
20192020,033,ESTILL,161,Estill County,011,Estill Springs Elementary,161011,033161011,210176001746,SESC,907,01,82,81,0,0,0,0,2,2,0,0,0,1,0,1,0,0,0,1,2,3,79,78,157,163
20192020,033,ESTILL,161,Estill County,011,Estill Springs Elementary,161011,033161011,210176001746,SESC,907,All Students,239,248,1,0,1,0,2,2,0,0,0,5,5,10,0,0,0,4,4,8,238,228,466,487
20192020,033,ESTILL,161,Estill County,011,Estill Springs Elementary,161011,033161011,210176001746,SESC,907,KG,90,95,1,0,1,0,0,0,0,0,0,3,3,6,0,0,0,2,2,4,89,85,174,185
20192020,033,ESTILL,161,Estill County,011,Estill Springs Elementary,161011,033161011,210176001746,SESC,907,02,67,72,0,0,0,0,0,0,0,0,0,1,2,3,0,0,0,1,0,1,70,65,135,139
20192020,033,ESTILL,161,Estill County,014,Estill County Success Academy,161014,033161014,210176002406,SESC,907,10,2,4,0,0,0,0,0,0,0,0,0,0,0,0,0,0,0,0,0,0,4,2,6,6
20192020,033,ESTILL,161,Estill County,014,Estill County Success Academy,161014,033161014,210176002406,SESC,907,All Students,5,14,0,0,0,0,0,0,0,0,0,0,0,0,0,0,0,0,0,0,14,5,19,19
20192020,033,ESTILL,161,Estill County,014,Estill County Success Academy,161014,033161014,210176002406,SESC,907,06,0,4,0,0,0,0,0,0,0,0,0,0,0,0,0,0,0,0,0,0,4,0,4,4
20192020,033,ESTILL,161,Estill County,014,Estill County Success Academy,161014,033161014,210176002406,SESC,907,07,1,0,0,0,0,0,0,0,0,0,0,0,0,0,0,0,0,0,0,0,0,1,1,1
20192020,033,ESTILL,161,Estill County,014,Estill County Success Academy,161014,033161014,210176002406,SESC,907,08,1,2,0,0,0,0,0,0,0,0,0,0,0,0,0,0,0,0,0,0,2,1,3,3
20192020,033,ESTILL,161,Estill County,014,Estill County Success Academy,161014,033161014,210176002406,SESC,907,09,0,3,0,0,0,0,0,0,0,0,0,0,0,0,0,0,0,0,0,0,3,0,3,3
20192020,033,ESTILL,161,Estill County,014,Estill County Success Academy,161014,033161014,210176002406,SESC,907,12,1,1,0,0,0,0,0,0,0,0,0,0,0,0,0,0,0,0,0,0,1,1,2,2
20192020,033,ESTILL,161,Estill County,085,Estill County Middle School,161085,033161085,210176000341,SESC,907,08,73,98,1,1,2,0,0,0,0,0,0,0,1,1,0,0,0,1,0,1,96,71,167,171
20192020,033,ESTILL,161,Estill County,085,Estill County Middle School,161085,033161085,210176000341,SESC,907,All Students,264,276,1,1,2,0,0,0,1,1,2,1,2,3,0,0,0,3,4,7,270,256,526,540
20192020,033,ESTILL,161,Estill County,085,Estill County Middle School,161085,033161085,210176000341,SESC,907,06,94,90,0,0,0,0,0,0,0,0,0,1,0,1,0,0,0,2,3,5,87,91,178,184
20192020,033,ESTILL,161,Estill County,085,Estill County Middle School,161085,033161085,210176000341,SESC,907,07,97,88,0,0,0,0,0,0,1,1,2,0,1,1,0,0,0,0,1,1,87,94,181,185
20192020,033,ESTILL,161,Estill County,090,Estill County High School,161090,033161090,210176000342,SESC,907,09,86,75,0,0,0,0,0,0,0,0,0,0,0,0,0,0,0,0,1,1,75,85,160,161
20192020,033,ESTILL,161,Estill County,090,Estill County High School,161090,033161090,210176000342,SESC,907,All Students,328,340,0,0,0,0,0,0,2,0,2,0,4,4,0,0,0,2,1,3,336,323,659,668
20192020,033,ESTILL,161,Estill County,090,Estill County High School,161090,033161090,210176000342,SESC,907,12,83,85,0,0,0,0,0,0,0,0,0,0,1,1,0,0,0,1,0,1,84,82,166,168
20192020,033,ESTILL,161,Estill County,090,Estill County High School,161090,033161090,210176000342,SESC,907,14,0,2,0,0,0,0,0,0,0,0,0,0,0,0,0,0,0,0,0,0,2,0,2,2
20192020,033,ESTILL,161,Estill County,090,Estill County High School,161090,033161090,210176000342,SESC,907,10,81,104,0,0,0,0,0,0,2,0,2,0,2,2,0,0,0,1,0,1,101,79,180,185
20192020,033,ESTILL,161,Estill County,090,Estill County High School,161090,033161090,210176000342,SESC,907,11,78,74,0,0,0,0,0,0,0,0,0,0,1,1,0,0,0,0,0,0,74,77,151,152
20192020,033,ESTILL,161,Estill County,220,South Irvine Early Learning Center,161220,033161220,210176000345,SESC,907,All Students,0,0,0,0,0,0,0,0,0,0,0,0,0,0,0,0,0,0,0,0,0,0,0,0
20192020,033,ESTILL,161,Estill County,220,South Irvine Early Learning Center,161220,033161220,210176000345,SESC,907,PS,89,95,0,0,0,0,0,0,0,0,0,2,1,3,0,0,0,0,0,0,93,88,181,184
20192020,033,ESTILL,161,Estill County,280,West Irvine Intermediate,161280,033161280,210176000346,SESC,907,04,78,78,0,0,0,0,0,0,0,0,0,1,2,3,0,0,0,1,0,1,76,76,152,156
20192020,033,ESTILL,161,Estill County,280,West Irvine Intermediate,161280,033161280,210176000346,SESC,907,05,82,93,0,2,2,0,0,0,0,0,0,0,1,1,0,0,0,3,1,4,90,78,168,175
20192020,033,ESTILL,161,Estill County,280,West Irvine Intermediate,161280,033161280,210176000346,SESC,907,All Students,219,253,1,2,3,0,0,0,0,0,0,3,3,6,0,1,1,6,1,7,243,212,455,472
20192020,033,ESTILL,161,Estill County,280,West Irvine Intermediate,161280,033161280,210176000346,SESC,907,03,59,82,1,0,1,0,0,0,0,0,0,2,0,2,0,1,1,2,0,2,77,58,135,141
20192020,010,BOYD,162,Fairview Independent,"",---District Total---,162,"","",KEDC,903,03,15,27,0,0,0,0,0,0,0,0,0,0,0,0,0,0,0,0,0,0,27,15,42,42
20192020,010,BOYD,162,Fairview Independent,"",---District Total---,162,"","",KEDC,903,All Students,300,334,5,4,9,1,0,1,0,0,0,0,1,1,0,0,0,16,9,25,312,286,598,634
20192020,010,BOYD,162,Fairview Independent,"",---District Total---,162,"","",KEDC,903,PS,17,30,0,2,2,0,0,0,0,0,0,0,0,0,0,0,0,0,4,4,30,11,41,47
20192020,010,BOYD,162,Fairview Independent,"",---District Total---,162,"","",KEDC,903,KG,22,22,1,0,1,0,0,0,0,0,0,0,0,0,0,0,0,3,1,4,18,21,39,44
20192020,010,BOYD,162,Fairview Independent,"",---District Total---,162,"","",KEDC,903,01,18,24,0,0,0,0,0,0,0,0,0,0,0,0,0,0,0,2,2,4,22,16,38,42
20192020,010,BOYD,162,Fairview Independent,"",---District Total---,162,"","",KEDC,903,02,19,22,0,0,0,0,0,0,0,0,0,0,0,0,0,0,0,1,0,1,21,19,40,41
20192020,010,BOYD,162,Fairview Independent,"",---District Total---,162,"","",KEDC,903,04,19,24,0,0,0,0,0,0,0,0,0,0,0,0,0,0,0,3,1,4,21,18,39,43
20192020,010,BOYD,162,Fairview Independent,"",---District Total---,162,"","",KEDC,903,05,16,34,1,0,1,1,0,1,0,0,0,0,0,0,0,0,0,0,0,0,32,16,48,50
20192020,010,BOYD,162,Fairview Independent,"",---District Total---,162,"","",KEDC,903,06,22,23,0,2,2,0,0,0,0,0,0,0,0,0,0,0,0,0,2,2,23,18,41,45
20192020,010,BOYD,162,Fairview Independent,"",---District Total---,162,"","",KEDC,903,07,32,29,0,1,1,0,0,0,0,0,0,0,1,1,0,0,0,0,1,1,29,29,58,61
20192020,010,BOYD,162,Fairview Independent,"",---District Total---,162,"","",KEDC,903,08,23,26,1,0,1,0,0,0,0,0,0,0,0,0,0,0,0,3,1,4,22,22,44,49
20192020,010,BOYD,162,Fairview Independent,"",---District Total---,162,"","",KEDC,903,09,31,28,1,0,1,0,0,0,0,0,0,0,0,0,0,0,0,1,0,1,26,31,57,59
20192020,010,BOYD,162,Fairview Independent,"",---District Total---,162,"","",KEDC,903,10,31,34,0,1,1,0,0,0,0,0,0,0,0,0,0,0,0,2,1,3,32,29,61,65
20192020,010,BOYD,162,Fairview Independent,"",---District Total---,162,"","",KEDC,903,11,26,24,0,0,0,0,0,0,0,0,0,0,0,0,0,0,0,1,0,1,23,26,49,50
20192020,010,BOYD,162,Fairview Independent,"",---District Total---,162,"","",KEDC,903,12,26,17,1,0,1,0,0,0,0,0,0,0,0,0,0,0,0,0,0,0,16,26,42,43
20192020,010,BOYD,162,Fairview Independent,011,Fairview Elementary School,162011,010162011,210180001889,KEDC,903,05,16,34,1,0,1,1,0,1,0,0,0,0,0,0,0,0,0,0,0,0,32,16,48,50
20192020,010,BOYD,162,Fairview Independent,011,Fairview Elementary School,162011,010162011,210180001889,KEDC,903,All Students,109,153,2,0,2,1,0,1,0,0,0,0,0,0,0,0,0,9,4,13,141,105,246,262
20192020,010,BOYD,162,Fairview Independent,011,Fairview Elementary School,162011,010162011,210180001889,KEDC,903,PS,17,30,0,2,2,0,0,0,0,0,0,0,0,0,0,0,0,0,4,4,30,11,41,47
20192020,010,BOYD,162,Fairview Independent,011,Fairview Elementary School,162011,010162011,210180001889,KEDC,903,KG,22,22,1,0,1,0,0,0,0,0,0,0,0,0,0,0,0,3,1,4,18,21,39,44
20192020,010,BOYD,162,Fairview Independent,011,Fairview Elementary School,162011,010162011,210180001889,KEDC,903,01,18,24,0,0,0,0,0,0,0,0,0,0,0,0,0,0,0,2,2,4,22,16,38,42
20192020,010,BOYD,162,Fairview Independent,011,Fairview Elementary School,162011,010162011,210180001889,KEDC,903,02,19,22,0,0,0,0,0,0,0,0,0,0,0,0,0,0,0,1,0,1,21,19,40,41
20192020,010,BOYD,162,Fairview Independent,011,Fairview Elementary School,162011,010162011,210180001889,KEDC,903,03,15,27,0,0,0,0,0,0,0,0,0,0,0,0,0,0,0,0,0,0,27,15,42,42
20192020,010,BOYD,162,Fairview Independent,011,Fairview Elementary School,162011,010162011,210180001889,KEDC,903,04,19,24,0,0,0,0,0,0,0,0,0,0,0,0,0,0,0,3,1,4,21,18,39,43
20192020,010,BOYD,162,Fairview Independent,020,Fairview High School,162020,010162020,210180000348,KEDC,903,11,26,24,0,0,0,0,0,0,0,0,0,0,0,0,0,0,0,1,0,1,23,26,49,50
20192020,010,BOYD,162,Fairview Independent,020,Fairview High School,162020,010162020,210180000348,KEDC,903,All Students,191,181,3,4,7,0,0,0,0,0,0,0,1,1,0,0,0,7,5,12,171,181,352,372
20192020,010,BOYD,162,Fairview Independent,020,Fairview High School,162020,010162020,210180000348,KEDC,903,06,22,23,0,2,2,0,0,0,0,0,0,0,0,0,0,0,0,0,2,2,23,18,41,45
20192020,010,BOYD,162,Fairview Independent,020,Fairview High School,162020,010162020,210180000348,KEDC,903,07,32,29,0,1,1,0,0,0,0,0,0,0,1,1,0,0,0,0,1,1,29,29,58,61
20192020,010,BOYD,162,Fairview Independent,020,Fairview High School,162020,010162020,210180000348,KEDC,903,08,23,26,1,0,1,0,0,0,0,0,0,0,0,0,0,0,0,3,1,4,22,22,44,49
20192020,010,BOYD,162,Fairview Independent,020,Fairview High School,162020,010162020,210180000348,KEDC,903,09,31,28,1,0,1,0,0,0,0,0,0,0,0,0,0,0,0,1,0,1,26,31,57,59
20192020,010,BOYD,162,Fairview Independent,020,Fairview High School,162020,010162020,210180000348,KEDC,903,10,31,34,0,1,1,0,0,0,0,0,0,0,0,0,0,0,0,2,1,3,32,29,61,65
20192020,010,BOYD,162,Fairview Independent,020,Fairview High School,162020,010162020,210180000348,KEDC,903,12,26,17,1,0,1,0,0,0,0,0,0,0,0,0,0,0,0,0,0,0,16,26,42,43
20192020,034,FAYETTE,165,Fayette County,"",---District Total---,165,"","",CKEC,901,12,1385,1342,326,318,644,3,0,3,58,73,131,182,179,361,2,0,2,35,52,87,736,763,1499,2727
20192020,034,FAYETTE,165,Fayette County,"",---District Total---,165,"","",CKEC,901,All Students,20235,21014,4743,4651,9394,33,31,64,997,989,1986,3789,3529,7318,14,15,29,1121,1192,2313,10317,9828,20145,41249
20192020,034,FAYETTE,165,Fayette County,"",---District Total---,165,"","",CKEC,901,PS,509,756,224,161,385,0,1,1,39,20,59,155,115,270,1,0,1,59,31,90,278,181,459,1265
20192020,034,FAYETTE,165,Fayette County,"",---District Total---,165,"","",CKEC,901,KG,1576,1663,343,320,663,1,2,3,69,79,148,320,290,610,3,0,3,108,113,221,819,772,1591,3239
20192020,034,FAYETTE,165,Fayette County,"",---District Total---,165,"","",CKEC,901,01,1611,1646,374,373,747,5,1,6,99,78,177,292,265,557,1,1,2,103,126,229,772,767,1539,3257
20192020,034,FAYETTE,165,Fayette County,"",---District Total---,165,"","",CKEC,901,02,1416,1452,301,304,605,6,1,7,89,90,179,245,241,486,0,1,1,92,116,208,719,663,1382,2868
20192020,034,FAYETTE,165,Fayette County,"",---District Total---,165,"","",CKEC,901,03,1629,1686,375,358,733,5,2,7,76,78,154,307,302,609,1,2,3,95,89,184,827,798,1625,3315
20192020,034,FAYETTE,165,Fayette County,"",---District Total---,165,"","",CKEC,901,04,1528,1626,360,345,705,1,1,2,88,67,155,286,295,581,1,0,1,95,108,203,795,712,1507,3154
20192020,034,FAYETTE,165,Fayette County,"",---District Total---,165,"","",CKEC,901,05,1570,1773,423,387,810,4,4,8,89,69,158,332,288,620,1,2,3,99,106,205,825,714,1539,3343
20192020,034,FAYETTE,165,Fayette County,"",---District Total---,165,"","",CKEC,901,06,1644,1642,388,389,777,1,4,5,71,70,141,326,307,633,2,1,3,86,94,180,768,779,1547,3286
20192020,034,FAYETTE,165,Fayette County,"",---District Total---,165,"","",CKEC,901,07,1606,1706,399,383,782,2,2,4,75,71,146,314,313,627,0,2,2,90,83,173,826,752,1578,3312
20192020,034,FAYETTE,165,Fayette County,"",---District Total---,165,"","",CKEC,901,08,1544,1607,319,374,693,0,3,3,78,77,155,326,299,625,0,3,3,90,79,169,794,709,1503,3151
20192020,034,FAYETTE,165,Fayette County,"",---District Total---,165,"","",CKEC,901,09,1620,1908,454,391,845,1,3,4,73,67,140,367,287,654,0,0,0,100,93,193,913,779,1692,3528
20192020,034,FAYETTE,165,Fayette County,"",---District Total---,165,"","",CKEC,901,10,1589,1550,361,394,755,3,2,5,64,78,142,266,229,495,3,0,3,77,67,144,776,819,1595,3139
20192020,034,FAYETTE,165,Fayette County,"",---District Total---,165,"","",CKEC,901,11,1507,1399,315,311,626,1,6,7,67,91,158,225,233,458,0,3,3,51,66,117,740,797,1537,2906
20192020,034,FAYETTE,165,Fayette County,"",---District Total---,165,"","",CKEC,901,14,10,14,5,4,9,0,0,0,1,1,2,1,1,2,0,0,0,0,0,0,7,4,11,24
20192020,034,FAYETTE,165,Fayette County,005,Arlington Elementary School,165005,034165005,210186000350,CKEC,901,04,20,17,10,9,19,0,0,0,0,0,0,0,8,8,0,0,0,1,0,1,6,3,9,37
20192020,034,FAYETTE,165,Fayette County,005,Arlington Elementary School,165005,034165005,210186000350,CKEC,901,All Students,141,129,44,49,93,0,1,1,0,0,0,49,52,101,0,0,0,3,4,7,33,35,68,270
20192020,034,FAYETTE,165,Fayette County,005,Arlington Elementary School,165005,034165005,210186000350,CKEC,901,PS,17,29,11,2,13,0,0,0,0,1,1,11,10,21,0,0,0,0,1,1,7,3,10,46
20192020,034,FAYETTE,165,Fayette County,005,Arlington Elementary School,165005,034165005,210186000350,CKEC,901,KG,28,26,6,6,12,0,1,1,0,0,0,11,9,20,0,0,0,1,1,2,8,11,19,54
20192020,034,FAYETTE,165,Fayette County,005,Arlington Elementary School,165005,034165005,210186000350,CKEC,901,01,19,28,9,6,15,0,0,0,0,0,0,13,7,20,0,0,0,0,0,0,6,6,12,47
20192020,034,FAYETTE,165,Fayette County,005,Arlington Elementary School,165005,034165005,210186000350,CKEC,901,02,18,17,5,9,14,0,0,0,0,0,0,6,5,11,0,0,0,0,3,3,6,1,7,35
20192020,034,FAYETTE,165,Fayette County,005,Arlington Elementary School,165005,034165005,210186000350,CKEC,901,03,23,20,9,9,18,0,0,0,0,0,0,7,9,16,0,0,0,0,0,0,4,5,9,43
20192020,034,FAYETTE,165,Fayette County,005,Arlington Elementary School,165005,034165005,210186000350,CKEC,901,05,33,21,5,10,15,0,0,0,0,0,0,12,14,26,0,0,0,1,0,1,3,9,12,54
20192020,034,FAYETTE,165,Fayette County,007,Ashland Elementary School,165007,034165007,210186000351,CKEC,901,All Students,155,142,33,37,70,0,0,0,6,1,7,9,9,18,0,0,0,0,12,12,94,96,190,297
20192020,034,FAYETTE,165,Fayette County,007,Ashland Elementary School,165007,034165007,210186000351,CKEC,901,KG,25,14,7,4,11,0,0,0,0,0,0,1,2,3,0,0,0,0,1,1,6,18,24,39
20192020,034,FAYETTE,165,Fayette County,007,Ashland Elementary School,165007,034165007,210186000351,CKEC,901,01,29,18,6,6,12,0,0,0,2,0,2,0,1,1,0,0,0,0,1,1,10,21,31,47
20192020,034,FAYETTE,165,Fayette County,007,Ashland Elementary School,165007,034165007,210186000351,CKEC,901,02,21,15,3,6,9,0,0,0,0,0,0,1,0,1,0,0,0,0,1,1,11,14,25,36
20192020,034,FAYETTE,165,Fayette County,007,Ashland Elementary School,165007,034165007,210186000351,CKEC,901,03,24,28,5,8,13,0,0,0,0,0,0,4,2,6,0,0,0,0,3,3,19,11,30,52
20192020,034,FAYETTE,165,Fayette County,007,Ashland Elementary School,165007,034165007,210186000351,CKEC,901,04,21,32,3,6,9,0,0,0,1,0,1,1,2,3,0,0,0,0,3,3,27,10,37,53
20192020,034,FAYETTE,165,Fayette County,007,Ashland Elementary School,165007,034165007,210186000351,CKEC,901,05,35,35,9,7,16,0,0,0,3,1,4,2,2,4,0,0,0,0,3,3,21,22,43,70
20192020,034,FAYETTE,165,Fayette County,009,UK Early Childhood Lab,165009,034165009,210186002385,CKEC,901,PS,7,9,2,3,5,0,0,0,0,1,1,0,0,0,0,0,0,2,0,2,5,3,8,16
20192020,034,FAYETTE,165,Fayette County,009,UK Early Childhood Lab,165009,034165009,210186002385,CKEC,901,All Students,0,0,0,0,0,0,0,0,0,0,0,0,0,0,0,0,0,0,0,0,0,0,0,0
20192020,034,FAYETTE,165,Fayette County,012,Veterans Park Elementary School,165012,034165012,210186001421,CKEC,901,KG,55,78,6,9,15,0,0,0,5,1,6,3,3,6,0,0,0,8,6,14,56,36,92,133
20192020,034,FAYETTE,165,Fayette County,012,Veterans Park Elementary School,165012,034165012,210186001421,CKEC,901,01,69,62,8,6,14,0,0,0,3,6,9,4,5,9,0,0,0,2,7,9,45,45,90,131
20192020,034,FAYETTE,165,Fayette County,012,Veterans Park Elementary School,165012,034165012,210186001421,CKEC,901,02,60,66,8,7,15,0,0,0,7,5,12,0,2,2,0,0,0,2,3,5,49,43,92,126
20192020,034,FAYETTE,165,Fayette County,012,Veterans Park Elementary School,165012,034165012,210186001421,CKEC,901,03,64,84,12,6,18,1,1,2,0,2,2,5,2,7,0,0,0,3,1,4,63,52,115,148
20192020,034,FAYETTE,165,Fayette County,012,Veterans Park Elementary School,165012,034165012,210186001421,CKEC,901,05,55,61,7,5,12,0,0,0,0,1,1,4,0,4,0,0,0,1,3,4,49,46,95,116
20192020,034,FAYETTE,165,Fayette County,012,Veterans Park Elementary School,165012,034165012,210186001421,CKEC,901,04,62,67,8,11,19,0,0,0,6,4,10,3,2,5,0,0,0,1,3,4,49,42,91,129
20192020,034,FAYETTE,165,Fayette County,012,Veterans Park Elementary School,165012,034165012,210186001421,CKEC,901,All Students,365,418,49,44,93,1,1,2,21,19,40,19,14,33,0,0,0,17,23,40,311,264,575,783
20192020,034,FAYETTE,165,Fayette County,015,Beaumont Middle School,165015,034165015,210186000353,CKEC,901,07,136,155,10,12,22,0,1,1,16,12,28,25,24,49,0,0,0,4,8,12,100,79,179,291
20192020,034,FAYETTE,165,Fayette County,015,Beaumont Middle School,165015,034165015,210186000353,CKEC,901,All Students,427,482,29,42,71,0,2,2,47,44,91,109,77,186,0,0,0,16,19,35,281,243,524,909
20192020,034,FAYETTE,165,Fayette County,015,Beaumont Middle School,165015,034165015,210186000353,CKEC,901,06,146,154,11,16,27,0,1,1,17,18,35,35,28,63,0,0,0,6,6,12,85,77,162,300
20192020,034,FAYETTE,165,Fayette County,015,Beaumont Middle School,165015,034165015,210186000353,CKEC,901,08,145,173,8,14,22,0,0,0,14,14,28,49,25,74,0,0,0,6,5,11,96,87,183,318
20192020,034,FAYETTE,165,Fayette County,018,Scapa At Bluegrass,165018,034165018,210186000354,CKEC,901,07,39,18,0,5,5,0,0,0,3,5,8,0,1,1,0,0,0,1,0,1,14,28,42,57
20192020,034,FAYETTE,165,Fayette County,018,Scapa At Bluegrass,165018,034165018,210186000354,CKEC,901,All Students,190,88,4,17,21,0,1,1,11,25,36,1,6,7,0,0,0,3,21,24,69,120,189,278
20192020,034,FAYETTE,165,Fayette County,018,Scapa At Bluegrass,165018,034165018,210186000354,CKEC,901,04,35,19,1,2,3,0,0,0,5,3,8,0,0,0,0,0,0,0,6,6,13,24,37,54
20192020,034,FAYETTE,165,Fayette County,018,Scapa At Bluegrass,165018,034165018,210186000354,CKEC,901,05,36,18,1,3,4,0,1,1,3,7,10,1,1,2,0,0,0,1,4,5,12,20,32,54
20192020,034,FAYETTE,165,Fayette County,018,Scapa At Bluegrass,165018,034165018,210186000354,CKEC,901,06,39,17,2,6,8,0,0,0,0,4,4,0,1,1,0,0,0,1,5,6,14,23,37,56
20192020,034,FAYETTE,165,Fayette County,018,Scapa At Bluegrass,165018,034165018,210186000354,CKEC,901,08,41,16,0,1,1,0,0,0,0,6,6,0,3,3,0,0,0,0,6,6,16,25,41,57
20192020,034,FAYETTE,165,Fayette County,021,Martin L King Acad for Excellence Alt,165021,034165021,210186001848,CKEC,901,11,30,27,8,7,15,0,1,1,0,0,0,2,2,4,0,0,0,1,1,2,16,19,35,57
20192020,034,FAYETTE,165,Fayette County,021,Martin L King Acad for Excellence Alt,165021,034165021,210186001848,CKEC,901,All Students,82,135,53,33,86,0,1,1,2,0,2,12,9,21,0,0,0,16,2,18,52,37,89,217
20192020,034,FAYETTE,165,Fayette County,021,Martin L King Acad for Excellence Alt,165021,034165021,210186001848,CKEC,901,06,2,3,2,1,3,0,0,0,0,0,0,0,1,1,0,0,0,0,0,0,1,0,1,5
20192020,034,FAYETTE,165,Fayette County,021,Martin L King Acad for Excellence Alt,165021,034165021,210186001848,CKEC,901,07,4,8,5,2,7,0,0,0,0,0,0,0,0,0,0,0,0,1,0,1,2,2,4,12
20192020,034,FAYETTE,165,Fayette County,021,Martin L King Acad for Excellence Alt,165021,034165021,210186001848,CKEC,901,08,7,14,10,5,15,0,0,0,0,0,0,1,2,3,0,0,0,0,0,0,3,0,3,21
20192020,034,FAYETTE,165,Fayette County,021,Martin L King Acad for Excellence Alt,165021,034165021,210186001848,CKEC,901,09,11,39,14,7,21,0,0,0,1,0,1,4,1,5,0,0,0,10,0,10,10,3,13,50
20192020,034,FAYETTE,165,Fayette County,021,Martin L King Acad for Excellence Alt,165021,034165021,210186001848,CKEC,901,10,19,37,11,8,19,0,0,0,1,0,1,5,1,6,0,0,0,4,1,5,16,9,25,56
20192020,034,FAYETTE,165,Fayette County,021,Martin L King Acad for Excellence Alt,165021,034165021,210186001848,CKEC,901,12,9,7,3,3,6,0,0,0,0,0,0,0,2,2,0,0,0,0,0,0,4,4,8,16
20192020,034,FAYETTE,165,Fayette County,025,Crawford Middle School,165025,034165025,210186000357,CKEC,901,06,122,127,42,43,85,0,0,0,2,1,3,41,30,71,0,1,1,8,9,17,34,38,72,249
20192020,034,FAYETTE,165,Fayette County,025,Crawford Middle School,165025,034165025,210186000357,CKEC,901,08,111,118,38,50,88,0,0,0,3,3,6,40,31,71,0,0,0,6,3,9,31,24,55,229
20192020,034,FAYETTE,165,Fayette County,025,Crawford Middle School,165025,034165025,210186000357,CKEC,901,All Students,381,369,135,144,279,1,0,1,8,9,17,104,97,201,0,1,1,23,20,43,98,110,208,750
20192020,034,FAYETTE,165,Fayette County,025,Crawford Middle School,165025,034165025,210186000357,CKEC,901,07,148,124,55,51,106,1,0,1,3,5,8,23,36,59,0,0,0,9,8,17,33,48,81,272
20192020,034,FAYETTE,165,Fayette County,030,Bryan Station Middle School,165030,034165030,210186000358,CKEC,901,06,159,128,32,41,73,0,0,0,1,1,2,38,48,86,0,0,0,5,5,10,52,64,116,287
20192020,034,FAYETTE,165,Fayette County,030,Bryan Station Middle School,165030,034165030,210186000358,CKEC,901,08,102,101,19,26,45,0,0,0,1,0,1,29,35,64,0,0,0,10,6,16,42,35,77,203
20192020,034,FAYETTE,165,Fayette County,030,Bryan Station Middle School,165030,034165030,210186000358,CKEC,901,All Students,402,342,81,102,183,0,0,0,3,2,5,95,121,216,0,0,0,25,25,50,138,152,290,744
20192020,034,FAYETTE,165,Fayette County,030,Bryan Station Middle School,165030,034165030,210186000358,CKEC,901,07,141,113,30,35,65,0,0,0,1,1,2,28,38,66,0,0,0,10,14,24,44,53,97,254
20192020,034,FAYETTE,165,Fayette County,032,Cassidy Elementary School,165032,034165032,210186000359,CKEC,901,04,60,59,8,4,12,0,0,0,2,4,6,5,4,9,0,0,0,5,2,7,39,46,85,119
20192020,034,FAYETTE,165,Fayette County,032,Cassidy Elementary School,165032,034165032,210186000359,CKEC,901,All Students,370,384,46,36,82,0,0,0,19,23,42,30,23,53,0,0,0,25,14,39,264,274,538,754
20192020,034,FAYETTE,165,Fayette County,032,Cassidy Elementary School,165032,034165032,210186000359,CKEC,901,KG,69,71,4,6,10,0,0,0,3,5,8,5,5,10,0,0,0,4,1,5,55,52,107,140
20192020,034,FAYETTE,165,Fayette County,032,Cassidy Elementary School,165032,034165032,210186000359,CKEC,901,01,62,73,9,10,19,0,0,0,2,6,8,4,1,5,0,0,0,3,1,4,55,44,99,135
20192020,034,FAYETTE,165,Fayette County,032,Cassidy Elementary School,165032,034165032,210186000359,CKEC,901,02,49,58,6,3,9,0,0,0,3,3,6,5,2,7,0,0,0,2,5,7,42,36,78,107
20192020,034,FAYETTE,165,Fayette County,032,Cassidy Elementary School,165032,034165032,210186000359,CKEC,901,03,75,55,10,8,18,0,0,0,4,2,6,4,8,12,0,0,0,3,1,4,34,56,90,130
20192020,034,FAYETTE,165,Fayette County,032,Cassidy Elementary School,165032,034165032,210186000359,CKEC,901,05,55,68,9,5,14,0,0,0,5,3,8,7,3,10,0,0,0,8,4,12,39,40,79,123
20192020,034,FAYETTE,165,Fayette County,034,Edythe Jones Hayes Middle School,165034,034165034,210186001957,CKEC,901,08,193,188,31,38,69,0,0,0,21,8,29,16,10,26,0,1,1,16,13,29,104,123,227,381
20192020,034,FAYETTE,165,Fayette County,034,Edythe Jones Hayes Middle School,165034,034165034,210186001957,CKEC,901,All Students,585,584,109,111,220,0,0,0,53,38,91,44,40,84,1,1,2,33,37,70,344,358,702,1169
20192020,034,FAYETTE,165,Fayette County,034,Edythe Jones Hayes Middle School,165034,034165034,210186001957,CKEC,901,06,201,178,39,35,74,0,0,0,16,11,27,12,20,32,1,0,1,7,15,22,103,120,223,379
20192020,034,FAYETTE,165,Fayette County,034,Edythe Jones Hayes Middle School,165034,034165034,210186001957,CKEC,901,07,191,218,39,38,77,0,0,0,16,19,35,16,10,26,0,0,0,10,9,19,137,115,252,409
20192020,034,FAYETTE,165,Fayette County,035,Deep Springs Elementary School,165035,034165035,210186000360,CKEC,901,01,42,51,16,12,28,0,0,0,0,0,0,9,10,19,0,0,0,3,3,6,23,17,40,93
20192020,034,FAYETTE,165,Fayette County,035,Deep Springs Elementary School,165035,034165035,210186000360,CKEC,901,02,36,36,12,7,19,1,0,1,0,0,0,6,10,16,0,0,0,2,2,4,15,17,32,72
20192020,034,FAYETTE,165,Fayette County,035,Deep Springs Elementary School,165035,034165035,210186000360,CKEC,901,03,39,43,11,17,28,0,0,0,0,0,0,11,8,19,0,0,0,3,4,7,18,10,28,82
20192020,034,FAYETTE,165,Fayette County,035,Deep Springs Elementary School,165035,034165035,210186000360,CKEC,901,05,35,53,21,12,33,0,0,0,0,0,0,14,6,20,0,0,0,1,2,3,17,15,32,88
20192020,034,FAYETTE,165,Fayette County,035,Deep Springs Elementary School,165035,034165035,210186000360,CKEC,901,04,48,53,15,13,28,0,0,0,0,0,0,14,13,27,0,0,0,6,2,8,18,20,38,101
20192020,034,FAYETTE,165,Fayette County,035,Deep Springs Elementary School,165035,034165035,210186000360,CKEC,901,All Students,250,271,86,82,168,1,0,1,0,0,0,62,56,118,0,0,0,19,16,35,103,96,199,521
20192020,034,FAYETTE,165,Fayette County,035,Deep Springs Elementary School,165035,034165035,210186000360,CKEC,901,PS,21,40,13,9,22,0,0,0,0,0,0,6,6,12,0,0,0,5,1,6,16,5,21,61
20192020,034,FAYETTE,165,Fayette County,035,Deep Springs Elementary School,165035,034165035,210186000360,CKEC,901,KG,50,35,11,21,32,0,0,0,0,0,0,8,9,17,0,0,0,4,3,7,12,17,29,85
20192020,034,FAYETTE,165,Fayette County,036,Dixie Elementary Magnet School,165036,034165036,210186000361,CKEC,901,04,44,53,16,20,36,0,0,0,2,1,3,7,8,15,0,0,0,4,3,7,24,12,36,97
20192020,034,FAYETTE,165,Fayette County,036,Dixie Elementary Magnet School,165036,034165036,210186000361,CKEC,901,All Students,274,310,85,92,177,2,0,2,4,5,9,49,42,91,0,0,0,27,28,55,143,107,250,584
20192020,034,FAYETTE,165,Fayette County,036,Dixie Elementary Magnet School,165036,034165036,210186000361,CKEC,901,PS,17,22,4,5,9,0,0,0,1,0,1,7,5,12,0,0,0,3,0,3,7,7,14,39
20192020,034,FAYETTE,165,Fayette County,036,Dixie Elementary Magnet School,165036,034165036,210186000361,CKEC,901,KG,52,51,12,16,28,0,0,0,0,2,2,11,7,18,0,0,0,2,3,5,26,24,50,103
20192020,034,FAYETTE,165,Fayette County,036,Dixie Elementary Magnet School,165036,034165036,210186000361,CKEC,901,01,44,65,13,16,29,1,0,1,1,0,1,15,4,19,0,0,0,4,5,9,31,19,50,109
20192020,034,FAYETTE,165,Fayette County,036,Dixie Elementary Magnet School,165036,034165036,210186000361,CKEC,901,02,39,40,13,10,23,1,0,1,1,1,2,4,7,11,0,0,0,5,4,9,16,17,33,79
20192020,034,FAYETTE,165,Fayette County,036,Dixie Elementary Magnet School,165036,034165036,210186000361,CKEC,901,03,44,56,17,14,31,0,0,0,0,1,1,9,8,17,0,0,0,6,4,10,24,17,41,100
20192020,034,FAYETTE,165,Fayette County,036,Dixie Elementary Magnet School,165036,034165036,210186000361,CKEC,901,05,51,45,14,16,30,0,0,0,0,0,0,3,8,11,0,0,0,6,9,15,22,18,40,96
20192020,034,FAYETTE,165,Fayette County,037,Garden Springs Elementary School,165037,034165037,210186000362,CKEC,901,04,35,28,2,1,3,0,0,0,0,3,3,7,4,11,0,0,0,1,4,5,18,23,41,63
20192020,034,FAYETTE,165,Fayette County,037,Garden Springs Elementary School,165037,034165037,210186000362,CKEC,901,All Students,198,197,17,10,27,0,0,0,4,5,9,37,23,60,0,0,0,11,17,28,128,143,271,395
20192020,034,FAYETTE,165,Fayette County,037,Garden Springs Elementary School,165037,034165037,210186000362,CKEC,901,KG,24,39,3,3,6,0,0,0,2,1,3,6,2,8,0,0,0,3,2,5,25,16,41,63
20192020,034,FAYETTE,165,Fayette County,037,Garden Springs Elementary School,165037,034165037,210186000362,CKEC,901,01,35,26,2,1,3,0,0,0,1,0,1,3,5,8,0,0,0,3,1,4,17,28,45,61
20192020,034,FAYETTE,165,Fayette County,037,Garden Springs Elementary School,165037,034165037,210186000362,CKEC,901,02,34,26,2,1,3,0,0,0,1,0,1,5,4,9,0,0,0,1,6,7,17,23,40,60
20192020,034,FAYETTE,165,Fayette County,037,Garden Springs Elementary School,165037,034165037,210186000362,CKEC,901,03,34,41,6,4,10,0,0,0,0,1,1,8,3,11,0,0,0,3,3,6,24,23,47,75
20192020,034,FAYETTE,165,Fayette County,037,Garden Springs Elementary School,165037,034165037,210186000362,CKEC,901,05,36,37,2,0,2,0,0,0,0,0,0,8,5,13,0,0,0,0,1,1,27,30,57,73
20192020,034,FAYETTE,165,Fayette County,038,Harrison Elementary School,165038,034165038,210186000363,CKEC,901,04,21,24,10,8,18,0,0,0,1,0,1,6,5,11,0,0,0,1,1,2,6,7,13,45
20192020,034,FAYETTE,165,Fayette County,038,Harrison Elementary School,165038,034165038,210186000363,CKEC,901,All Students,128,121,72,67,139,1,0,1,1,0,1,13,23,36,0,0,0,9,12,21,25,26,51,249
20192020,034,FAYETTE,165,Fayette County,038,Harrison Elementary School,165038,034165038,210186000363,CKEC,901,KG,23,15,11,8,19,0,0,0,0,0,0,2,4,6,0,0,0,0,4,4,2,7,9,38
20192020,034,FAYETTE,165,Fayette County,038,Harrison Elementary School,165038,034165038,210186000363,CKEC,901,01,16,27,17,9,26,0,0,0,0,0,0,2,4,6,0,0,0,3,1,4,5,2,7,43
20192020,034,FAYETTE,165,Fayette County,038,Harrison Elementary School,165038,034165038,210186000363,CKEC,901,02,20,20,11,14,25,0,0,0,0,0,0,0,2,2,0,0,0,2,2,4,7,2,9,40
20192020,034,FAYETTE,165,Fayette County,038,Harrison Elementary School,165038,034165038,210186000363,CKEC,901,03,21,16,10,9,19,1,0,1,0,0,0,3,3,6,0,0,0,1,2,3,1,7,8,37
20192020,034,FAYETTE,165,Fayette County,038,Harrison Elementary School,165038,034165038,210186000363,CKEC,901,05,27,19,13,19,32,0,0,0,0,0,0,0,5,5,0,0,0,2,2,4,4,1,5,46
20192020,034,FAYETTE,165,Fayette County,039,Henry Clay High School,165039,034165039,210186000364,CKEC,901,12,290,277,50,73,123,2,0,2,16,23,39,31,10,41,0,0,0,9,9,18,169,175,344,567
20192020,034,FAYETTE,165,Fayette County,039,Henry Clay High School,165039,034165039,210186000364,CKEC,901,All Students,1084,1082,209,232,441,3,1,4,68,70,138,131,99,230,0,1,1,46,41,87,625,640,1265,2166
20192020,034,FAYETTE,165,Fayette County,039,Henry Clay High School,165039,034165039,210186000364,CKEC,901,09,271,315,64,70,134,0,1,1,25,13,38,46,37,83,0,0,0,15,12,27,165,138,303,586
20192020,034,FAYETTE,165,Fayette County,039,Henry Clay High School,165039,034165039,210186000364,CKEC,901,10,254,257,49,42,91,1,0,1,11,14,25,34,20,54,0,0,0,14,10,24,148,168,316,511
20192020,034,FAYETTE,165,Fayette County,039,Henry Clay High School,165039,034165039,210186000364,CKEC,901,11,267,232,45,47,92,0,0,0,16,19,35,20,32,52,0,1,1,8,10,18,143,158,301,499
20192020,034,FAYETTE,165,Fayette County,039,Henry Clay High School,165039,034165039,210186000364,CKEC,901,14,2,1,1,0,1,0,0,0,0,1,1,0,0,0,0,0,0,0,0,0,0,1,1,3
20192020,034,FAYETTE,165,Fayette County,045,Athens-Chilesburg Elementary,165045,034165045,210186001987,CKEC,901,02,50,36,1,0,1,1,0,1,3,2,5,4,1,5,0,0,0,2,6,8,25,41,66,86
20192020,034,FAYETTE,165,Fayette County,045,Athens-Chilesburg Elementary,165045,034165045,210186001987,CKEC,901,All Students,306,310,11,13,24,4,0,4,34,25,59,15,9,24,0,0,0,10,17,27,236,242,478,616
20192020,034,FAYETTE,165,Fayette County,045,Athens-Chilesburg Elementary,165045,034165045,210186001987,CKEC,901,KG,50,50,0,1,1,1,0,1,4,7,11,3,3,6,0,0,0,1,2,3,41,37,78,100
20192020,034,FAYETTE,165,Fayette County,045,Athens-Chilesburg Elementary,165045,034165045,210186001987,CKEC,901,01,51,51,1,2,3,1,0,1,8,5,13,2,1,3,0,0,0,0,2,2,39,41,80,102
20192020,034,FAYETTE,165,Fayette County,045,Athens-Chilesburg Elementary,165045,034165045,210186001987,CKEC,901,03,55,64,1,4,5,0,0,0,10,6,16,2,0,2,0,0,0,4,1,5,47,44,91,119
20192020,034,FAYETTE,165,Fayette County,045,Athens-Chilesburg Elementary,165045,034165045,210186001987,CKEC,901,04,44,54,3,2,5,0,0,0,4,2,6,1,2,3,0,0,0,1,3,4,45,35,80,98
20192020,034,FAYETTE,165,Fayette County,045,Athens-Chilesburg Elementary,165045,034165045,210186001987,CKEC,901,05,56,55,5,4,9,1,0,1,5,3,8,3,2,5,0,0,0,2,3,5,39,44,83,111
20192020,034,FAYETTE,165,Fayette County,051,ABLE,165051,034165051,210186002236,CKEC,901,01,0,1,1,0,1,0,0,0,0,0,0,0,0,0,0,0,0,0,0,0,0,0,0,1
20192020,034,FAYETTE,165,Fayette County,051,ABLE,165051,034165051,210186002236,CKEC,901,03,0,3,1,0,1,0,0,0,0,0,0,0,0,0,0,0,0,0,0,0,2,0,2,3
20192020,034,FAYETTE,165,Fayette County,051,ABLE,165051,034165051,210186002236,CKEC,901,04,0,3,1,0,1,0,0,0,0,0,0,0,0,0,0,0,0,2,0,2,0,0,0,3
20192020,034,FAYETTE,165,Fayette County,051,ABLE,165051,034165051,210186002236,CKEC,901,05,0,1,0,0,0,0,0,0,0,0,0,0,0,0,0,0,0,0,0,0,1,0,1,1
20192020,034,FAYETTE,165,Fayette County,051,ABLE,165051,034165051,210186002236,CKEC,901,All Students,0,8,3,0,3,0,0,0,0,0,0,0,0,0,0,0,0,2,0,2,3,0,3,8
20192020,034,FAYETTE,165,Fayette County,052,Rosa Parks Elementary School,165052,034165052,210186001422,CKEC,901,03,70,76,3,3,6,0,0,0,21,16,37,6,3,9,0,0,0,2,2,4,44,46,90,146
20192020,034,FAYETTE,165,Fayette County,052,Rosa Parks Elementary School,165052,034165052,210186001422,CKEC,901,05,51,82,3,0,3,0,0,0,25,18,43,5,1,6,0,0,0,2,1,3,47,31,78,133
20192020,034,FAYETTE,165,Fayette County,052,Rosa Parks Elementary School,165052,034165052,210186001422,CKEC,901,04,46,64,1,0,1,0,1,1,18,11,29,4,4,8,0,0,0,4,1,5,37,29,66,110
20192020,034,FAYETTE,165,Fayette County,052,Rosa Parks Elementary School,165052,034165052,210186001422,CKEC,901,All Students,342,397,13,5,18,0,1,1,109,102,211,21,17,38,0,0,0,13,13,26,241,204,445,739
20192020,034,FAYETTE,165,Fayette County,052,Rosa Parks Elementary School,165052,034165052,210186001422,CKEC,901,KG,51,67,2,1,3,0,0,0,11,14,25,2,0,2,0,0,0,3,3,6,49,33,82,118
20192020,034,FAYETTE,165,Fayette County,052,Rosa Parks Elementary School,165052,034165052,210186001422,CKEC,901,01,62,45,3,1,4,0,0,0,15,20,35,0,5,5,0,0,0,1,4,5,26,32,58,107
20192020,034,FAYETTE,165,Fayette County,052,Rosa Parks Elementary School,165052,034165052,210186001422,CKEC,901,02,62,63,1,0,1,0,0,0,19,23,42,4,4,8,0,0,0,1,2,3,38,33,71,125
20192020,034,FAYETTE,165,Fayette County,054,The Stables,165054,034165054,210186002320,CKEC,901,11,6,3,0,2,2,0,0,0,0,0,0,0,0,0,0,0,0,0,1,1,3,3,6,9
20192020,034,FAYETTE,165,Fayette County,054,The Stables,165054,034165054,210186002320,CKEC,901,All Students,25,18,2,3,5,0,0,0,0,0,0,3,2,5,0,0,0,1,1,2,12,19,31,43
20192020,034,FAYETTE,165,Fayette County,054,The Stables,165054,034165054,210186002320,CKEC,901,08,7,4,0,0,0,0,0,0,0,0,0,1,1,2,0,0,0,0,0,0,3,6,9,11
20192020,034,FAYETTE,165,Fayette County,054,The Stables,165054,034165054,210186002320,CKEC,901,09,9,6,1,1,2,0,0,0,0,0,0,2,1,3,0,0,0,1,0,1,2,7,9,15
20192020,034,FAYETTE,165,Fayette County,054,The Stables,165054,034165054,210186002320,CKEC,901,10,3,4,1,0,1,0,0,0,0,0,0,0,0,0,0,0,0,0,0,0,3,3,6,7
20192020,034,FAYETTE,165,Fayette County,054,The Stables,165054,034165054,210186002320,CKEC,901,12,0,1,0,0,0,0,0,0,0,0,0,0,0,0,0,0,0,0,0,0,1,0,1,1
20192020,034,FAYETTE,165,Fayette County,055,Booker T Washington Elementary School,165055,034165055,210186002426,CKEC,901,04,23,24,13,9,22,0,0,0,0,1,1,9,10,19,0,0,0,1,1,2,1,2,3,47
20192020,034,FAYETTE,165,Fayette County,055,Booker T Washington Elementary School,165055,034165055,210186002426,CKEC,901,All Students,126,134,60,53,113,1,0,1,0,3,3,54,55,109,0,0,0,7,5,12,12,10,22,260
20192020,034,FAYETTE,165,Fayette County,055,Booker T Washington Elementary School,165055,034165055,210186002426,CKEC,901,PS,14,20,11,4,15,0,0,0,0,0,0,1,3,4,0,0,0,1,1,2,7,6,13,34
20192020,034,FAYETTE,165,Fayette County,055,Booker T Washington Elementary School,165055,034165055,210186002426,CKEC,901,KG,22,27,10,7,17,0,0,0,0,1,1,13,11,24,0,0,0,1,2,3,3,1,4,49
20192020,034,FAYETTE,165,Fayette County,055,Booker T Washington Elementary School,165055,034165055,210186002426,CKEC,901,01,19,24,12,9,21,0,0,0,0,0,0,8,8,16,0,0,0,2,1,3,2,1,3,43
20192020,034,FAYETTE,165,Fayette County,055,Booker T Washington Elementary School,165055,034165055,210186002426,CKEC,901,02,18,22,7,6,13,1,0,1,0,1,1,9,8,17,0,0,0,2,0,2,3,3,6,40
20192020,034,FAYETTE,165,Fayette County,055,Booker T Washington Elementary School,165055,034165055,210186002426,CKEC,901,03,22,17,8,12,20,0,0,0,0,0,0,6,8,14,0,0,0,1,1,2,2,1,3,39
20192020,034,FAYETTE,165,Fayette County,055,Booker T Washington Elementary School,165055,034165055,210186002426,CKEC,901,05,22,20,10,10,20,0,0,0,0,0,0,9,10,19,0,0,0,0,0,0,1,2,3,42
20192020,034,FAYETTE,165,Fayette County,056,William Wells Brown Elementary,165056,034165056,210186002199,CKEC,901,04,22,18,14,14,28,0,0,0,0,0,0,1,6,7,0,0,0,0,0,0,3,2,5,40
20192020,034,FAYETTE,165,Fayette County,056,William Wells Brown Elementary,165056,034165056,210186002199,CKEC,901,05,19,27,22,15,37,0,0,0,0,0,0,1,1,2,0,0,0,1,2,3,3,1,4,46
20192020,034,FAYETTE,165,Fayette County,056,William Wells Brown Elementary,165056,034165056,210186002199,CKEC,901,PS,17,20,15,11,26,0,0,0,0,0,0,2,4,6,0,0,0,0,0,0,3,2,5,37
20192020,034,FAYETTE,165,Fayette County,056,William Wells Brown Elementary,165056,034165056,210186002199,CKEC,901,KG,23,20,16,14,30,0,0,0,0,0,0,4,5,9,0,0,0,0,3,3,0,1,1,43
20192020,034,FAYETTE,165,Fayette County,056,William Wells Brown Elementary,165056,034165056,210186002199,CKEC,901,01,22,26,16,17,33,0,0,0,0,0,0,3,1,4,0,0,0,3,1,4,4,3,7,48
20192020,034,FAYETTE,165,Fayette County,056,William Wells Brown Elementary,165056,034165056,210186002199,CKEC,901,02,21,18,12,16,28,0,0,0,0,0,0,3,3,6,0,0,0,1,2,3,2,0,2,39
20192020,034,FAYETTE,165,Fayette County,056,William Wells Brown Elementary,165056,034165056,210186002199,CKEC,901,All Students,130,133,98,92,190,0,0,0,0,1,1,16,19,35,0,0,0,7,9,16,12,9,21,263
20192020,034,FAYETTE,165,Fayette County,056,William Wells Brown Elementary,165056,034165056,210186002199,CKEC,901,03,23,24,18,16,34,0,0,0,0,1,1,4,3,7,0,0,0,2,1,3,0,2,2,47
20192020,034,FAYETTE,165,Fayette County,057,Liberty Elementary,165057,034165057,210186002207,CKEC,901,03,65,64,15,9,24,0,0,0,2,3,5,9,8,17,0,0,0,5,5,10,33,40,73,129
20192020,034,FAYETTE,165,Fayette County,057,Liberty Elementary,165057,034165057,210186002207,CKEC,901,04,54,61,12,14,26,0,0,0,4,1,5,4,5,9,0,0,0,1,5,6,40,29,69,115
20192020,034,FAYETTE,165,Fayette County,057,Liberty Elementary,165057,034165057,210186002207,CKEC,901,All Students,349,379,78,70,148,0,0,0,14,17,31,39,42,81,1,2,3,32,32,64,215,186,401,728
20192020,034,FAYETTE,165,Fayette County,057,Liberty Elementary,165057,034165057,210186002207,CKEC,901,KG,58,69,10,12,22,0,0,0,3,3,6,6,7,13,0,0,0,9,7,16,41,29,70,127
20192020,034,FAYETTE,165,Fayette County,057,Liberty Elementary,165057,034165057,210186002207,CKEC,901,02,53,64,14,11,25,0,0,0,3,2,5,7,5,12,0,1,1,6,3,9,34,31,65,117
20192020,034,FAYETTE,165,Fayette County,057,Liberty Elementary,165057,034165057,210186002207,CKEC,901,05,61,66,17,13,30,0,0,0,1,3,4,6,10,16,0,1,1,5,5,10,37,29,66,127
20192020,034,FAYETTE,165,Fayette County,057,Liberty Elementary,165057,034165057,210186002207,CKEC,901,01,58,55,10,11,21,0,0,0,1,5,6,7,7,14,1,0,1,6,7,13,30,28,58,113
20192020,034,FAYETTE,165,Fayette County,058,Sandersville Elementary,165058,034165058,210186002189,CKEC,901,PS,16,20,6,5,11,0,0,0,0,1,1,2,1,3,0,0,0,0,1,1,12,8,20,36
20192020,034,FAYETTE,165,Fayette County,058,Sandersville Elementary,165058,034165058,210186002189,CKEC,901,All Students,328,286,76,92,168,1,1,2,9,5,14,35,42,77,0,1,1,18,19,37,147,168,315,614
20192020,034,FAYETTE,165,Fayette County,058,Sandersville Elementary,165058,034165058,210186002189,CKEC,901,KG,68,55,11,17,28,0,0,0,2,0,2,8,11,19,0,0,0,5,2,7,29,38,67,123
20192020,034,FAYETTE,165,Fayette County,058,Sandersville Elementary,165058,034165058,210186002189,CKEC,901,01,67,55,12,16,28,0,0,0,3,0,3,6,11,17,0,1,1,3,3,6,31,36,67,122
20192020,034,FAYETTE,165,Fayette County,058,Sandersville Elementary,165058,034165058,210186002189,CKEC,901,02,53,49,14,15,29,0,1,1,2,2,4,10,4,14,0,0,0,3,6,9,20,25,45,102
20192020,034,FAYETTE,165,Fayette County,058,Sandersville Elementary,165058,034165058,210186002189,CKEC,901,03,45,49,17,12,29,0,0,0,1,1,2,1,3,4,0,0,0,3,4,7,27,25,52,94
20192020,034,FAYETTE,165,Fayette County,058,Sandersville Elementary,165058,034165058,210186002189,CKEC,901,04,50,34,6,14,20,0,0,0,0,1,1,4,8,12,0,0,0,2,3,5,22,24,46,84
20192020,034,FAYETTE,165,Fayette County,058,Sandersville Elementary,165058,034165058,210186002189,CKEC,901,05,45,44,16,18,34,1,0,1,1,1,2,6,5,11,0,0,0,2,1,3,18,20,38,89
20192020,034,FAYETTE,165,Fayette County,059,Wellington Elementary,165059,034165059,210186002247,CKEC,901,04,63,56,1,4,5,0,0,0,12,8,20,5,5,10,0,0,0,4,6,10,34,40,74,119
20192020,034,FAYETTE,165,Fayette County,059,Wellington Elementary,165059,034165059,210186002247,CKEC,901,05,65,84,4,6,10,0,1,1,10,10,20,8,4,12,0,0,0,8,4,12,54,40,94,149
20192020,034,FAYETTE,165,Fayette County,059,Wellington Elementary,165059,034165059,210186002247,CKEC,901,All Students,342,365,14,27,41,1,1,2,62,58,120,26,28,54,0,0,0,27,27,54,235,201,436,707
20192020,034,FAYETTE,165,Fayette County,059,Wellington Elementary,165059,034165059,210186002247,CKEC,901,PS,12,26,2,1,3,0,0,0,8,0,8,3,1,4,0,0,0,0,3,3,13,7,20,38
20192020,034,FAYETTE,165,Fayette County,059,Wellington Elementary,165059,034165059,210186002247,CKEC,901,KG,49,49,3,4,7,0,0,0,9,13,22,2,2,4,0,0,0,4,3,7,31,27,58,98
20192020,034,FAYETTE,165,Fayette County,059,Wellington Elementary,165059,034165059,210186002247,CKEC,901,01,60,63,1,4,5,0,0,0,14,5,19,2,9,11,0,0,0,2,5,7,44,37,81,123
20192020,034,FAYETTE,165,Fayette County,059,Wellington Elementary,165059,034165059,210186002247,CKEC,901,02,49,51,2,5,7,0,0,0,8,14,22,2,4,6,0,0,0,6,6,12,33,20,53,100
20192020,034,FAYETTE,165,Fayette County,059,Wellington Elementary,165059,034165059,210186002247,CKEC,901,03,56,62,3,4,7,1,0,1,9,8,17,7,4,11,0,0,0,3,3,6,39,37,76,118
20192020,034,FAYETTE,165,Fayette County,060,Lafayette High School,165060,034165060,210186000367,CKEC,901,11,297,292,29,34,63,0,0,0,13,23,36,34,34,68,0,0,0,9,13,22,207,193,400,589
20192020,034,FAYETTE,165,Fayette County,060,Lafayette High School,165060,034165060,210186000367,CKEC,901,14,1,2,0,1,1,0,0,0,1,0,1,0,0,0,0,0,0,0,0,0,1,0,1,3
20192020,034,FAYETTE,165,Fayette County,060,Lafayette High School,165060,034165060,210186000367,CKEC,901,All Students,1224,1183,144,153,297,1,0,1,50,69,119,155,131,286,1,0,1,42,53,95,790,818,1608,2407
20192020,034,FAYETTE,165,Fayette County,060,Lafayette High School,165060,034165060,210186000367,CKEC,901,09,325,348,45,43,88,0,0,0,16,16,32,55,39,94,0,0,0,10,20,30,222,207,429,673
20192020,034,FAYETTE,165,Fayette County,060,Lafayette High School,165060,034165060,210186000367,CKEC,901,10,306,275,38,38,76,0,0,0,9,15,24,34,30,64,0,0,0,18,13,31,176,210,386,581
20192020,034,FAYETTE,165,Fayette County,060,Lafayette High School,165060,034165060,210186000367,CKEC,901,12,295,266,32,37,69,1,0,1,11,15,26,32,28,60,1,0,1,5,7,12,184,208,392,561
20192020,034,FAYETTE,165,Fayette County,062,Lansdowne Elementary School,165062,034165062,210186000368,CKEC,901,03,46,64,23,8,31,0,0,0,0,4,4,8,10,18,0,0,0,3,3,6,30,21,51,110
20192020,034,FAYETTE,165,Fayette County,062,Lansdowne Elementary School,165062,034165062,210186000368,CKEC,901,05,43,46,16,13,29,1,0,1,0,1,1,7,8,15,0,0,0,0,3,3,22,18,40,89
20192020,034,FAYETTE,165,Fayette County,062,Lansdowne Elementary School,165062,034165062,210186000368,CKEC,901,All Students,254,308,92,67,159,1,1,2,14,15,29,39,43,82,0,0,0,20,17,37,142,111,253,562
20192020,034,FAYETTE,165,Fayette County,062,Lansdowne Elementary School,165062,034165062,210186000368,CKEC,901,PS,16,22,11,3,14,0,0,0,1,2,3,2,3,5,0,0,0,1,0,1,7,8,15,38
20192020,034,FAYETTE,165,Fayette County,062,Lansdowne Elementary School,165062,034165062,210186000368,CKEC,901,KG,48,44,8,12,20,0,1,1,1,3,4,6,5,11,0,0,0,4,5,9,25,22,47,92
20192020,034,FAYETTE,165,Fayette County,062,Lansdowne Elementary School,165062,034165062,210186000368,CKEC,901,01,40,39,13,11,24,0,0,0,2,2,4,3,5,8,0,0,0,4,1,5,17,21,38,79
20192020,034,FAYETTE,165,Fayette County,062,Lansdowne Elementary School,165062,034165062,210186000368,CKEC,901,02,34,60,15,12,27,0,0,0,6,2,8,6,6,12,0,0,0,5,2,7,28,12,40,94
20192020,034,FAYETTE,165,Fayette County,062,Lansdowne Elementary School,165062,034165062,210186000368,CKEC,901,04,43,55,17,11,28,0,0,0,5,3,8,9,9,18,0,0,0,4,3,7,20,17,37,98
20192020,034,FAYETTE,165,Fayette County,065,Leestown Middle School,165065,034165065,210186000369,CKEC,901,06,166,191,42,52,94,1,1,2,2,3,5,68,54,122,0,0,0,8,4,12,70,52,122,357
20192020,034,FAYETTE,165,Fayette County,065,Leestown Middle School,165065,034165065,210186000369,CKEC,901,08,170,151,32,40,72,0,0,0,2,6,8,58,68,126,0,0,0,4,7,11,55,49,104,321
20192020,034,FAYETTE,165,Fayette County,065,Leestown Middle School,165065,034165065,210186000369,CKEC,901,All Students,515,511,109,137,246,1,1,2,6,10,16,194,198,392,0,0,0,20,17,37,181,152,333,1026
20192020,034,FAYETTE,165,Fayette County,065,Leestown Middle School,165065,034165065,210186000369,CKEC,901,07,179,169,35,45,80,0,0,0,2,1,3,68,76,144,0,0,0,8,6,14,56,51,107,348
20192020,034,FAYETTE,165,Fayette County,066,Family Care Center,165066,034165066,210186002325,CKEC,901,09,4,0,0,1,1,0,0,0,0,0,0,0,3,3,0,0,0,0,0,0,0,0,0,4
20192020,034,FAYETTE,165,Fayette County,066,Family Care Center,165066,034165066,210186002325,CKEC,901,11,3,0,0,1,1,0,0,0,0,0,0,0,0,0,0,0,0,0,0,0,0,2,2,3
20192020,034,FAYETTE,165,Fayette County,066,Family Care Center,165066,034165066,210186002325,CKEC,901,All Students,14,0,0,4,4,0,0,0,0,0,0,0,5,5,0,0,0,0,1,1,0,4,4,14
20192020,034,FAYETTE,165,Fayette County,066,Family Care Center,165066,034165066,210186002325,CKEC,901,10,7,0,0,2,2,0,0,0,0,0,0,0,2,2,0,0,0,0,1,1,0,2,2,7
20192020,034,FAYETTE,165,Fayette County,067,Lexington Trad Magnet School,165067,034165067,210186000370,CKEC,901,06,76,60,28,41,69,0,0,0,2,0,2,10,13,23,0,0,0,1,3,4,19,19,38,136
20192020,034,FAYETTE,165,Fayette County,067,Lexington Trad Magnet School,165067,034165067,210186000370,CKEC,901,08,76,69,29,39,68,0,0,0,0,0,0,10,17,27,0,0,0,8,4,12,22,16,38,145
20192020,034,FAYETTE,165,Fayette County,067,Lexington Trad Magnet School,165067,034165067,210186000370,CKEC,901,All Students,215,202,95,121,216,0,0,0,2,0,2,31,40,71,0,0,0,11,7,18,63,47,110,417
20192020,034,FAYETTE,165,Fayette County,067,Lexington Trad Magnet School,165067,034165067,210186000370,CKEC,901,07,63,73,38,41,79,0,0,0,0,0,0,11,10,21,0,0,0,2,0,2,22,12,34,136
20192020,034,FAYETTE,165,Fayette County,068,Locust Trace AgriScience Center,165068,034165068,210186002362,CKEC,901,11,0,0,0,0,0,0,0,0,0,0,0,0,0,0,0,0,0,0,0,0,0,0,0,0
20192020,034,FAYETTE,165,Fayette County,068,Locust Trace AgriScience Center,165068,034165068,210186002362,CKEC,901,14,0,0,0,0,0,0,0,0,0,0,0,0,0,0,0,0,0,0,0,0,0,0,0,0
20192020,034,FAYETTE,165,Fayette County,068,Locust Trace AgriScience Center,165068,034165068,210186002362,CKEC,901,All Students,0,0,0,0,0,0,0,0,0,0,0,0,0,0,0,0,0,0,0,0,0,0,0,0
20192020,034,FAYETTE,165,Fayette County,068,Locust Trace AgriScience Center,165068,034165068,210186002362,CKEC,901,09,0,0,0,0,0,0,0,0,0,0,0,0,0,0,0,0,0,0,0,0,0,0,0,0
20192020,034,FAYETTE,165,Fayette County,068,Locust Trace AgriScience Center,165068,034165068,210186002362,CKEC,901,10,0,0,0,0,0,0,0,0,0,0,0,0,0,0,0,0,0,0,0,0,0,0,0,0
20192020,034,FAYETTE,165,Fayette County,068,Locust Trace AgriScience Center,165068,034165068,210186002362,CKEC,901,12,0,0,0,0,0,0,0,0,0,0,0,0,0,0,0,0,0,0,0,0,0,0,0,0
20192020,034,FAYETTE,165,Fayette County,072,Madeline M Breckinridge Elem School,165072,034165072,210186000372,CKEC,901,PS,37,39,13,14,27,0,0,0,4,4,8,13,6,19,0,0,0,0,3,3,9,10,19,76
20192020,034,FAYETTE,165,Fayette County,072,Madeline M Breckinridge Elem School,165072,034165072,210186000372,CKEC,901,All Students,259,266,108,107,215,0,0,0,10,4,14,69,73,142,0,0,0,22,32,54,57,43,100,525
20192020,034,FAYETTE,165,Fayette County,072,Madeline M Breckinridge Elem School,165072,034165072,210186000372,CKEC,901,KG,50,42,17,15,32,0,0,0,1,1,2,15,19,34,0,0,0,3,5,8,6,10,16,92
20192020,034,FAYETTE,165,Fayette County,072,Madeline M Breckinridge Elem School,165072,034165072,210186000372,CKEC,901,01,45,62,26,17,43,0,0,0,3,1,4,11,9,20,0,0,0,5,7,12,17,11,28,107
20192020,034,FAYETTE,165,Fayette County,072,Madeline M Breckinridge Elem School,165072,034165072,210186000372,CKEC,901,02,42,38,12,21,33,0,0,0,0,0,0,13,12,25,0,0,0,2,5,7,11,4,15,80
20192020,034,FAYETTE,165,Fayette County,072,Madeline M Breckinridge Elem School,165072,034165072,210186000372,CKEC,901,03,35,38,17,14,31,0,0,0,3,1,4,7,7,14,0,0,0,3,4,7,8,9,17,73
20192020,034,FAYETTE,165,Fayette County,072,Madeline M Breckinridge Elem School,165072,034165072,210186000372,CKEC,901,04,40,38,17,18,35,0,0,0,0,1,1,9,10,19,0,0,0,6,6,12,6,5,11,78
20192020,034,FAYETTE,165,Fayette County,072,Madeline M Breckinridge Elem School,165072,034165072,210186000372,CKEC,901,05,47,48,19,22,41,0,0,0,3,0,3,14,16,30,0,0,0,3,5,8,9,4,13,95
20192020,034,FAYETTE,165,Fayette County,074,Maxwell Spanish Immersion Elem School,165074,034165074,210186000373,CKEC,901,04,35,49,13,4,17,0,0,0,0,0,0,11,8,19,0,0,0,7,4,11,18,19,37,84
20192020,034,FAYETTE,165,Fayette County,074,Maxwell Spanish Immersion Elem School,165074,034165074,210186000373,CKEC,901,05,35,29,5,8,13,0,1,1,2,0,2,8,6,14,0,0,0,5,6,11,9,14,23,64
20192020,034,FAYETTE,165,Fayette County,074,Maxwell Spanish Immersion Elem School,165074,034165074,210186000373,CKEC,901,All Students,280,274,53,39,92,0,1,1,6,4,10,55,53,108,0,0,0,30,35,65,130,148,278,554
20192020,034,FAYETTE,165,Fayette County,074,Maxwell Spanish Immersion Elem School,165074,034165074,210186000373,CKEC,901,KG,53,53,8,3,11,0,0,0,1,0,1,7,8,15,0,0,0,5,6,11,32,36,68,106
20192020,034,FAYETTE,165,Fayette County,074,Maxwell Spanish Immersion Elem School,165074,034165074,210186000373,CKEC,901,01,58,45,12,7,19,0,0,0,0,2,2,7,10,17,0,0,0,4,7,11,22,32,54,103
20192020,034,FAYETTE,165,Fayette County,074,Maxwell Spanish Immersion Elem School,165074,034165074,210186000373,CKEC,901,02,52,45,5,7,12,0,0,0,3,2,5,10,12,22,0,0,0,6,8,14,21,23,44,97
20192020,034,FAYETTE,165,Fayette County,074,Maxwell Spanish Immersion Elem School,165074,034165074,210186000373,CKEC,901,03,47,53,10,10,20,0,0,0,0,0,0,12,9,21,0,0,0,3,4,7,28,24,52,100
20192020,034,FAYETTE,165,Fayette County,076,Morton Middle School,165076,034165076,210186000374,CKEC,901,06,140,136,22,21,43,0,0,0,9,8,17,11,23,34,1,0,1,7,8,15,86,80,166,276
20192020,034,FAYETTE,165,Fayette County,076,Morton Middle School,165076,034165076,210186000374,CKEC,901,08,116,134,11,18,29,0,0,0,9,7,16,13,19,32,0,1,1,7,4,11,94,67,161,250
20192020,034,FAYETTE,165,Fayette County,076,Morton Middle School,165076,034165076,210186000374,CKEC,901,All Students,384,412,61,58,119,0,1,1,28,18,46,47,57,104,1,2,3,18,20,38,257,228,485,796
20192020,034,FAYETTE,165,Fayette County,076,Morton Middle School,165076,034165076,210186000374,CKEC,901,05,2,1,0,0,0,0,0,0,0,0,0,1,0,1,0,0,0,0,0,0,0,2,2,3
20192020,034,FAYETTE,165,Fayette County,076,Morton Middle School,165076,034165076,210186000374,CKEC,901,07,126,141,28,19,47,0,1,1,10,3,13,22,15,37,0,1,1,4,8,12,77,79,156,267
20192020,034,FAYETTE,165,Fayette County,077,Northern Elementary School,165077,034165077,210186000375,CKEC,901,05,39,48,21,15,36,0,1,1,0,0,0,13,13,26,0,0,0,0,4,4,14,6,20,87
20192020,034,FAYETTE,165,Fayette County,077,Northern Elementary School,165077,034165077,210186000375,CKEC,901,03,38,37,13,21,34,0,0,0,0,0,0,12,13,25,0,0,0,3,0,3,9,4,13,75
20192020,034,FAYETTE,165,Fayette County,077,Northern Elementary School,165077,034165077,210186000375,CKEC,901,04,41,49,19,20,39,1,0,1,0,0,0,16,8,24,0,0,0,1,1,2,12,12,24,90
20192020,034,FAYETTE,165,Fayette County,077,Northern Elementary School,165077,034165077,210186000375,CKEC,901,All Students,236,241,88,102,190,2,1,3,0,0,0,76,70,146,0,0,0,8,14,22,67,49,116,477
20192020,034,FAYETTE,165,Fayette County,077,Northern Elementary School,165077,034165077,210186000375,CKEC,901,PS,18,20,10,11,21,0,0,0,0,0,0,7,3,10,0,0,0,0,2,2,3,2,5,38
20192020,034,FAYETTE,165,Fayette County,077,Northern Elementary School,165077,034165077,210186000375,CKEC,901,KG,40,36,14,12,26,0,0,0,0,0,0,10,14,24,0,0,0,2,2,4,10,12,22,76
20192020,034,FAYETTE,165,Fayette County,077,Northern Elementary School,165077,034165077,210186000375,CKEC,901,01,44,42,12,19,31,1,0,1,0,0,0,18,10,28,0,0,0,1,5,6,10,10,20,86
20192020,034,FAYETTE,165,Fayette County,077,Northern Elementary School,165077,034165077,210186000375,CKEC,901,02,34,29,9,15,24,0,0,0,0,0,0,7,12,19,0,0,0,1,2,3,12,5,17,63
20192020,034,FAYETTE,165,Fayette County,079,Fayette County Preschool Center,165079,034165079,210186002337,CKEC,901,PS,32,50,4,4,8,0,0,0,7,1,8,5,5,10,0,0,0,8,2,10,26,20,46,82
20192020,034,FAYETTE,165,Fayette County,079,Fayette County Preschool Center,165079,034165079,210186002337,CKEC,901,All Students,0,0,0,0,0,0,0,0,0,0,0,0,0,0,0,0,0,0,0,0,0,0,0,0
20192020,034,FAYETTE,165,Fayette County,080,Picadome Elementary School,165080,034165080,210186000376,CKEC,901,03,37,40,10,9,19,0,0,0,0,1,1,4,2,6,0,0,0,2,3,5,24,22,46,77
20192020,034,FAYETTE,165,Fayette County,080,Picadome Elementary School,165080,034165080,210186000376,CKEC,901,05,30,43,14,6,20,0,0,0,2,1,3,3,1,4,0,0,0,6,0,6,18,22,40,73
20192020,034,FAYETTE,165,Fayette County,080,Picadome Elementary School,165080,034165080,210186000376,CKEC,901,All Students,214,224,59,60,119,0,0,0,5,4,9,16,20,36,1,0,1,14,15,29,129,115,244,438
20192020,034,FAYETTE,165,Fayette County,080,Picadome Elementary School,165080,034165080,210186000376,CKEC,901,PS,18,12,4,4,8,0,1,1,0,0,0,1,4,5,0,0,0,0,2,2,7,7,14,30
20192020,034,FAYETTE,165,Fayette County,080,Picadome Elementary School,165080,034165080,210186000376,CKEC,901,KG,41,35,12,14,26,0,0,0,0,1,1,2,5,7,1,0,1,3,4,7,17,17,34,76
20192020,034,FAYETTE,165,Fayette County,080,Picadome Elementary School,165080,034165080,210186000376,CKEC,901,01,39,36,12,13,25,0,0,0,1,0,1,1,2,3,0,0,0,0,1,1,22,23,45,75
20192020,034,FAYETTE,165,Fayette County,080,Picadome Elementary School,165080,034165080,210186000376,CKEC,901,02,33,29,7,10,17,0,0,0,1,0,1,3,6,9,0,0,0,3,2,5,15,15,30,62
20192020,034,FAYETTE,165,Fayette County,080,Picadome Elementary School,165080,034165080,210186000376,CKEC,901,04,34,41,4,8,12,0,0,0,1,1,2,3,4,7,0,0,0,0,5,5,33,16,49,75
20192020,034,FAYETTE,165,Fayette County,081,Southern Elementary School,165081,034165081,210186000377,CKEC,901,01,48,50,15,14,29,1,0,1,3,1,4,8,10,18,0,0,0,4,7,11,19,16,35,98
20192020,034,FAYETTE,165,Fayette County,081,Southern Elementary School,165081,034165081,210186000377,CKEC,901,03,45,36,12,10,22,0,0,0,0,3,3,4,6,10,0,0,0,2,1,3,18,25,43,81
20192020,034,FAYETTE,165,Fayette County,081,Southern Elementary School,165081,034165081,210186000377,CKEC,901,05,45,49,13,12,25,1,0,1,2,0,2,7,5,12,0,0,0,3,5,8,23,23,46,94
20192020,034,FAYETTE,165,Fayette County,081,Southern Elementary School,165081,034165081,210186000377,CKEC,901,04,33,43,20,14,34,0,0,0,4,0,4,5,5,10,0,0,0,3,4,7,11,10,21,76
20192020,034,FAYETTE,165,Fayette County,081,Southern Elementary School,165081,034165081,210186000377,CKEC,901,All Students,249,263,83,67,150,3,0,3,11,6,17,33,34,67,0,0,0,24,28,52,109,114,223,512
20192020,034,FAYETTE,165,Fayette County,081,Southern Elementary School,165081,034165081,210186000377,CKEC,901,PS,17,19,5,4,9,0,0,0,1,0,1,4,2,6,0,0,0,2,3,5,7,8,15,36
20192020,034,FAYETTE,165,Fayette County,081,Southern Elementary School,165081,034165081,210186000377,CKEC,901,KG,39,47,12,6,18,0,0,0,1,2,3,7,7,14,0,0,0,8,3,11,19,21,40,86
20192020,034,FAYETTE,165,Fayette County,081,Southern Elementary School,165081,034165081,210186000377,CKEC,901,02,39,38,11,11,22,1,0,1,1,0,1,2,1,3,0,0,0,4,8,12,19,19,38,77
20192020,034,FAYETTE,165,Fayette County,082,Squires Elementary School,165082,034165082,210186001584,CKEC,901,KG,41,37,7,12,19,0,0,0,0,0,0,9,10,19,0,0,0,2,3,5,19,16,35,78
20192020,034,FAYETTE,165,Fayette County,082,Squires Elementary School,165082,034165082,210186001584,CKEC,901,All Students,233,239,56,52,108,0,0,0,2,3,5,34,50,84,0,0,0,11,10,21,136,118,254,472
20192020,034,FAYETTE,165,Fayette County,082,Squires Elementary School,165082,034165082,210186001584,CKEC,901,PS,21,17,4,5,9,0,0,0,1,0,1,4,2,6,0,0,0,2,1,3,6,13,19,38
20192020,034,FAYETTE,165,Fayette County,082,Squires Elementary School,165082,034165082,210186001584,CKEC,901,01,33,29,5,7,12,0,0,0,0,0,0,5,8,13,0,0,0,2,2,4,17,16,33,62
20192020,034,FAYETTE,165,Fayette County,082,Squires Elementary School,165082,034165082,210186001584,CKEC,901,02,35,38,8,7,15,0,0,0,0,1,1,4,4,8,0,0,0,2,1,3,24,22,46,73
20192020,034,FAYETTE,165,Fayette County,082,Squires Elementary School,165082,034165082,210186001584,CKEC,901,03,51,34,8,12,20,0,0,0,1,1,2,5,10,15,0,0,0,2,1,3,18,27,45,85
20192020,034,FAYETTE,165,Fayette County,082,Squires Elementary School,165082,034165082,210186001584,CKEC,901,04,36,37,10,6,16,0,0,0,0,1,1,4,6,10,0,0,0,1,3,4,22,20,42,73
20192020,034,FAYETTE,165,Fayette County,082,Squires Elementary School,165082,034165082,210186001584,CKEC,901,05,37,64,18,8,26,0,0,0,1,0,1,7,12,19,0,0,0,2,0,2,36,17,53,101
20192020,034,FAYETTE,165,Fayette County,085,Stonewall Elementary School,165085,034165085,210186000378,CKEC,901,04,49,65,6,1,7,0,0,0,1,1,2,3,2,5,0,0,0,3,6,9,52,39,91,114
20192020,034,FAYETTE,165,Fayette County,085,Stonewall Elementary School,165085,034165085,210186000378,CKEC,901,05,55,60,9,4,13,0,0,0,2,3,5,5,3,8,0,0,0,3,5,8,41,40,81,115
20192020,034,FAYETTE,165,Fayette County,085,Stonewall Elementary School,165085,034165085,210186000378,CKEC,901,All Students,334,347,30,15,45,0,0,0,17,12,29,19,27,46,0,0,0,11,26,37,270,254,524,681
20192020,034,FAYETTE,165,Fayette County,085,Stonewall Elementary School,165085,034165085,210186000378,CKEC,901,PS,10,26,2,2,4,0,0,0,1,0,1,4,1,5,0,0,0,1,0,1,18,7,25,36
20192020,034,FAYETTE,165,Fayette County,085,Stonewall Elementary School,165085,034165085,210186000378,CKEC,901,KG,50,52,5,2,7,0,0,0,1,1,2,3,6,9,0,0,0,0,4,4,43,37,80,102
20192020,034,FAYETTE,165,Fayette County,085,Stonewall Elementary School,165085,034165085,210186000378,CKEC,901,01,53,57,2,3,5,0,0,0,6,3,9,5,4,9,0,0,0,2,5,7,42,38,80,110
20192020,034,FAYETTE,165,Fayette County,085,Stonewall Elementary School,165085,034165085,210186000378,CKEC,901,02,54,50,1,2,3,0,0,0,1,2,3,1,7,8,0,0,0,0,1,1,47,42,89,104
20192020,034,FAYETTE,165,Fayette County,085,Stonewall Elementary School,165085,034165085,210186000378,CKEC,901,03,73,63,7,3,10,0,0,0,6,2,8,2,5,7,0,0,0,3,5,8,45,58,103,136
20192020,034,FAYETTE,165,Fayette County,090,Russell Cave Elementary School,165090,034165090,210186000380,CKEC,901,03,24,13,1,3,4,0,0,0,0,0,0,11,17,28,0,0,0,0,0,0,1,4,5,37
20192020,034,FAYETTE,165,Fayette County,090,Russell Cave Elementary School,165090,034165090,210186000380,CKEC,901,05,19,21,4,2,6,0,0,0,0,0,0,16,13,29,0,0,0,0,0,0,1,4,5,40
20192020,034,FAYETTE,165,Fayette County,090,Russell Cave Elementary School,165090,034165090,210186000380,CKEC,901,All Students,115,130,16,15,31,0,0,0,0,0,0,100,81,181,0,0,0,1,0,1,13,19,32,245
20192020,034,FAYETTE,165,Fayette County,090,Russell Cave Elementary School,165090,034165090,210186000380,CKEC,901,PS,15,15,7,6,13,0,0,0,0,0,0,7,9,16,0,0,0,0,0,0,1,0,1,30
20192020,034,FAYETTE,165,Fayette County,090,Russell Cave Elementary School,165090,034165090,210186000380,CKEC,901,KG,12,28,1,1,2,0,0,0,0,0,0,24,7,31,0,0,0,0,0,0,3,4,7,40
20192020,034,FAYETTE,165,Fayette County,090,Russell Cave Elementary School,165090,034165090,210186000380,CKEC,901,01,16,23,5,4,9,0,0,0,0,0,0,16,11,27,0,0,0,0,0,0,2,1,3,39
20192020,034,FAYETTE,165,Fayette County,090,Russell Cave Elementary School,165090,034165090,210186000380,CKEC,901,02,17,17,3,2,5,0,0,0,0,0,0,12,12,24,0,0,0,0,0,0,2,3,5,34
20192020,034,FAYETTE,165,Fayette County,090,Russell Cave Elementary School,165090,034165090,210186000380,CKEC,901,04,27,28,2,3,5,0,0,0,0,0,0,21,21,42,0,0,0,1,0,1,4,3,7,55
20192020,034,FAYETTE,165,Fayette County,095,Tates Creek Elementary School,165095,034165095,210186000381,CKEC,901,03,55,60,24,19,43,0,0,0,3,0,3,8,11,19,0,1,1,5,11,16,20,13,33,115
20192020,034,FAYETTE,165,Fayette County,095,Tates Creek Elementary School,165095,034165095,210186000381,CKEC,901,05,49,54,17,25,42,0,0,0,2,1,3,5,6,11,0,0,0,9,4,13,21,13,34,103
20192020,034,FAYETTE,165,Fayette County,095,Tates Creek Elementary School,165095,034165095,210186000381,CKEC,901,All Students,296,323,125,125,250,0,1,1,14,4,18,35,46,81,0,1,1,37,33,70,112,86,198,619
20192020,034,FAYETTE,165,Fayette County,095,Tates Creek Elementary School,165095,034165095,210186000381,CKEC,901,PS,13,21,8,4,12,0,0,0,0,1,1,2,1,3,0,0,0,4,1,5,7,6,13,34
20192020,034,FAYETTE,165,Fayette County,095,Tates Creek Elementary School,165095,034165095,210186000381,CKEC,901,KG,50,72,26,23,49,0,0,0,3,1,4,9,7,16,0,0,0,9,6,15,25,13,38,122
20192020,034,FAYETTE,165,Fayette County,095,Tates Creek Elementary School,165095,034165095,210186000381,CKEC,901,01,54,65,31,22,53,0,1,1,1,1,2,6,7,13,0,0,0,9,4,13,18,19,37,119
20192020,034,FAYETTE,165,Fayette County,095,Tates Creek Elementary School,165095,034165095,210186000381,CKEC,901,02,40,33,10,20,30,0,0,0,3,1,4,3,6,9,0,0,0,2,3,5,15,10,25,73
20192020,034,FAYETTE,165,Fayette County,095,Tates Creek Elementary School,165095,034165095,210186000381,CKEC,901,04,48,39,17,16,33,0,0,0,2,0,2,4,9,13,0,0,0,3,5,8,13,18,31,87
20192020,034,FAYETTE,165,Fayette County,098,Coventry Oak Elementary,165098,034165098,210186002433,CKEC,901,03,49,45,13,21,34,0,0,0,0,0,0,23,14,37,0,0,0,1,2,3,8,12,20,94
20192020,034,FAYETTE,165,Fayette County,098,Coventry Oak Elementary,165098,034165098,210186002433,CKEC,901,05,52,52,12,20,32,0,0,0,1,0,1,22,17,39,1,0,1,1,5,6,15,10,25,104
20192020,034,FAYETTE,165,Fayette County,098,Coventry Oak Elementary,165098,034165098,210186002433,CKEC,901,All Students,277,285,82,93,175,1,0,1,4,2,6,107,99,206,3,0,3,13,19,32,75,64,139,562
20192020,034,FAYETTE,165,Fayette County,098,Coventry Oak Elementary,165098,034165098,210186002433,CKEC,901,PS,18,19,10,3,13,0,0,0,0,1,1,4,5,9,0,0,0,1,3,4,4,6,10,37
20192020,034,FAYETTE,165,Fayette County,098,Coventry Oak Elementary,165098,034165098,210186002433,CKEC,901,KG,36,53,14,12,26,0,0,0,1,0,1,18,17,35,2,0,2,1,1,2,17,6,23,89
20192020,034,FAYETTE,165,Fayette County,098,Coventry Oak Elementary,165098,034165098,210186002433,CKEC,901,01,47,47,11,14,25,0,0,0,1,1,2,18,16,34,0,0,0,3,2,5,14,14,28,94
20192020,034,FAYETTE,165,Fayette County,098,Coventry Oak Elementary,165098,034165098,210186002433,CKEC,901,02,43,35,11,10,21,1,0,1,1,1,2,11,16,27,0,0,0,1,6,7,10,10,20,78
20192020,034,FAYETTE,165,Fayette County,098,Coventry Oak Elementary,165098,034165098,210186002433,CKEC,901,04,50,53,21,16,37,0,0,0,0,0,0,15,19,34,0,0,0,6,3,9,11,12,23,103
20192020,034,FAYETTE,165,Fayette County,099,Garrett Morgan Elementary,165099,034165099,210186002435,CKEC,901,03,45,67,10,7,17,0,0,0,3,4,7,3,1,4,0,0,0,2,3,5,49,30,79,112
20192020,034,FAYETTE,165,Fayette County,099,Garrett Morgan Elementary,165099,034165099,210186002435,CKEC,901,05,56,55,10,9,19,0,0,0,1,6,7,4,5,9,0,0,0,3,1,4,37,35,72,111
20192020,034,FAYETTE,165,Fayette County,099,Garrett Morgan Elementary,165099,034165099,210186002435,CKEC,901,All Students,366,356,64,60,124,0,0,0,33,33,66,20,21,41,1,0,1,20,26,46,218,226,444,722
20192020,034,FAYETTE,165,Fayette County,099,Garrett Morgan Elementary,165099,034165099,210186002435,CKEC,901,KG,65,59,12,6,18,0,0,0,8,4,12,3,3,6,0,0,0,2,6,8,34,46,80,124
20192020,034,FAYETTE,165,Fayette County,099,Garrett Morgan Elementary,165099,034165099,210186002435,CKEC,901,01,77,51,7,12,19,0,0,0,5,6,11,3,5,8,0,0,0,4,6,10,32,48,80,128
20192020,034,FAYETTE,165,Fayette County,099,Garrett Morgan Elementary,165099,034165099,210186002435,CKEC,901,02,74,66,11,12,23,0,0,0,10,9,19,3,4,7,0,0,0,5,6,11,37,43,80,140
20192020,034,FAYETTE,165,Fayette County,099,Garrett Morgan Elementary,165099,034165099,210186002435,CKEC,901,04,49,58,14,14,28,0,0,0,6,4,10,4,3,7,1,0,1,4,4,8,29,24,53,107
20192020,034,FAYETTE,165,Fayette County,100,Tates Creek Middle School,165100,034165100,210186000382,CKEC,901,07,118,152,38,37,75,0,0,0,6,3,9,19,16,35,0,1,1,7,7,14,82,54,136,270
20192020,034,FAYETTE,165,Fayette County,100,Tates Creek Middle School,165100,034165100,210186000382,CKEC,901,All Students,332,415,107,105,212,0,3,3,12,10,22,53,37,90,0,2,2,22,28,50,221,147,368,747
20192020,034,FAYETTE,165,Fayette County,100,Tates Creek Middle School,165100,034165100,210186000382,CKEC,901,06,109,122,38,37,75,0,2,2,1,3,4,14,9,23,0,0,0,6,12,18,63,46,109,231
20192020,034,FAYETTE,165,Fayette County,100,Tates Creek Middle School,165100,034165100,210186000382,CKEC,901,08,105,141,31,31,62,0,1,1,5,4,9,20,12,32,0,1,1,9,9,18,76,47,123,246
20192020,034,FAYETTE,165,Fayette County,102,Fayette Regional Juvenile Det Ctr,165102,034165102,210186002025,CKEC,901,12,0,1,0,0,0,0,0,0,0,0,0,0,0,0,0,0,0,0,0,0,1,0,1,1
20192020,034,FAYETTE,165,Fayette County,102,Fayette Regional Juvenile Det Ctr,165102,034165102,210186002025,CKEC,901,All Students,2,23,13,1,14,0,0,0,0,0,0,1,0,1,0,0,0,1,0,1,8,1,9,25
20192020,034,FAYETTE,165,Fayette County,102,Fayette Regional Juvenile Det Ctr,165102,034165102,210186002025,CKEC,901,08,0,1,1,0,1,0,0,0,0,0,0,0,0,0,0,0,0,0,0,0,0,0,0,1
20192020,034,FAYETTE,165,Fayette County,102,Fayette Regional Juvenile Det Ctr,165102,034165102,210186002025,CKEC,901,09,2,7,4,1,5,0,0,0,0,0,0,0,0,0,0,0,0,1,0,1,2,1,3,9
20192020,034,FAYETTE,165,Fayette County,102,Fayette Regional Juvenile Det Ctr,165102,034165102,210186002025,CKEC,901,10,0,7,4,0,4,0,0,0,0,0,0,0,0,0,0,0,0,0,0,0,3,0,3,7
20192020,034,FAYETTE,165,Fayette County,102,Fayette Regional Juvenile Det Ctr,165102,034165102,210186002025,CKEC,901,11,0,7,4,0,4,0,0,0,0,0,0,1,0,1,0,0,0,0,0,0,2,0,2,7
20192020,034,FAYETTE,165,Fayette County,105,Tates Creek High School,165105,034165105,210186000383,CKEC,901,12,252,200,60,74,134,0,0,0,7,7,14,14,24,38,0,0,0,5,18,23,114,129,243,452
20192020,034,FAYETTE,165,Fayette County,105,Tates Creek High School,165105,034165105,210186000383,CKEC,901,11,195,175,55,52,107,0,0,0,3,7,10,24,16,40,0,0,0,7,15,22,86,105,191,370
20192020,034,FAYETTE,165,Fayette County,105,Tates Creek High School,165105,034165105,210186000383,CKEC,901,14,0,3,0,0,0,0,0,0,0,0,0,0,0,0,0,0,0,0,0,0,3,0,3,3
20192020,034,FAYETTE,165,Fayette County,105,Tates Creek High School,165105,034165105,210186000383,CKEC,901,All Students,923,853,231,291,522,0,1,1,20,28,48,108,89,197,2,0,2,45,71,116,447,443,890,1776
20192020,034,FAYETTE,165,Fayette County,105,Tates Creek High School,165105,034165105,210186000383,CKEC,901,08,1,4,0,0,0,0,0,0,2,1,3,0,0,0,0,0,0,1,0,1,1,0,1,5
20192020,034,FAYETTE,165,Fayette County,105,Tates Creek High School,165105,034165105,210186000383,CKEC,901,09,248,282,70,76,146,0,1,1,4,5,9,41,32,73,0,0,0,23,22,45,144,112,256,530
20192020,034,FAYETTE,165,Fayette County,105,Tates Creek High School,165105,034165105,210186000383,CKEC,901,10,227,189,46,89,135,0,0,0,4,8,12,29,17,46,2,0,2,9,16,25,99,97,196,416
20192020,034,FAYETTE,165,Fayette County,111,SAP Program,165111,034165111,210186002438,CKEC,901,07,0,0,0,0,0,0,0,0,0,0,0,0,0,0,0,0,0,0,0,0,0,0,0,0
20192020,034,FAYETTE,165,Fayette County,111,SAP Program,165111,034165111,210186002438,CKEC,901,All Students,0,0,0,0,0,0,0,0,0,0,0,0,0,0,0,0,0,0,0,0,0,0,0,0
20192020,034,FAYETTE,165,Fayette County,111,SAP Program,165111,034165111,210186002438,CKEC,901,06,0,0,0,0,0,0,0,0,0,0,0,0,0,0,0,0,0,0,0,0,0,0,0,0
20192020,034,FAYETTE,165,Fayette County,111,SAP Program,165111,034165111,210186002438,CKEC,901,08,0,0,0,0,0,0,0,0,0,0,0,0,0,0,0,0,0,0,0,0,0,0,0,0
20192020,034,FAYETTE,165,Fayette County,111,SAP Program,165111,034165111,210186002438,CKEC,901,09,0,0,0,0,0,0,0,0,0,0,0,0,0,0,0,0,0,0,0,0,0,0,0,0
20192020,034,FAYETTE,165,Fayette County,111,SAP Program,165111,034165111,210186002438,CKEC,901,10,0,0,0,0,0,0,0,0,0,0,0,0,0,0,0,0,0,0,0,0,0,0,0,0
20192020,034,FAYETTE,165,Fayette County,111,SAP Program,165111,034165111,210186002438,CKEC,901,12,0,0,0,0,0,0,0,0,0,0,0,0,0,0,0,0,0,0,0,0,0,0,0,0
20192020,034,FAYETTE,165,Fayette County,111,SAP Program,165111,034165111,210186002438,CKEC,901,14,0,0,0,0,0,0,0,0,0,0,0,0,0,0,0,0,0,0,0,0,0,0,0,0
20192020,034,FAYETTE,165,Fayette County,111,SAP Program,165111,034165111,210186002438,CKEC,901,11,0,0,0,0,0,0,0,0,0,0,0,0,0,0,0,0,0,0,0,0,0,0,0,0
20192020,034,FAYETTE,165,Fayette County,120,Clays Mill Elementary School,165120,034165120,210186000384,CKEC,901,05,44,58,4,0,4,0,0,0,2,0,2,3,6,9,0,0,0,2,3,5,47,35,82,102
20192020,034,FAYETTE,165,Fayette County,120,Clays Mill Elementary School,165120,034165120,210186000384,CKEC,901,All Students,261,284,12,7,19,1,0,1,10,3,13,15,20,35,0,0,0,17,20,37,229,211,440,545
20192020,034,FAYETTE,165,Fayette County,120,Clays Mill Elementary School,165120,034165120,210186000384,CKEC,901,KG,47,49,2,1,3,0,0,0,1,0,1,4,3,7,0,0,0,4,6,10,38,37,75,96
20192020,034,FAYETTE,165,Fayette County,120,Clays Mill Elementary School,165120,034165120,210186000384,CKEC,901,01,40,38,1,0,1,0,0,0,2,0,2,2,4,6,0,0,0,3,4,7,30,32,62,78
20192020,034,FAYETTE,165,Fayette County,120,Clays Mill Elementary School,165120,034165120,210186000384,CKEC,901,02,42,47,2,1,3,0,0,0,2,1,3,2,3,5,0,0,0,3,3,6,38,34,72,89
20192020,034,FAYETTE,165,Fayette County,120,Clays Mill Elementary School,165120,034165120,210186000384,CKEC,901,03,48,41,0,4,4,1,0,1,1,2,3,2,2,4,0,0,0,1,1,2,36,39,75,89
20192020,034,FAYETTE,165,Fayette County,120,Clays Mill Elementary School,165120,034165120,210186000384,CKEC,901,04,40,51,3,1,4,0,0,0,2,0,2,2,2,4,0,0,0,4,3,7,40,34,74,91
20192020,034,FAYETTE,165,Fayette County,125,Frederick Douglass High School,165125,034165125,210186002459,CKEC,901,12,108,168,71,33,104,0,0,0,5,4,9,18,17,35,0,0,0,5,7,12,69,47,116,276
20192020,034,FAYETTE,165,Fayette County,125,Frederick Douglass High School,165125,034165125,210186002459,CKEC,901,All Students,735,744,247,234,481,3,1,4,24,34,58,109,84,193,0,0,0,31,35,66,330,347,677,1479
20192020,034,FAYETTE,165,Fayette County,125,Frederick Douglass High School,165125,034165125,210186002459,CKEC,901,09,211,253,75,67,142,1,0,1,6,7,13,42,22,64,0,0,0,11,12,23,118,103,221,464
20192020,034,FAYETTE,165,Fayette County,125,Frederick Douglass High School,165125,034165125,210186002459,CKEC,901,10,223,175,58,76,134,1,0,1,7,9,16,28,26,54,0,0,0,7,9,16,74,103,177,398
20192020,034,FAYETTE,165,Fayette County,125,Frederick Douglass High School,165125,034165125,210186002459,CKEC,901,11,191,147,42,57,99,1,1,2,6,14,20,21,19,40,0,0,0,8,7,15,69,93,162,338
20192020,034,FAYETTE,165,Fayette County,125,Frederick Douglass High School,165125,034165125,210186002459,CKEC,901,14,2,1,1,1,2,0,0,0,0,0,0,0,0,0,0,0,0,0,0,0,0,1,1,3
20192020,034,FAYETTE,165,Fayette County,130,STEAM Academy,165130,034165130,210186002341,CKEC,901,11,34,38,10,7,17,0,1,1,2,2,4,3,2,5,0,0,0,2,1,3,21,21,42,72
20192020,034,FAYETTE,165,Fayette County,130,STEAM Academy,165130,034165130,210186002341,CKEC,901,All Students,114,135,32,31,63,0,2,2,3,5,8,12,11,23,0,0,0,4,6,10,84,59,143,249
20192020,034,FAYETTE,165,Fayette County,130,STEAM Academy,165130,034165130,210186002341,CKEC,901,09,41,48,10,10,20,0,0,0,1,2,3,6,4,10,0,0,0,1,4,5,30,21,51,89
20192020,034,FAYETTE,165,Fayette County,130,STEAM Academy,165130,034165130,210186002341,CKEC,901,10,39,49,12,14,26,0,1,1,0,1,1,3,5,8,0,0,0,1,1,2,33,17,50,88
20192020,034,FAYETTE,165,Fayette County,133,Success Academy,165133,034165133,210186002463,CKEC,901,10,7,10,5,1,6,0,0,0,0,0,0,1,2,3,0,0,0,1,0,1,3,4,7,17
20192020,034,FAYETTE,165,Fayette County,133,Success Academy,165133,034165133,210186002463,CKEC,901,12,0,2,1,0,1,0,0,0,0,0,0,1,0,1,0,0,0,0,0,0,0,0,0,2
20192020,034,FAYETTE,165,Fayette County,133,Success Academy,165133,034165133,210186002463,CKEC,901,09,6,5,2,1,3,0,0,0,0,0,0,2,1,3,0,0,0,0,0,0,1,4,5,11
20192020,034,FAYETTE,165,Fayette County,133,Success Academy,165133,034165133,210186002463,CKEC,901,11,1,6,3,0,3,0,0,0,0,0,0,1,0,1,0,0,0,1,0,1,1,1,2,7
20192020,034,FAYETTE,165,Fayette County,133,Success Academy,165133,034165133,210186002463,CKEC,901,All Students,14,23,11,2,13,0,0,0,0,0,0,5,3,8,0,0,0,2,0,2,5,9,14,37
20192020,034,FAYETTE,165,Fayette County,140,Yates Elementary School,165140,034165140,210186000385,CKEC,901,01,31,33,9,9,18,0,0,0,1,0,1,9,11,20,0,0,0,3,4,7,11,7,18,64
20192020,034,FAYETTE,165,Fayette County,140,Yates Elementary School,165140,034165140,210186000385,CKEC,901,All Students,169,191,68,66,134,0,0,0,2,1,3,48,52,100,0,0,0,9,7,16,64,43,107,360
20192020,034,FAYETTE,165,Fayette County,140,Yates Elementary School,165140,034165140,210186000385,CKEC,901,PS,41,70,22,17,39,0,0,0,9,4,13,7,9,16,0,0,0,7,3,10,25,8,33,111
20192020,034,FAYETTE,165,Fayette County,140,Yates Elementary School,165140,034165140,210186000385,CKEC,901,KG,30,41,14,12,26,0,0,0,0,0,0,11,7,18,0,0,0,0,1,1,16,10,26,71
20192020,034,FAYETTE,165,Fayette County,140,Yates Elementary School,165140,034165140,210186000385,CKEC,901,02,20,32,14,8,22,0,0,0,0,1,1,9,6,15,0,0,0,1,0,1,8,5,13,52
20192020,034,FAYETTE,165,Fayette County,140,Yates Elementary School,165140,034165140,210186000385,CKEC,901,03,30,34,10,15,25,0,0,0,1,0,1,9,8,17,0,0,0,2,0,2,12,7,19,64
20192020,034,FAYETTE,165,Fayette County,140,Yates Elementary School,165140,034165140,210186000385,CKEC,901,04,28,22,6,11,17,0,0,0,0,0,0,5,10,15,0,0,0,2,0,2,9,7,16,50
20192020,034,FAYETTE,165,Fayette County,140,Yates Elementary School,165140,034165140,210186000385,CKEC,901,05,30,29,15,11,26,0,0,0,0,0,0,5,10,15,0,0,0,1,2,3,8,7,15,59
20192020,034,FAYETTE,165,Fayette County,150,Glendover Elementary School,165150,034165150,210186000386,CKEC,901,05,40,49,4,9,13,0,0,0,6,1,7,14,8,22,0,0,0,3,1,4,22,21,43,89
20192020,034,FAYETTE,165,Fayette County,150,Glendover Elementary School,165150,034165150,210186000386,CKEC,901,All Students,279,283,28,23,51,0,0,0,31,32,63,75,62,137,0,0,0,8,15,23,141,147,288,562
20192020,034,FAYETTE,165,Fayette County,150,Glendover Elementary School,165150,034165150,210186000386,CKEC,901,PS,15,21,3,1,4,0,0,0,2,3,5,1,3,4,0,0,0,1,0,1,14,8,22,36
20192020,034,FAYETTE,165,Fayette County,150,Glendover Elementary School,165150,034165150,210186000386,CKEC,901,KG,57,42,4,3,7,0,0,0,5,10,15,10,13,23,0,0,0,2,3,5,21,28,49,99
20192020,034,FAYETTE,165,Fayette County,150,Glendover Elementary School,165150,034165150,210186000386,CKEC,901,01,47,52,8,0,8,0,0,0,7,4,11,15,11,26,0,0,0,2,5,7,20,27,47,99
20192020,034,FAYETTE,165,Fayette County,150,Glendover Elementary School,165150,034165150,210186000386,CKEC,901,02,45,50,5,1,6,0,0,0,6,9,15,15,7,22,0,0,0,0,2,2,24,26,50,95
20192020,034,FAYETTE,165,Fayette County,150,Glendover Elementary School,165150,034165150,210186000386,CKEC,901,03,50,50,3,4,7,0,0,0,3,5,8,10,16,26,0,0,0,1,2,3,33,23,56,100
20192020,034,FAYETTE,165,Fayette County,150,Glendover Elementary School,165150,034165150,210186000386,CKEC,901,04,40,40,4,6,10,0,0,0,4,3,7,11,7,18,0,0,0,0,2,2,21,22,43,80
20192020,034,FAYETTE,165,Fayette County,160,Meadowthorpe Elementary School,165160,034165160,210186000387,CKEC,901,04,43,37,3,8,11,0,0,0,0,3,3,4,8,12,0,0,0,5,4,9,25,20,45,80
20192020,034,FAYETTE,165,Fayette County,160,Meadowthorpe Elementary School,165160,034165160,210186000387,CKEC,901,All Students,207,260,66,52,118,2,0,2,13,11,24,43,28,71,0,1,1,21,18,39,115,97,212,467
20192020,034,FAYETTE,165,Fayette County,160,Meadowthorpe Elementary School,165160,034165160,210186000387,CKEC,901,PS,13,18,4,8,12,0,0,0,1,0,1,3,4,7,0,0,0,3,0,3,7,1,8,31
20192020,034,FAYETTE,165,Fayette County,160,Meadowthorpe Elementary School,165160,034165160,210186000387,CKEC,901,KG,34,35,10,6,16,0,0,0,2,4,6,12,5,17,0,0,0,2,3,5,9,16,25,69
20192020,034,FAYETTE,165,Fayette County,160,Meadowthorpe Elementary School,165160,034165160,210186000387,CKEC,901,01,35,42,15,13,28,1,0,1,2,1,3,5,4,9,0,0,0,3,3,6,16,14,30,77
20192020,034,FAYETTE,165,Fayette County,160,Meadowthorpe Elementary School,165160,034165160,210186000387,CKEC,901,02,23,39,15,4,19,0,0,0,1,0,1,7,1,8,0,0,0,2,2,4,14,16,30,62
20192020,034,FAYETTE,165,Fayette County,160,Meadowthorpe Elementary School,165160,034165160,210186000387,CKEC,901,03,35,43,11,7,18,1,0,1,2,1,3,4,6,10,0,1,1,4,3,7,21,17,38,78
20192020,034,FAYETTE,165,Fayette County,160,Meadowthorpe Elementary School,165160,034165160,210186000387,CKEC,901,05,37,64,12,14,26,0,0,0,6,2,8,11,4,15,0,0,0,5,3,8,30,14,44,101
20192020,034,FAYETTE,165,Fayette County,170,Bryan Station High School,165170,034165170,210186000388,CKEC,901,12,195,187,69,73,142,0,0,0,0,1,1,36,39,75,0,0,0,5,6,11,77,76,153,382
20192020,034,FAYETTE,165,Fayette County,170,Bryan Station High School,165170,034165170,210186000388,CKEC,901,All Students,850,845,299,297,596,1,3,4,8,8,16,213,211,424,0,2,2,29,35,64,295,294,589,1695
20192020,034,FAYETTE,165,Fayette County,170,Bryan Station High School,165170,034165170,210186000388,CKEC,901,08,26,16,1,2,3,0,0,0,0,3,3,0,3,3,0,0,0,1,1,2,14,17,31,42
20192020,034,FAYETTE,165,Fayette County,170,Bryan Station High School,165170,034165170,210186000388,CKEC,901,09,222,242,92,77,169,0,0,0,4,0,4,67,66,133,0,0,0,14,12,26,65,67,132,464
20192020,034,FAYETTE,165,Fayette County,170,Bryan Station High School,165170,034165170,210186000388,CKEC,901,10,222,221,73,85,158,1,1,2,2,3,5,63,54,117,0,0,0,5,8,13,77,71,148,443
20192020,034,FAYETTE,165,Fayette County,170,Bryan Station High School,165170,034165170,210186000388,CKEC,901,11,183,174,62,59,121,0,2,2,2,1,3,46,49,95,0,2,2,4,8,12,60,62,122,357
20192020,034,FAYETTE,165,Fayette County,170,Bryan Station High School,165170,034165170,210186000388,CKEC,901,14,2,5,2,1,3,0,0,0,0,0,0,1,0,1,0,0,0,0,0,0,2,1,3,7
20192020,034,FAYETTE,165,Fayette County,180,Mary Todd Elementary School,165180,034165180,210186000389,CKEC,901,04,41,40,13,10,23,0,0,0,1,0,1,17,19,36,0,0,0,2,1,3,7,11,18,81
20192020,034,FAYETTE,165,Fayette County,180,Mary Todd Elementary School,165180,034165180,210186000389,CKEC,901,All Students,204,230,70,76,146,0,0,0,1,0,1,88,72,160,0,0,0,14,9,23,57,47,104,434
20192020,034,FAYETTE,165,Fayette County,180,Mary Todd Elementary School,165180,034165180,210186000389,CKEC,901,PS,13,21,7,4,11,0,0,0,0,0,0,7,4,11,0,0,0,1,0,1,6,5,11,34
20192020,034,FAYETTE,165,Fayette County,180,Mary Todd Elementary School,165180,034165180,210186000389,CKEC,901,KG,34,40,13,9,22,0,0,0,0,0,0,13,14,27,0,0,0,3,3,6,11,8,19,74
20192020,034,FAYETTE,165,Fayette County,180,Mary Todd Elementary School,165180,034165180,210186000389,CKEC,901,01,30,27,7,18,25,0,0,0,0,0,0,13,3,16,0,0,0,2,3,5,5,6,11,57
20192020,034,FAYETTE,165,Fayette County,180,Mary Todd Elementary School,165180,034165180,210186000389,CKEC,901,02,30,30,11,14,25,0,0,0,0,0,0,9,11,20,0,0,0,2,1,3,8,4,12,60
20192020,034,FAYETTE,165,Fayette County,180,Mary Todd Elementary School,165180,034165180,210186000389,CKEC,901,03,42,47,12,14,26,0,0,0,0,0,0,17,17,34,0,0,0,3,1,4,15,10,25,89
20192020,034,FAYETTE,165,Fayette County,180,Mary Todd Elementary School,165180,034165180,210186000389,CKEC,901,05,27,46,14,11,25,0,0,0,0,0,0,19,8,27,0,0,0,2,0,2,11,8,19,73
20192020,034,FAYETTE,165,Fayette County,190,James Lane Allen Elementary School,165190,034165190,210186000390,CKEC,901,04,37,28,7,6,13,0,0,0,1,2,3,11,15,26,0,0,0,2,1,3,7,13,20,65
20192020,034,FAYETTE,165,Fayette County,190,James Lane Allen Elementary School,165190,034165190,210186000390,CKEC,901,All Students,211,224,45,42,87,0,0,0,2,4,6,106,88,194,0,0,0,12,7,19,59,70,129,435
20192020,034,FAYETTE,165,Fayette County,190,James Lane Allen Elementary School,165190,034165190,210186000390,CKEC,901,PS,15,39,5,4,9,0,0,0,0,0,0,20,8,28,0,0,0,2,0,2,12,3,15,54
20192020,034,FAYETTE,165,Fayette County,190,James Lane Allen Elementary School,165190,034165190,210186000390,CKEC,901,KG,35,43,13,6,19,0,0,0,0,0,0,17,14,31,0,0,0,0,2,2,13,13,26,78
20192020,034,FAYETTE,165,Fayette County,190,James Lane Allen Elementary School,165190,034165190,210186000390,CKEC,901,01,33,46,8,12,20,0,0,0,0,0,0,22,13,35,0,0,0,2,1,3,14,7,21,79
20192020,034,FAYETTE,165,Fayette County,190,James Lane Allen Elementary School,165190,034165190,210186000390,CKEC,901,02,31,33,7,7,14,0,0,0,1,1,2,16,10,26,0,0,0,1,1,2,8,12,20,64
20192020,034,FAYETTE,165,Fayette County,190,James Lane Allen Elementary School,165190,034165190,210186000390,CKEC,901,03,40,41,8,7,15,0,0,0,0,0,0,22,19,41,0,0,0,4,2,6,7,12,19,81
20192020,034,FAYETTE,165,Fayette County,190,James Lane Allen Elementary School,165190,034165190,210186000390,CKEC,901,05,35,33,2,4,6,0,0,0,0,1,1,18,17,35,0,0,0,3,0,3,10,13,23,68
20192020,034,FAYETTE,165,Fayette County,200,Paul Laurence Dunbar High School,165200,034165200,210186001669,CKEC,901,11,241,253,31,26,57,0,1,1,25,23,48,70,71,141,0,0,0,8,9,17,119,111,230,494
20192020,034,FAYETTE,165,Fayette County,200,Paul Laurence Dunbar High School,165200,034165200,210186001669,CKEC,901,All Students,984,1043,139,117,256,0,2,2,90,98,188,278,276,554,2,0,2,32,33,65,502,458,960,2027
20192020,034,FAYETTE,165,Fayette County,200,Paul Laurence Dunbar High School,165200,034165200,210186001669,CKEC,901,09,245,287,35,32,67,0,1,1,16,24,40,94,75,169,0,0,0,7,11,18,135,102,237,532
20192020,034,FAYETTE,165,Fayette County,200,Paul Laurence Dunbar High School,165200,034165200,210186001669,CKEC,901,10,259,268,32,33,65,0,0,0,30,28,58,64,70,134,1,0,1,11,8,19,130,120,250,527
20192020,034,FAYETTE,165,Fayette County,200,Paul Laurence Dunbar High School,165200,034165200,210186001669,CKEC,901,12,236,233,40,25,65,0,0,0,19,23,42,50,59,109,1,0,1,6,5,11,117,124,241,469
20192020,034,FAYETTE,165,Fayette County,200,Paul Laurence Dunbar High School,165200,034165200,210186001669,CKEC,901,14,3,2,1,1,2,0,0,0,0,0,0,0,1,1,0,0,0,0,0,0,1,1,2,5
20192020,034,FAYETTE,165,Fayette County,225,Jessie M Clark Middle School,165225,034165225,210186000391,CKEC,901,08,176,182,15,17,32,0,2,2,12,16,28,16,13,29,0,0,0,9,9,18,130,119,249,358
20192020,034,FAYETTE,165,Fayette County,225,Jessie M Clark Middle School,165225,034165225,210186000391,CKEC,901,All Students,584,581,47,54,101,1,2,3,32,42,74,56,53,109,0,0,0,37,36,73,408,397,805,1165
20192020,034,FAYETTE,165,Fayette County,225,Jessie M Clark Middle School,165225,034165225,210186000391,CKEC,901,06,205,195,21,17,38,0,0,0,11,13,24,21,17,38,0,0,0,15,16,31,127,142,269,400
20192020,034,FAYETTE,165,Fayette County,225,Jessie M Clark Middle School,165225,034165225,210186000391,CKEC,901,07,203,204,11,20,31,1,0,1,9,13,22,19,23,42,0,0,0,13,11,24,151,136,287,407
20192020,034,FAYETTE,165,Fayette County,240,Cardinal Valley Elementary School,165240,034165240,210186000392,CKEC,901,01,49,53,2,11,13,0,0,0,0,0,0,40,32,72,0,0,0,2,1,3,9,5,14,102
20192020,034,FAYETTE,165,Fayette County,240,Cardinal Valley Elementary School,165240,034165240,210186000392,CKEC,901,02,49,49,7,2,9,0,0,0,0,0,0,32,37,69,0,0,0,2,0,2,8,10,18,98
20192020,034,FAYETTE,165,Fayette County,240,Cardinal Valley Elementary School,165240,034165240,210186000392,CKEC,901,03,46,62,9,6,15,0,0,0,0,0,0,45,37,82,0,0,0,0,1,1,8,2,10,108
20192020,034,FAYETTE,165,Fayette County,240,Cardinal Valley Elementary School,165240,034165240,210186000392,CKEC,901,05,50,64,10,8,18,0,0,0,0,0,0,48,40,88,0,0,0,1,0,1,5,2,7,114
20192020,034,FAYETTE,165,Fayette County,240,Cardinal Valley Elementary School,165240,034165240,210186000392,CKEC,901,04,53,60,8,7,15,0,0,0,0,0,0,46,31,77,0,0,0,1,2,3,5,13,18,113
20192020,034,FAYETTE,165,Fayette County,240,Cardinal Valley Elementary School,165240,034165240,210186000392,CKEC,901,All Students,291,340,44,37,81,0,0,0,0,0,0,249,209,458,0,0,0,6,5,11,41,40,81,631
20192020,034,FAYETTE,165,Fayette County,240,Cardinal Valley Elementary School,165240,034165240,210186000392,CKEC,901,PS,12,24,3,1,4,0,0,0,0,0,0,14,9,23,0,0,0,1,1,2,6,1,7,36
20192020,034,FAYETTE,165,Fayette County,240,Cardinal Valley Elementary School,165240,034165240,210186000392,CKEC,901,KG,44,52,8,3,11,0,0,0,0,0,0,38,32,70,0,0,0,0,1,1,6,8,14,96
20192020,034,FAYETTE,165,Fayette County,245,Winburn Middle School,165245,034165245,210186000393,CKEC,901,07,132,142,37,49,86,0,0,0,5,2,7,53,51,104,0,0,0,7,5,12,40,25,65,274
20192020,034,FAYETTE,165,Fayette County,245,Winburn Middle School,165245,034165245,210186000393,CKEC,901,All Students,405,392,129,163,292,0,0,0,18,9,27,144,148,292,0,0,0,14,11,25,87,74,161,797
20192020,034,FAYETTE,165,Fayette County,245,Winburn Middle School,165245,034165245,210186000393,CKEC,901,06,140,146,56,50,106,0,0,0,7,4,11,46,50,96,0,0,0,4,3,7,33,33,66,286
20192020,034,FAYETTE,165,Fayette County,245,Winburn Middle School,165245,034165245,210186000393,CKEC,901,08,133,104,36,64,100,0,0,0,6,3,9,45,47,92,0,0,0,3,3,6,14,16,30,237
20192020,034,FAYETTE,165,Fayette County,255,Millcreek Elementary School,165255,034165255,210186001419,CKEC,901,02,30,39,14,10,24,0,0,0,0,1,1,7,4,11,0,0,0,4,5,9,14,10,24,69
20192020,034,FAYETTE,165,Fayette County,255,Millcreek Elementary School,165255,034165255,210186001419,CKEC,901,All Students,234,252,87,83,170,0,0,0,3,9,12,27,33,60,1,0,1,21,19,40,113,90,203,486
20192020,034,FAYETTE,165,Fayette County,255,Millcreek Elementary School,165255,034165255,210186001419,CKEC,901,PS,36,76,23,15,38,0,0,0,1,1,2,14,6,20,1,0,1,8,1,9,29,13,42,112
20192020,034,FAYETTE,165,Fayette County,255,Millcreek Elementary School,165255,034165255,210186001419,CKEC,901,KG,37,48,17,12,29,0,0,0,0,0,0,5,4,9,0,0,0,6,2,8,20,19,39,85
20192020,034,FAYETTE,165,Fayette County,255,Millcreek Elementary School,165255,034165255,210186001419,CKEC,901,01,44,40,9,13,22,0,0,0,3,2,5,2,5,7,0,0,0,5,5,10,21,19,40,84
20192020,034,FAYETTE,165,Fayette County,255,Millcreek Elementary School,165255,034165255,210186001419,CKEC,901,03,43,40,11,15,26,0,0,0,0,1,1,5,10,15,1,0,1,4,2,6,19,15,34,83
20192020,034,FAYETTE,165,Fayette County,255,Millcreek Elementary School,165255,034165255,210186001419,CKEC,901,04,44,33,12,16,28,0,0,0,0,3,3,4,4,8,0,0,0,1,2,3,16,19,35,77
20192020,034,FAYETTE,165,Fayette County,255,Millcreek Elementary School,165255,034165255,210186001419,CKEC,901,05,36,52,24,17,41,0,0,0,0,2,2,4,6,10,0,0,0,1,3,4,23,8,31,88
20192020,034,FAYETTE,165,Fayette County,275,Carter G. Woodson Academy,165275,034165275,210186002323,CKEC,901,11,0,20,19,0,19,0,0,0,0,0,0,0,0,0,0,0,0,1,0,1,0,0,0,20
20192020,034,FAYETTE,165,Fayette County,275,Carter G. Woodson Academy,165275,034165275,210186002323,CKEC,901,All Students,0,221,170,0,170,0,0,0,0,0,0,30,0,30,0,0,0,13,0,13,8,0,8,221
20192020,034,FAYETTE,165,Fayette County,275,Carter G. Woodson Academy,165275,034165275,210186002323,CKEC,901,06,0,48,31,0,31,0,0,0,0,0,0,9,0,9,0,0,0,4,0,4,4,0,4,48
20192020,034,FAYETTE,165,Fayette County,275,Carter G. Woodson Academy,165275,034165275,210186002323,CKEC,901,07,0,47,39,0,39,0,0,0,0,0,0,5,0,5,0,0,0,2,0,2,1,0,1,47
20192020,034,FAYETTE,165,Fayette County,275,Carter G. Woodson Academy,165275,034165275,210186002323,CKEC,901,08,0,38,24,0,24,0,0,0,0,0,0,10,0,10,0,0,0,1,0,1,3,0,3,38
20192020,034,FAYETTE,165,Fayette County,275,Carter G. Woodson Academy,165275,034165275,210186002323,CKEC,901,09,0,38,32,0,32,0,0,0,0,0,0,3,0,3,0,0,0,3,0,3,0,0,0,38
20192020,034,FAYETTE,165,Fayette County,275,Carter G. Woodson Academy,165275,034165275,210186002323,CKEC,901,10,0,30,25,0,25,0,0,0,0,0,0,3,0,3,0,0,0,2,0,2,0,0,0,30
20192020,034,FAYETTE,165,Fayette County,525,Southern Middle School,165525,034165525,210186000394,CKEC,901,07,126,141,34,29,63,0,0,0,4,7,11,24,13,37,0,0,0,12,7,19,67,70,137,267
20192020,034,FAYETTE,165,Fayette County,525,Southern Middle School,165525,034165525,210186000394,CKEC,901,All Students,392,415,83,85,168,0,0,0,10,17,27,60,39,99,0,0,0,35,24,59,227,227,454,807
20192020,034,FAYETTE,165,Fayette County,525,Southern Middle School,165525,034165525,210186000394,CKEC,901,06,139,137,22,29,51,0,0,0,3,4,7,21,13,34,0,0,0,14,8,22,77,85,162,276
20192020,034,FAYETTE,165,Fayette County,525,Southern Middle School,165525,034165525,210186000394,CKEC,901,08,127,137,27,27,54,0,0,0,3,6,9,15,13,28,0,0,0,9,9,18,83,72,155,264
20192020,034,FAYETTE,165,Fayette County,531,Brenda Cowan Elementary,165531,034165531,210186002486,CKEC,901,05,26,17,4,7,11,0,0,0,5,4,9,0,3,3,0,0,0,1,4,5,7,8,15,43
20192020,034,FAYETTE,165,Fayette County,531,Brenda Cowan Elementary,165531,034165531,210186002486,CKEC,901,All Students,211,230,46,40,86,0,1,1,34,34,68,14,17,31,0,0,0,15,13,28,121,106,227,441
20192020,034,FAYETTE,165,Fayette County,531,Brenda Cowan Elementary,165531,034165531,210186002486,CKEC,901,KG,39,46,10,4,14,0,0,0,3,5,8,5,5,10,0,0,0,0,1,1,28,24,52,85
20192020,034,FAYETTE,165,Fayette County,531,Brenda Cowan Elementary,165531,034165531,210186002486,CKEC,901,01,42,55,14,10,24,0,0,0,10,6,16,1,0,1,0,0,0,4,3,7,26,23,49,97
20192020,034,FAYETTE,165,Fayette County,531,Brenda Cowan Elementary,165531,034165531,210186002486,CKEC,901,04,26,44,5,5,10,0,0,0,5,5,10,4,3,7,0,0,0,2,2,4,28,11,39,70
20192020,034,FAYETTE,165,Fayette County,531,Brenda Cowan Elementary,165531,034165531,210186002486,CKEC,901,02,26,35,6,9,15,0,0,0,5,4,9,2,1,3,0,0,0,6,1,7,16,11,27,61
20192020,034,FAYETTE,165,Fayette County,531,Brenda Cowan Elementary,165531,034165531,210186002486,CKEC,901,03,52,33,7,5,12,0,1,1,6,10,16,2,5,7,0,0,0,2,2,4,16,29,45,85
20192020,034,FAYETTE,165,Fayette County,620,Julius Marks Elementary School,165620,034165620,210186000395,CKEC,901,KG,47,43,4,17,21,0,0,0,2,0,2,7,5,12,0,0,0,7,3,10,23,22,45,90
20192020,034,FAYETTE,165,Fayette County,620,Julius Marks Elementary School,165620,034165620,210186000395,CKEC,901,All Students,273,274,67,85,152,0,0,0,7,6,13,38,28,66,0,1,1,30,32,62,132,121,253,547
20192020,034,FAYETTE,165,Fayette County,620,Julius Marks Elementary School,165620,034165620,210186000395,CKEC,901,PS,16,21,8,4,12,0,0,0,0,0,0,2,0,2,0,0,0,4,2,6,7,10,17,37
20192020,034,FAYETTE,165,Fayette County,620,Julius Marks Elementary School,165620,034165620,210186000395,CKEC,901,01,51,44,14,18,32,0,0,0,2,1,3,4,6,10,0,0,0,4,8,12,20,18,38,95
20192020,034,FAYETTE,165,Fayette County,620,Julius Marks Elementary School,165620,034165620,210186000395,CKEC,901,02,40,39,6,9,15,0,0,0,1,2,3,5,2,7,0,0,0,5,6,11,22,21,43,79
20192020,034,FAYETTE,165,Fayette County,620,Julius Marks Elementary School,165620,034165620,210186000395,CKEC,901,03,38,43,10,9,19,0,0,0,0,2,2,6,5,11,0,0,0,6,3,9,21,19,40,81
20192020,034,FAYETTE,165,Fayette County,620,Julius Marks Elementary School,165620,034165620,210186000395,CKEC,901,04,43,50,15,13,28,0,0,0,1,1,2,7,6,13,0,0,0,3,4,7,24,19,43,93
20192020,034,FAYETTE,165,Fayette County,620,Julius Marks Elementary School,165620,034165620,210186000395,CKEC,901,05,54,55,18,19,37,0,0,0,1,0,1,9,4,13,0,1,1,5,8,13,22,22,44,109
20192020,034,FAYETTE,165,Fayette County,651,Audrey Grevious Center,165651,034165651,210186001480,CKEC,901,11,2,3,1,2,3,0,0,0,0,0,0,1,0,1,0,0,0,0,0,0,1,0,1,5
20192020,034,FAYETTE,165,Fayette County,651,Audrey Grevious Center,165651,034165651,210186001480,CKEC,901,All Students,11,28,13,6,19,0,0,0,0,0,0,7,1,8,0,0,0,1,0,1,7,4,11,39
20192020,034,FAYETTE,165,Fayette County,651,Audrey Grevious Center,165651,034165651,210186001480,CKEC,901,07,0,1,0,0,0,0,0,0,0,0,0,1,0,1,0,0,0,0,0,0,0,0,0,1
20192020,034,FAYETTE,165,Fayette County,651,Audrey Grevious Center,165651,034165651,210186001480,CKEC,901,08,2,6,4,2,6,0,0,0,0,0,0,2,0,2,0,0,0,0,0,0,0,0,0,8
20192020,034,FAYETTE,165,Fayette County,651,Audrey Grevious Center,165651,034165651,210186001480,CKEC,901,09,4,14,5,1,6,0,0,0,0,0,0,3,1,4,0,0,0,1,0,1,5,2,7,18
20192020,034,FAYETTE,165,Fayette County,651,Audrey Grevious Center,165651,034165651,210186001480,CKEC,901,10,3,4,3,1,4,0,0,0,0,0,0,0,0,0,0,0,0,0,0,0,1,2,3,7
20192020,034,FAYETTE,165,Fayette County,887,Fayette Pre-School,165887,034165887,210186002263,CKEC,901,All Students,0,0,0,0,0,0,0,0,0,0,0,0,0,0,0,0,0,0,0,0,0,0,0,0
20192020,034,FAYETTE,165,Fayette County,887,Fayette Pre-School,165887,034165887,210186002263,CKEC,901,PS,12,20,7,7,14,0,0,0,2,0,2,2,1,3,0,0,0,2,0,2,7,4,11,32
20192020,034,FAYETTE,165,Fayette County,898,Fayette County Learning Center,165898,034165898,210186002251,CKEC,901,10,20,24,4,5,9,0,0,0,0,0,0,2,2,4,0,0,0,5,0,5,13,13,26,44
20192020,034,FAYETTE,165,Fayette County,898,Fayette County Learning Center,165898,034165898,210186002251,CKEC,901,All Students,67,74,14,12,26,0,0,0,0,0,0,5,9,14,0,0,0,10,0,10,45,46,91,141
20192020,034,FAYETTE,165,Fayette County,898,Fayette County Learning Center,165898,034165898,210186002251,CKEC,901,08,6,10,2,0,2,0,0,0,0,0,0,1,0,1,0,0,0,0,0,0,7,6,13,16
20192020,034,FAYETTE,165,Fayette County,898,Fayette County Learning Center,165898,034165898,210186002251,CKEC,901,09,21,24,5,4,9,0,0,0,0,0,0,2,5,7,0,0,0,3,0,3,14,12,26,45
20192020,034,FAYETTE,165,Fayette County,898,Fayette County Learning Center,165898,034165898,210186002251,CKEC,901,11,20,16,3,3,6,0,0,0,0,0,0,0,2,2,0,0,0,2,0,2,11,15,26,36
20192020,034,FAYETTE,165,Fayette County,899,Opportunity Middle College,165899,034165899,210186002242,CKEC,901,All Students,37,6,3,14,17,0,0,0,0,2,2,2,6,8,0,0,0,0,1,1,1,14,15,43
20192020,034,FAYETTE,165,Fayette County,899,Opportunity Middle College,165899,034165899,210186002242,CKEC,901,11,37,6,3,14,17,0,0,0,0,2,2,2,6,8,0,0,0,0,1,1,1,14,15,43
20192020,034,FAYETTE,165,Fayette County,904,Southside Technical Center,165904,034165904,210186001563,CKEC,901,12,0,0,0,0,0,0,0,0,0,0,0,0,0,0,0,0,0,0,0,0,0,0,0,0
20192020,034,FAYETTE,165,Fayette County,904,Southside Technical Center,165904,034165904,210186001563,CKEC,901,All Students,0,0,0,0,0,0,0,0,0,0,0,0,0,0,0,0,0,0,0,0,0,0,0,0
20192020,034,FAYETTE,165,Fayette County,904,Southside Technical Center,165904,034165904,210186001563,CKEC,901,09,0,0,0,0,0,0,0,0,0,0,0,0,0,0,0,0,0,0,0,0,0,0,0,0
20192020,034,FAYETTE,165,Fayette County,904,Southside Technical Center,165904,034165904,210186001563,CKEC,901,10,0,0,0,0,0,0,0,0,0,0,0,0,0,0,0,0,0,0,0,0,0,0,0,0
20192020,034,FAYETTE,165,Fayette County,904,Southside Technical Center,165904,034165904,210186001563,CKEC,901,11,0,0,0,0,0,0,0,0,0,0,0,0,0,0,0,0,0,0,0,0,0,0,0,0
20192020,034,FAYETTE,165,Fayette County,905,Eastside Technical Center,165905,034165905,210186001564,CKEC,901,All Students,0,0,0,0,0,0,0,0,0,0,0,0,0,0,0,0,0,0,0,0,0,0,0,0
20192020,034,FAYETTE,165,Fayette County,905,Eastside Technical Center,165905,034165905,210186001564,CKEC,901,09,0,0,0,0,0,0,0,0,0,0,0,0,0,0,0,0,0,0,0,0,0,0,0,0
20192020,034,FAYETTE,165,Fayette County,905,Eastside Technical Center,165905,034165905,210186001564,CKEC,901,10,0,0,0,0,0,0,0,0,0,0,0,0,0,0,0,0,0,0,0,0,0,0,0,0
20192020,034,FAYETTE,165,Fayette County,905,Eastside Technical Center,165905,034165905,210186001564,CKEC,901,11,0,0,0,0,0,0,0,0,0,0,0,0,0,0,0,0,0,0,0,0,0,0,0,0
20192020,034,FAYETTE,165,Fayette County,905,Eastside Technical Center,165905,034165905,210186001564,CKEC,901,12,0,0,0,0,0,0,0,0,0,0,0,0,0,0,0,0,0,0,0,0,0,0,0,0
20192020,035,FLEMING,171,Fleming County,"",---District Total---,171,"","",KEDC,903,02,72,65,0,0,0,0,1,1,0,0,0,3,0,3,0,0,0,1,1,2,61,70,131,137
20192020,035,FLEMING,171,Fleming County,"",---District Total---,171,"","",KEDC,903,03,74,81,2,2,4,0,0,0,0,0,0,4,1,5,0,0,0,0,2,2,75,69,144,155
20192020,035,FLEMING,171,Fleming County,"",---District Total---,171,"","",KEDC,903,04,63,81,0,0,0,0,0,0,0,0,0,2,2,4,0,0,0,4,1,5,75,60,135,144
20192020,035,FLEMING,171,Fleming County,"",---District Total---,171,"","",KEDC,903,05,82,88,0,0,0,0,0,0,0,0,0,6,5,11,0,0,0,3,4,7,79,73,152,170
20192020,035,FLEMING,171,Fleming County,"",---District Total---,171,"","",KEDC,903,06,78,90,2,1,3,0,0,0,0,0,0,3,5,8,0,0,0,1,0,1,84,72,156,168
20192020,035,FLEMING,171,Fleming County,"",---District Total---,171,"","",KEDC,903,07,96,92,1,0,1,0,0,0,0,0,0,1,5,6,0,0,0,3,3,6,87,88,175,188
20192020,035,FLEMING,171,Fleming County,"",---District Total---,171,"","",KEDC,903,08,77,89,0,0,0,0,0,0,0,0,0,2,2,4,0,0,0,3,5,8,84,70,154,166
20192020,035,FLEMING,171,Fleming County,"",---District Total---,171,"","",KEDC,903,09,78,80,1,0,1,0,0,0,0,1,1,2,4,6,0,0,0,0,4,4,77,69,146,158
20192020,035,FLEMING,171,Fleming County,"",---District Total---,171,"","",KEDC,903,10,85,85,1,2,3,0,0,0,0,0,0,2,2,4,0,0,0,1,3,4,81,78,159,170
20192020,035,FLEMING,171,Fleming County,"",---District Total---,171,"","",KEDC,903,11,98,88,0,1,1,0,0,0,0,2,2,3,0,3,0,0,0,0,2,2,85,93,178,186
20192020,035,FLEMING,171,Fleming County,"",---District Total---,171,"","",KEDC,903,14,0,1,0,0,0,0,0,0,0,0,0,0,0,0,0,0,0,0,0,0,1,0,1,1
20192020,035,FLEMING,171,Fleming County,"",---District Total---,171,"","",KEDC,903,12,68,94,1,2,3,0,1,1,0,1,1,4,1,5,0,0,0,0,2,2,89,61,150,162
20192020,035,FLEMING,171,Fleming County,"",---District Total---,171,"","",KEDC,903,All Students,1026,1120,8,8,16,0,2,2,0,4,4,38,35,73,1,0,1,22,28,50,1051,949,2000,2146
20192020,035,FLEMING,171,Fleming County,"",---District Total---,171,"","",KEDC,903,PS,8,15,0,0,0,0,0,0,0,0,0,2,1,3,0,0,0,1,0,1,12,7,19,23
20192020,035,FLEMING,171,Fleming County,"",---District Total---,171,"","",KEDC,903,KG,84,98,0,0,0,0,0,0,0,0,0,2,3,5,1,0,1,2,1,3,93,80,173,182
20192020,035,FLEMING,171,Fleming County,"",---District Total---,171,"","",KEDC,903,01,71,88,0,0,0,0,0,0,0,0,0,4,5,9,0,0,0,4,0,4,80,66,146,159
20192020,035,FLEMING,171,Fleming County,020,Ewing Elementary School,171020,035171020,210192000396,KEDC,903,PS,1,2,0,0,0,0,0,0,0,0,0,0,0,0,0,0,0,0,0,0,2,1,3,3
20192020,035,FLEMING,171,Fleming County,020,Ewing Elementary School,171020,035171020,210192000396,KEDC,903,All Students,139,154,0,0,0,0,0,0,0,0,0,5,4,9,1,0,1,2,2,4,146,133,279,293
20192020,035,FLEMING,171,Fleming County,020,Ewing Elementary School,171020,035171020,210192000396,KEDC,903,KG,23,24,0,0,0,0,0,0,0,0,0,1,1,2,1,0,1,1,0,1,21,22,43,47
20192020,035,FLEMING,171,Fleming County,020,Ewing Elementary School,171020,035171020,210192000396,KEDC,903,01,20,21,0,0,0,0,0,0,0,0,0,0,0,0,0,0,0,0,0,0,21,20,41,41
20192020,035,FLEMING,171,Fleming County,020,Ewing Elementary School,171020,035171020,210192000396,KEDC,903,02,14,18,0,0,0,0,0,0,0,0,0,0,0,0,0,0,0,0,0,0,18,14,32,32
20192020,035,FLEMING,171,Fleming County,020,Ewing Elementary School,171020,035171020,210192000396,KEDC,903,03,25,28,0,0,0,0,0,0,0,0,0,1,1,2,0,0,0,0,0,0,27,24,51,53
20192020,035,FLEMING,171,Fleming County,020,Ewing Elementary School,171020,035171020,210192000396,KEDC,903,04,16,25,0,0,0,0,0,0,0,0,0,1,1,2,0,0,0,1,0,1,23,15,38,41
20192020,035,FLEMING,171,Fleming County,020,Ewing Elementary School,171020,035171020,210192000396,KEDC,903,05,20,20,0,0,0,0,0,0,0,0,0,2,1,3,0,0,0,0,2,2,18,17,35,40
20192020,035,FLEMING,171,Fleming County,020,Ewing Elementary School,171020,035171020,210192000396,KEDC,903,06,21,18,0,0,0,0,0,0,0,0,0,0,0,0,0,0,0,0,0,0,18,21,39,39
20192020,035,FLEMING,171,Fleming County,030,Simons Middle School,171030,035171030,210192000397,KEDC,903,08,77,89,0,0,0,0,0,0,0,0,0,2,2,4,0,0,0,3,5,8,84,70,154,166
20192020,035,FLEMING,171,Fleming County,030,Simons Middle School,171030,035171030,210192000397,KEDC,903,All Students,173,181,1,0,1,0,0,0,0,0,0,3,7,10,0,0,0,6,8,14,171,158,329,354
20192020,035,FLEMING,171,Fleming County,030,Simons Middle School,171030,035171030,210192000397,KEDC,903,07,96,92,1,0,1,0,0,0,0,0,0,1,5,6,0,0,0,3,3,6,87,88,175,188
20192020,035,FLEMING,171,Fleming County,035,Fleming County High School,171035,035171035,210192000398,KEDC,903,10,85,85,1,2,3,0,0,0,0,0,0,2,2,4,0,0,0,1,3,4,81,78,159,170
20192020,035,FLEMING,171,Fleming County,035,Fleming County High School,171035,035171035,210192000398,KEDC,903,11,98,88,0,1,1,0,0,0,0,2,2,3,0,3,0,0,0,0,2,2,85,93,178,186
20192020,035,FLEMING,171,Fleming County,035,Fleming County High School,171035,035171035,210192000398,KEDC,903,14,0,1,0,0,0,0,0,0,0,0,0,0,0,0,0,0,0,0,0,0,1,0,1,1
20192020,035,FLEMING,171,Fleming County,035,Fleming County High School,171035,035171035,210192000398,KEDC,903,12,68,94,1,2,3,0,1,1,0,1,1,4,1,5,0,0,0,0,2,2,89,61,150,162
20192020,035,FLEMING,171,Fleming County,035,Fleming County High School,171035,035171035,210192000398,KEDC,903,All Students,329,348,3,5,8,0,1,1,0,4,4,11,7,18,0,0,0,1,11,12,333,301,634,677
20192020,035,FLEMING,171,Fleming County,035,Fleming County High School,171035,035171035,210192000398,KEDC,903,09,78,80,1,0,1,0,0,0,0,1,1,2,4,6,0,0,0,0,4,4,77,69,146,158
20192020,035,FLEMING,171,Fleming County,040,Flemingsburg Elementary School,171040,035171040,210192000399,KEDC,903,05,40,43,0,0,0,0,0,0,0,0,0,2,4,6,0,0,0,2,0,2,39,36,75,83
20192020,035,FLEMING,171,Fleming County,040,Flemingsburg Elementary School,171040,035171040,210192000399,KEDC,903,All Students,240,272,1,3,4,0,1,1,0,0,0,15,13,28,0,0,0,9,4,13,247,219,466,512
20192020,035,FLEMING,171,Fleming County,040,Flemingsburg Elementary School,171040,035171040,210192000399,KEDC,903,PS,1,4,0,0,0,0,0,0,0,0,0,1,0,1,0,0,0,1,0,1,2,1,3,5
20192020,035,FLEMING,171,Fleming County,040,Flemingsburg Elementary School,171040,035171040,210192000399,KEDC,903,KG,38,49,0,0,0,0,0,0,0,0,0,0,0,0,0,0,0,1,1,2,48,37,85,87
20192020,035,FLEMING,171,Fleming County,040,Flemingsburg Elementary School,171040,035171040,210192000399,KEDC,903,01,33,39,0,0,0,0,0,0,0,0,0,4,4,8,0,0,0,3,0,3,32,29,61,72
20192020,035,FLEMING,171,Fleming County,040,Flemingsburg Elementary School,171040,035171040,210192000399,KEDC,903,02,35,32,0,0,0,0,1,1,0,0,0,3,0,3,0,0,0,0,1,1,29,33,62,67
20192020,035,FLEMING,171,Fleming County,040,Flemingsburg Elementary School,171040,035171040,210192000399,KEDC,903,03,30,32,1,2,3,0,0,0,0,0,0,2,0,2,0,0,0,0,2,2,29,26,55,62
20192020,035,FLEMING,171,Fleming County,040,Flemingsburg Elementary School,171040,035171040,210192000399,KEDC,903,04,28,31,0,0,0,0,0,0,0,0,0,1,1,2,0,0,0,2,0,2,28,27,55,59
20192020,035,FLEMING,171,Fleming County,040,Flemingsburg Elementary School,171040,035171040,210192000399,KEDC,903,06,36,46,0,1,1,0,0,0,0,0,0,3,4,7,0,0,0,1,0,1,42,31,73,82
20192020,035,FLEMING,171,Fleming County,050,E P Ward Elementary School,171050,035171050,210192000400,KEDC,903,05,8,17,0,0,0,0,0,0,0,0,0,2,0,2,0,0,0,0,1,1,15,7,22,25
20192020,035,FLEMING,171,Fleming County,050,E P Ward Elementary School,171050,035171050,210192000400,KEDC,903,All Students,71,96,1,0,1,0,0,0,0,0,0,3,2,5,0,0,0,3,1,4,89,68,157,167
20192020,035,FLEMING,171,Fleming County,050,E P Ward Elementary School,171050,035171050,210192000400,KEDC,903,PS,6,6,0,0,0,0,0,0,0,0,0,0,1,1,0,0,0,0,0,0,6,5,11,12
20192020,035,FLEMING,171,Fleming County,050,E P Ward Elementary School,171050,035171050,210192000400,KEDC,903,KG,8,16,0,0,0,0,0,0,0,0,0,1,1,2,0,0,0,0,0,0,15,7,22,24
20192020,035,FLEMING,171,Fleming County,050,E P Ward Elementary School,171050,035171050,210192000400,KEDC,903,01,9,13,0,0,0,0,0,0,0,0,0,0,0,0,0,0,0,1,0,1,12,9,21,22
20192020,035,FLEMING,171,Fleming County,050,E P Ward Elementary School,171050,035171050,210192000400,KEDC,903,02,15,8,0,0,0,0,0,0,0,0,0,0,0,0,0,0,0,1,0,1,7,15,22,23
20192020,035,FLEMING,171,Fleming County,050,E P Ward Elementary School,171050,035171050,210192000400,KEDC,903,03,12,10,0,0,0,0,0,0,0,0,0,0,0,0,0,0,0,0,0,0,10,12,22,22
20192020,035,FLEMING,171,Fleming County,050,E P Ward Elementary School,171050,035171050,210192000400,KEDC,903,04,4,17,0,0,0,0,0,0,0,0,0,0,0,0,0,0,0,1,0,1,16,4,20,21
20192020,035,FLEMING,171,Fleming County,050,E P Ward Elementary School,171050,035171050,210192000400,KEDC,903,06,15,15,1,0,1,0,0,0,0,0,0,0,1,1,0,0,0,0,0,0,14,14,28,30
20192020,035,FLEMING,171,Fleming County,060,Hillsboro Elementary School,171060,035171060,210192000401,KEDC,903,KG,15,9,0,0,0,0,0,0,0,0,0,0,1,1,0,0,0,0,0,0,9,14,23,24
20192020,035,FLEMING,171,Fleming County,060,Hillsboro Elementary School,171060,035171060,210192000401,KEDC,903,All Students,74,69,2,0,2,0,0,0,0,0,0,1,2,3,0,0,0,1,2,3,65,70,135,143
20192020,035,FLEMING,171,Fleming County,060,Hillsboro Elementary School,171060,035171060,210192000401,KEDC,903,02,8,7,0,0,0,0,0,0,0,0,0,0,0,0,0,0,0,0,0,0,7,8,15,15
20192020,035,FLEMING,171,Fleming County,060,Hillsboro Elementary School,171060,035171060,210192000401,KEDC,903,05,14,8,0,0,0,0,0,0,0,0,0,0,0,0,0,0,0,1,1,2,7,13,20,22
20192020,035,FLEMING,171,Fleming County,060,Hillsboro Elementary School,171060,035171060,210192000401,KEDC,903,PS,0,3,0,0,0,0,0,0,0,0,0,1,0,1,0,0,0,0,0,0,2,0,2,3
20192020,035,FLEMING,171,Fleming County,060,Hillsboro Elementary School,171060,035171060,210192000401,KEDC,903,03,7,11,1,0,1,0,0,0,0,0,0,1,0,1,0,0,0,0,0,0,9,7,16,18
20192020,035,FLEMING,171,Fleming County,060,Hillsboro Elementary School,171060,035171060,210192000401,KEDC,903,06,6,11,1,0,1,0,0,0,0,0,0,0,0,0,0,0,0,0,0,0,10,6,16,17
20192020,035,FLEMING,171,Fleming County,060,Hillsboro Elementary School,171060,035171060,210192000401,KEDC,903,04,15,8,0,0,0,0,0,0,0,0,0,0,0,0,0,0,0,0,1,1,8,14,22,23
20192020,035,FLEMING,171,Fleming County,060,Hillsboro Elementary School,171060,035171060,210192000401,KEDC,903,01,9,15,0,0,0,0,0,0,0,0,0,0,1,1,0,0,0,0,0,0,15,8,23,24
20192020,036,FLOYD,175,Floyd County,"",---District Total---,175,"","",KVEC,904,01,230,244,0,2,2,0,0,0,0,0,0,2,6,8,0,0,0,0,3,3,242,219,461,474
20192020,036,FLOYD,175,Floyd County,"",---District Total---,175,"","",KVEC,904,All Students,2602,2856,16,14,30,1,0,1,6,2,8,38,32,70,0,0,0,20,23,43,2775,2531,5306,5458
20192020,036,FLOYD,175,Floyd County,"",---District Total---,175,"","",KVEC,904,PS,141,165,0,0,0,1,0,1,0,0,0,3,1,4,0,0,0,0,4,4,161,136,297,306
20192020,036,FLOYD,175,Floyd County,"",---District Total---,175,"","",KVEC,904,KG,228,245,2,1,3,0,0,0,0,0,0,0,3,3,0,0,0,1,1,2,242,223,465,473
20192020,036,FLOYD,175,Floyd County,"",---District Total---,175,"","",KVEC,904,02,189,224,2,1,3,0,0,0,0,1,1,4,4,8,0,0,0,1,3,4,217,180,397,413
20192020,036,FLOYD,175,Floyd County,"",---District Total---,175,"","",KVEC,904,03,190,204,3,1,4,0,0,0,0,0,0,3,3,6,0,0,0,3,2,5,195,184,379,394
20192020,036,FLOYD,175,Floyd County,"",---District Total---,175,"","",KVEC,904,04,193,251,1,0,1,0,0,0,0,0,0,4,3,7,0,0,0,3,2,5,243,188,431,444
20192020,036,FLOYD,175,Floyd County,"",---District Total---,175,"","",KVEC,904,05,233,186,2,3,5,0,0,0,1,0,1,1,3,4,0,0,0,4,3,7,178,224,402,419
20192020,036,FLOYD,175,Floyd County,"",---District Total---,175,"","",KVEC,904,06,207,224,1,0,1,0,0,0,1,0,1,5,0,5,0,0,0,2,1,3,215,206,421,431
20192020,036,FLOYD,175,Floyd County,"",---District Total---,175,"","",KVEC,904,07,212,238,1,1,2,0,0,0,1,0,1,4,4,8,0,0,0,3,4,7,229,203,432,450
20192020,036,FLOYD,175,Floyd County,"",---District Total---,175,"","",KVEC,904,08,186,216,0,2,2,1,0,1,0,0,0,4,3,7,0,0,0,0,1,1,211,180,391,402
20192020,036,FLOYD,175,Floyd County,"",---District Total---,175,"","",KVEC,904,09,213,229,1,2,3,0,0,0,1,0,1,3,3,6,0,0,0,2,2,4,222,206,428,442
20192020,036,FLOYD,175,Floyd County,"",---District Total---,175,"","",KVEC,904,10,189,227,2,1,3,0,0,0,1,1,2,3,0,3,0,0,0,1,1,2,220,186,406,416
20192020,036,FLOYD,175,Floyd County,"",---District Total---,175,"","",KVEC,904,11,176,171,0,0,0,0,0,0,1,0,1,2,0,2,0,0,0,0,0,0,168,176,344,347
20192020,036,FLOYD,175,Floyd County,"",---District Total---,175,"","",KVEC,904,12,154,197,1,0,1,0,0,0,0,0,0,3,0,3,0,0,0,0,0,0,193,154,347,351
20192020,036,FLOYD,175,Floyd County,"",---District Total---,175,"","",KVEC,904,14,2,0,0,0,0,0,0,0,0,0,0,0,0,0,0,0,0,0,0,0,0,2,2,2
20192020,036,FLOYD,175,Floyd County,010,Duff-Allen Central Elementary,175010,036175010,210195002452,KVEC,904,08,49,46,0,0,0,0,0,0,0,0,0,1,1,2,0,0,0,0,1,1,45,47,92,95
20192020,036,FLOYD,175,Floyd County,010,Duff-Allen Central Elementary,175010,036175010,210195002452,KVEC,904,All Students,290,276,0,0,0,0,0,0,0,0,0,3,6,9,0,0,0,0,1,1,273,283,556,566
20192020,036,FLOYD,175,Floyd County,010,Duff-Allen Central Elementary,175010,036175010,210195002452,KVEC,904,PS,14,9,0,0,0,0,0,0,0,0,0,0,0,0,0,0,0,0,0,0,9,14,23,23
20192020,036,FLOYD,175,Floyd County,010,Duff-Allen Central Elementary,175010,036175010,210195002452,KVEC,904,KG,23,22,0,0,0,0,0,0,0,0,0,0,1,1,0,0,0,0,0,0,22,22,44,45
20192020,036,FLOYD,175,Floyd County,010,Duff-Allen Central Elementary,175010,036175010,210195002452,KVEC,904,01,27,22,0,0,0,0,0,0,0,0,0,0,1,1,0,0,0,0,0,0,22,26,48,49
20192020,036,FLOYD,175,Floyd County,010,Duff-Allen Central Elementary,175010,036175010,210195002452,KVEC,904,02,18,19,0,0,0,0,0,0,0,0,0,0,1,1,0,0,0,0,0,0,19,17,36,37
20192020,036,FLOYD,175,Floyd County,010,Duff-Allen Central Elementary,175010,036175010,210195002452,KVEC,904,03,24,13,0,0,0,0,0,0,0,0,0,0,1,1,0,0,0,0,0,0,13,23,36,37
20192020,036,FLOYD,175,Floyd County,010,Duff-Allen Central Elementary,175010,036175010,210195002452,KVEC,904,04,32,23,0,0,0,0,0,0,0,0,0,0,0,0,0,0,0,0,0,0,23,32,55,55
20192020,036,FLOYD,175,Floyd County,010,Duff-Allen Central Elementary,175010,036175010,210195002452,KVEC,904,05,21,21,0,0,0,0,0,0,0,0,0,0,0,0,0,0,0,0,0,0,21,21,42,42
20192020,036,FLOYD,175,Floyd County,010,Duff-Allen Central Elementary,175010,036175010,210195002452,KVEC,904,06,39,51,0,0,0,0,0,0,0,0,0,1,0,1,0,0,0,0,0,0,50,39,89,90
20192020,036,FLOYD,175,Floyd County,010,Duff-Allen Central Elementary,175010,036175010,210195002452,KVEC,904,07,57,59,0,0,0,0,0,0,0,0,0,1,1,2,0,0,0,0,0,0,58,56,114,116
20192020,036,FLOYD,175,Floyd County,019,Prestonsburg Elementary School,175019,036175019,210195002210,KVEC,904,04,45,67,0,0,0,0,0,0,0,0,0,1,1,2,0,0,0,1,1,2,65,43,108,112
20192020,036,FLOYD,175,Floyd County,019,Prestonsburg Elementary School,175019,036175019,210195002210,KVEC,904,All Students,307,359,0,1,1,0,0,0,0,0,0,7,8,15,0,0,0,3,4,7,349,294,643,666
20192020,036,FLOYD,175,Floyd County,019,Prestonsburg Elementary School,175019,036175019,210195002210,KVEC,904,PS,28,32,0,0,0,0,0,0,0,0,0,1,1,2,0,0,0,0,1,1,31,26,57,60
20192020,036,FLOYD,175,Floyd County,019,Prestonsburg Elementary School,175019,036175019,210195002210,KVEC,904,KG,57,64,0,0,0,0,0,0,0,0,0,0,1,1,0,0,0,0,0,0,64,56,120,121
20192020,036,FLOYD,175,Floyd County,019,Prestonsburg Elementary School,175019,036175019,210195002210,KVEC,904,01,47,71,0,0,0,0,0,0,0,0,0,2,4,6,0,0,0,0,1,1,69,42,111,118
20192020,036,FLOYD,175,Floyd County,019,Prestonsburg Elementary School,175019,036175019,210195002210,KVEC,904,02,54,62,0,0,0,0,0,0,0,0,0,3,1,4,0,0,0,0,1,1,59,52,111,116
20192020,036,FLOYD,175,Floyd County,019,Prestonsburg Elementary School,175019,036175019,210195002210,KVEC,904,03,46,49,0,0,0,0,0,0,0,0,0,1,0,1,0,0,0,2,1,3,46,45,91,95
20192020,036,FLOYD,175,Floyd County,019,Prestonsburg Elementary School,175019,036175019,210195002210,KVEC,904,05,58,46,0,1,1,0,0,0,0,0,0,0,1,1,0,0,0,0,0,0,46,56,102,104
20192020,036,FLOYD,175,Floyd County,020,Allen Elementary School,175020,036175020,210195000403,KVEC,904,07,25,27,1,1,2,0,0,0,0,0,0,0,0,0,0,0,0,1,0,1,25,24,49,52
20192020,036,FLOYD,175,Floyd County,020,Allen Elementary School,175020,036175020,210195000403,KVEC,904,All Students,244,225,3,3,6,0,0,0,2,1,3,2,1,3,0,0,0,4,2,6,214,237,451,469
20192020,036,FLOYD,175,Floyd County,020,Allen Elementary School,175020,036175020,210195000403,KVEC,904,PS,15,27,0,0,0,0,0,0,0,0,0,0,0,0,0,0,0,0,0,0,27,15,42,42
20192020,036,FLOYD,175,Floyd County,020,Allen Elementary School,175020,036175020,210195000403,KVEC,904,KG,36,29,0,0,0,0,0,0,0,0,0,0,0,0,0,0,0,1,0,1,28,36,64,65
20192020,036,FLOYD,175,Floyd County,020,Allen Elementary School,175020,036175020,210195000403,KVEC,904,01,35,22,0,1,1,0,0,0,0,0,0,0,0,0,0,0,0,0,0,0,22,34,56,57
20192020,036,FLOYD,175,Floyd County,020,Allen Elementary School,175020,036175020,210195000403,KVEC,904,02,26,19,0,0,0,0,0,0,0,1,1,0,0,0,0,0,0,0,2,2,19,23,42,45
20192020,036,FLOYD,175,Floyd County,020,Allen Elementary School,175020,036175020,210195000403,KVEC,904,03,23,27,1,0,1,0,0,0,0,0,0,0,0,0,0,0,0,0,0,0,26,23,49,50
20192020,036,FLOYD,175,Floyd County,020,Allen Elementary School,175020,036175020,210195000403,KVEC,904,04,18,30,0,0,0,0,0,0,0,0,0,2,1,3,0,0,0,0,0,0,28,17,45,48
20192020,036,FLOYD,175,Floyd County,020,Allen Elementary School,175020,036175020,210195000403,KVEC,904,05,29,24,1,0,1,0,0,0,1,0,1,0,0,0,0,0,0,1,0,1,21,29,50,53
20192020,036,FLOYD,175,Floyd County,020,Allen Elementary School,175020,036175020,210195000403,KVEC,904,06,24,27,0,0,0,0,0,0,1,0,1,0,0,0,0,0,0,1,0,1,25,24,49,51
20192020,036,FLOYD,175,Floyd County,020,Allen Elementary School,175020,036175020,210195000403,KVEC,904,08,28,20,0,1,1,0,0,0,0,0,0,0,0,0,0,0,0,0,0,0,20,27,47,48
20192020,036,FLOYD,175,Floyd County,021,May Valley Elementary School,175021,036175021,210195001426,KVEC,904,04,27,31,1,0,1,0,0,0,0,0,0,0,0,0,0,0,0,0,0,0,30,27,57,58
20192020,036,FLOYD,175,Floyd County,021,May Valley Elementary School,175021,036175021,210195001426,KVEC,904,All Students,161,167,3,2,5,0,0,0,0,0,0,3,5,8,0,0,0,0,2,2,161,152,313,328
20192020,036,FLOYD,175,Floyd County,021,May Valley Elementary School,175021,036175021,210195001426,KVEC,904,PS,20,17,0,0,0,1,0,1,0,0,0,0,0,0,0,0,0,0,0,0,16,20,36,37
20192020,036,FLOYD,175,Floyd County,021,May Valley Elementary School,175021,036175021,210195001426,KVEC,904,KG,31,38,0,0,0,0,0,0,0,0,0,0,1,1,0,0,0,0,1,1,38,29,67,69
20192020,036,FLOYD,175,Floyd County,021,May Valley Elementary School,175021,036175021,210195001426,KVEC,904,01,27,18,0,0,0,0,0,0,0,0,0,0,1,1,0,0,0,0,1,1,18,25,43,45
20192020,036,FLOYD,175,Floyd County,021,May Valley Elementary School,175021,036175021,210195001426,KVEC,904,02,22,30,1,0,1,0,0,0,0,0,0,0,1,1,0,0,0,0,0,0,29,21,50,52
20192020,036,FLOYD,175,Floyd County,021,May Valley Elementary School,175021,036175021,210195001426,KVEC,904,03,24,23,1,1,2,0,0,0,0,0,0,2,0,2,0,0,0,0,0,0,20,23,43,47
20192020,036,FLOYD,175,Floyd County,021,May Valley Elementary School,175021,036175021,210195001426,KVEC,904,05,30,27,0,1,1,0,0,0,0,0,0,1,2,3,0,0,0,0,0,0,26,27,53,57
20192020,036,FLOYD,175,Floyd County,030,South Floyd Elementary School,175030,036175030,210195002446,KVEC,904,PS,32,34,0,0,0,0,0,0,0,0,0,0,0,0,0,0,0,0,1,1,34,31,65,66
20192020,036,FLOYD,175,Floyd County,030,South Floyd Elementary School,175030,036175030,210195002446,KVEC,904,All Students,281,349,4,3,7,0,0,0,0,0,0,1,3,4,0,0,0,1,2,3,343,273,616,630
20192020,036,FLOYD,175,Floyd County,030,South Floyd Elementary School,175030,036175030,210195002446,KVEC,904,KG,31,39,0,1,1,0,0,0,0,0,0,0,0,0,0,0,0,0,0,0,39,30,69,70
20192020,036,FLOYD,175,Floyd County,030,South Floyd Elementary School,175030,036175030,210195002446,KVEC,904,01,41,46,0,1,1,0,0,0,0,0,0,0,0,0,0,0,0,0,0,0,46,40,86,87
20192020,036,FLOYD,175,Floyd County,030,South Floyd Elementary School,175030,036175030,210195002446,KVEC,904,02,33,44,1,1,2,0,0,0,0,0,0,0,1,1,0,0,0,0,0,0,43,31,74,77
20192020,036,FLOYD,175,Floyd County,030,South Floyd Elementary School,175030,036175030,210195002446,KVEC,904,03,28,42,1,0,1,0,0,0,0,0,0,0,2,2,0,0,0,0,1,1,41,25,66,70
20192020,036,FLOYD,175,Floyd County,030,South Floyd Elementary School,175030,036175030,210195002446,KVEC,904,04,29,40,0,0,0,0,0,0,0,0,0,0,0,0,0,0,0,1,0,1,39,29,68,69
20192020,036,FLOYD,175,Floyd County,030,South Floyd Elementary School,175030,036175030,210195002446,KVEC,904,05,34,31,1,0,1,0,0,0,0,0,0,0,0,0,0,0,0,0,1,1,30,33,63,65
20192020,036,FLOYD,175,Floyd County,030,South Floyd Elementary School,175030,036175030,210195002446,KVEC,904,06,37,32,1,0,1,0,0,0,0,0,0,0,0,0,0,0,0,0,0,0,31,37,68,69
20192020,036,FLOYD,175,Floyd County,030,South Floyd Elementary School,175030,036175030,210195002446,KVEC,904,07,24,35,0,0,0,0,0,0,0,0,0,0,0,0,0,0,0,0,0,0,35,24,59,59
20192020,036,FLOYD,175,Floyd County,030,South Floyd Elementary School,175030,036175030,210195002446,KVEC,904,08,24,40,0,0,0,0,0,0,0,0,0,1,0,1,0,0,0,0,0,0,39,24,63,64
20192020,036,FLOYD,175,Floyd County,050,Renaissance Learning Center,175050,036175050,210195001004,KVEC,904,All Students,0,0,0,0,0,0,0,0,0,0,0,0,0,0,0,0,0,0,0,0,0,0,0,0
20192020,036,FLOYD,175,Floyd County,050,Renaissance Learning Center,175050,036175050,210195001004,KVEC,904,10,0,0,0,0,0,0,0,0,0,0,0,0,0,0,0,0,0,0,0,0,0,0,0,0
20192020,036,FLOYD,175,Floyd County,050,Renaissance Learning Center,175050,036175050,210195001004,KVEC,904,11,0,0,0,0,0,0,0,0,0,0,0,0,0,0,0,0,0,0,0,0,0,0,0,0
20192020,036,FLOYD,175,Floyd County,050,Renaissance Learning Center,175050,036175050,210195001004,KVEC,904,12,0,0,0,0,0,0,0,0,0,0,0,0,0,0,0,0,0,0,0,0,0,0,0,0
20192020,036,FLOYD,175,Floyd County,050,Renaissance Learning Center,175050,036175050,210195001004,KVEC,904,09,0,0,0,0,0,0,0,0,0,0,0,0,0,0,0,0,0,0,0,0,0,0,0,0
20192020,036,FLOYD,175,Floyd County,110,Betsy Layne High School,175110,036175110,210195000406,KVEC,904,14,1,0,0,0,0,0,0,0,0,0,0,0,0,0,0,0,0,0,0,0,0,1,1,1
20192020,036,FLOYD,175,Floyd County,110,Betsy Layne High School,175110,036175110,210195000406,KVEC,904,12,37,51,0,0,0,0,0,0,0,0,0,1,0,1,0,0,0,0,0,0,50,37,87,88
20192020,036,FLOYD,175,Floyd County,110,Betsy Layne High School,175110,036175110,210195000406,KVEC,904,All Students,180,207,0,0,0,0,0,0,1,0,1,1,0,1,0,0,0,1,2,3,204,178,382,387
20192020,036,FLOYD,175,Floyd County,110,Betsy Layne High School,175110,036175110,210195000406,KVEC,904,09,54,56,0,0,0,0,0,0,0,0,0,0,0,0,0,0,0,1,1,2,55,53,108,110
20192020,036,FLOYD,175,Floyd County,110,Betsy Layne High School,175110,036175110,210195000406,KVEC,904,10,41,57,0,0,0,0,0,0,1,0,1,0,0,0,0,0,0,0,1,1,56,40,96,98
20192020,036,FLOYD,175,Floyd County,110,Betsy Layne High School,175110,036175110,210195000406,KVEC,904,11,47,43,0,0,0,0,0,0,0,0,0,0,0,0,0,0,0,0,0,0,43,47,90,90
20192020,036,FLOYD,175,Floyd County,115,Floyd Central High School,175115,036175115,210195002450,KVEC,904,12,77,93,1,0,1,0,0,0,0,0,0,1,0,1,0,0,0,0,0,0,91,77,168,170
20192020,036,FLOYD,175,Floyd County,115,Floyd Central High School,175115,036175115,210195002450,KVEC,904,All Students,344,352,3,3,6,0,0,0,0,0,0,5,1,6,0,0,0,0,0,0,344,340,684,696
20192020,036,FLOYD,175,Floyd County,115,Floyd Central High School,175115,036175115,210195002450,KVEC,904,09,96,98,1,2,3,0,0,0,0,0,0,1,1,2,0,0,0,0,0,0,96,93,189,194
20192020,036,FLOYD,175,Floyd County,115,Floyd Central High School,175115,036175115,210195002450,KVEC,904,10,83,95,1,1,2,0,0,0,0,0,0,2,0,2,0,0,0,0,0,0,92,82,174,178
20192020,036,FLOYD,175,Floyd County,115,Floyd Central High School,175115,036175115,210195002450,KVEC,904,11,87,66,0,0,0,0,0,0,0,0,0,1,0,1,0,0,0,0,0,0,65,87,152,153
20192020,036,FLOYD,175,Floyd County,115,Floyd Central High School,175115,036175115,210195002450,KVEC,904,14,1,0,0,0,0,0,0,0,0,0,0,0,0,0,0,0,0,0,0,0,0,1,1,1
20192020,036,FLOYD,175,Floyd County,120,Betsy Layne Elementary School,175120,036175120,210195000407,KVEC,904,06,43,36,0,0,0,0,0,0,0,0,0,0,0,0,0,0,0,0,0,0,36,43,79,79
20192020,036,FLOYD,175,Floyd County,120,Betsy Layne Elementary School,175120,036175120,210195000407,KVEC,904,08,33,30,0,0,0,0,0,0,0,0,0,0,1,1,0,0,0,0,0,0,30,32,62,63
20192020,036,FLOYD,175,Floyd County,120,Betsy Layne Elementary School,175120,036175120,210195000407,KVEC,904,All Students,303,300,1,1,2,0,0,0,0,0,0,3,2,5,0,0,0,5,6,11,291,294,585,603
20192020,036,FLOYD,175,Floyd County,120,Betsy Layne Elementary School,175120,036175120,210195000407,KVEC,904,PS,14,22,0,0,0,0,0,0,0,0,0,0,0,0,0,0,0,0,1,1,22,13,35,36
20192020,036,FLOYD,175,Floyd County,120,Betsy Layne Elementary School,175120,036175120,210195000407,KVEC,904,KG,42,31,1,0,1,0,0,0,0,0,0,0,0,0,0,0,0,0,0,0,30,42,72,73
20192020,036,FLOYD,175,Floyd County,120,Betsy Layne Elementary School,175120,036175120,210195000407,KVEC,904,01,27,35,0,0,0,0,0,0,0,0,0,0,0,0,0,0,0,0,1,1,35,26,61,62
20192020,036,FLOYD,175,Floyd County,120,Betsy Layne Elementary School,175120,036175120,210195000407,KVEC,904,02,27,36,0,0,0,0,0,0,0,0,0,1,0,1,0,0,0,1,0,1,34,27,61,63
20192020,036,FLOYD,175,Floyd County,120,Betsy Layne Elementary School,175120,036175120,210195000407,KVEC,904,03,33,38,0,0,0,0,0,0,0,0,0,0,0,0,0,0,0,1,0,1,37,33,70,71
20192020,036,FLOYD,175,Floyd County,120,Betsy Layne Elementary School,175120,036175120,210195000407,KVEC,904,04,28,38,0,0,0,0,0,0,0,0,0,0,0,0,0,0,0,1,1,2,37,27,64,66
20192020,036,FLOYD,175,Floyd County,120,Betsy Layne Elementary School,175120,036175120,210195000407,KVEC,904,05,39,19,0,1,1,0,0,0,0,0,0,0,0,0,0,0,0,1,2,3,18,36,54,58
20192020,036,FLOYD,175,Floyd County,120,Betsy Layne Elementary School,175120,036175120,210195000407,KVEC,904,07,31,37,0,0,0,0,0,0,0,0,0,2,1,3,0,0,0,1,2,3,34,28,62,68
20192020,036,FLOYD,175,Floyd County,440,James D. Adams Middle School,175440,036175440,210195001670,KVEC,904,06,50,61,0,0,0,0,0,0,0,0,0,4,0,4,0,0,0,1,1,2,56,49,105,111
20192020,036,FLOYD,175,Floyd County,440,James D. Adams Middle School,175440,036175440,210195001670,KVEC,904,08,41,61,0,1,1,1,0,1,0,0,0,2,1,3,0,0,0,0,0,0,58,39,97,102
20192020,036,FLOYD,175,Floyd County,440,James D. Adams Middle School,175440,036175440,210195001670,KVEC,904,All Students,147,184,0,1,1,1,0,1,1,0,1,7,3,10,0,0,0,2,3,5,173,140,313,331
20192020,036,FLOYD,175,Floyd County,440,James D. Adams Middle School,175440,036175440,210195001670,KVEC,904,07,56,62,0,0,0,0,0,0,1,0,1,1,2,3,0,0,0,1,2,3,59,52,111,118
20192020,036,FLOYD,175,Floyd County,485,John M. Stumbo Elementary School,175485,036175485,210195000415,KVEC,904,07,19,18,0,0,0,0,0,0,0,0,0,0,0,0,0,0,0,0,0,0,18,19,37,37
20192020,036,FLOYD,175,Floyd County,485,John M. Stumbo Elementary School,175485,036175485,210195000415,KVEC,904,All Students,135,172,1,0,1,0,0,0,0,0,0,1,1,2,0,0,0,2,0,2,168,134,302,307
20192020,036,FLOYD,175,Floyd County,485,John M. Stumbo Elementary School,175485,036175485,210195000415,KVEC,904,PS,18,24,0,0,0,0,0,0,0,0,0,2,0,2,0,0,0,0,1,1,22,17,39,42
20192020,036,FLOYD,175,Floyd County,485,John M. Stumbo Elementary School,175485,036175485,210195000415,KVEC,904,KG,8,22,1,0,1,0,0,0,0,0,0,0,0,0,0,0,0,0,0,0,21,8,29,30
20192020,036,FLOYD,175,Floyd County,485,John M. Stumbo Elementary School,175485,036175485,210195000415,KVEC,904,01,26,30,0,0,0,0,0,0,0,0,0,0,0,0,0,0,0,0,0,0,30,26,56,56
20192020,036,FLOYD,175,Floyd County,485,John M. Stumbo Elementary School,175485,036175485,210195000415,KVEC,904,02,9,14,0,0,0,0,0,0,0,0,0,0,0,0,0,0,0,0,0,0,14,9,23,23
20192020,036,FLOYD,175,Floyd County,485,John M. Stumbo Elementary School,175485,036175485,210195000415,KVEC,904,03,12,12,0,0,0,0,0,0,0,0,0,0,0,0,0,0,0,0,0,0,12,12,24,24
20192020,036,FLOYD,175,Floyd County,485,John M. Stumbo Elementary School,175485,036175485,210195000415,KVEC,904,04,14,22,0,0,0,0,0,0,0,0,0,1,1,2,0,0,0,0,0,0,21,13,34,36
20192020,036,FLOYD,175,Floyd County,485,John M. Stumbo Elementary School,175485,036175485,210195000415,KVEC,904,05,22,18,0,0,0,0,0,0,0,0,0,0,0,0,0,0,0,2,0,2,16,22,38,40
20192020,036,FLOYD,175,Floyd County,485,John M. Stumbo Elementary School,175485,036175485,210195000415,KVEC,904,06,14,17,0,0,0,0,0,0,0,0,0,0,0,0,0,0,0,0,0,0,17,14,31,31
20192020,036,FLOYD,175,Floyd County,485,John M. Stumbo Elementary School,175485,036175485,210195000415,KVEC,904,08,11,19,0,0,0,0,0,0,0,0,0,0,0,0,0,0,0,0,0,0,19,11,30,30
20192020,036,FLOYD,175,Floyd County,850,Prestonsburg High School,175850,036175850,210195000423,KVEC,904,All Students,210,265,1,0,1,0,0,0,2,1,3,5,2,7,0,0,0,2,1,3,255,206,461,475
20192020,036,FLOYD,175,Floyd County,850,Prestonsburg High School,175850,036175850,210195000423,KVEC,904,09,63,75,0,0,0,0,0,0,1,0,1,2,2,4,0,0,0,1,1,2,71,60,131,138
20192020,036,FLOYD,175,Floyd County,850,Prestonsburg High School,175850,036175850,210195000423,KVEC,904,10,65,75,1,0,1,0,0,0,0,1,1,1,0,1,0,0,0,1,0,1,72,64,136,140
20192020,036,FLOYD,175,Floyd County,850,Prestonsburg High School,175850,036175850,210195000423,KVEC,904,11,42,62,0,0,0,0,0,0,1,0,1,1,0,1,0,0,0,0,0,0,60,42,102,104
20192020,036,FLOYD,175,Floyd County,850,Prestonsburg High School,175850,036175850,210195000423,KVEC,904,12,40,53,0,0,0,0,0,0,0,0,0,1,0,1,0,0,0,0,0,0,52,40,92,93
20192020,019,CAMPBELL,176,Fort Thomas Independent,"",---District Total---,176,"","",NKCES,905,02,106,115,3,4,7,0,0,0,0,1,1,6,2,8,0,0,0,8,5,13,98,94,192,221
20192020,019,CAMPBELL,176,Fort Thomas Independent,"",---District Total---,176,"","",NKCES,905,03,111,100,1,2,3,0,0,0,1,2,3,2,2,4,0,0,0,2,3,5,94,102,196,211
20192020,019,CAMPBELL,176,Fort Thomas Independent,"",---District Total---,176,"","",NKCES,905,04,100,120,1,2,3,0,0,0,0,2,2,4,5,9,0,0,0,5,4,9,110,87,197,220
20192020,019,CAMPBELL,176,Fort Thomas Independent,"",---District Total---,176,"","",NKCES,905,05,130,114,0,0,0,1,1,2,1,3,4,4,3,7,0,0,0,7,9,16,101,114,215,244
20192020,019,CAMPBELL,176,Fort Thomas Independent,"",---District Total---,176,"","",NKCES,905,06,126,153,1,1,2,0,0,0,3,3,6,2,1,3,0,0,0,5,5,10,142,116,258,279
20192020,019,CAMPBELL,176,Fort Thomas Independent,"",---District Total---,176,"","",NKCES,905,07,123,125,3,1,4,0,0,0,3,2,5,4,7,11,0,0,0,6,5,11,109,108,217,248
20192020,019,CAMPBELL,176,Fort Thomas Independent,"",---District Total---,176,"","",NKCES,905,08,109,148,2,0,2,0,0,0,0,2,2,3,3,6,0,0,0,11,4,15,132,100,232,257
20192020,019,CAMPBELL,176,Fort Thomas Independent,"",---District Total---,176,"","",NKCES,905,09,115,134,3,1,4,0,0,0,2,1,3,3,3,6,0,0,0,4,6,10,122,104,226,249
20192020,019,CAMPBELL,176,Fort Thomas Independent,"",---District Total---,176,"","",NKCES,905,10,129,135,1,1,2,0,0,0,0,2,2,5,0,5,0,0,0,6,2,8,123,124,247,264
20192020,019,CAMPBELL,176,Fort Thomas Independent,"",---District Total---,176,"","",NKCES,905,11,135,122,1,1,2,0,0,0,3,4,7,4,3,7,1,0,1,1,0,1,112,127,239,257
20192020,019,CAMPBELL,176,Fort Thomas Independent,"",---District Total---,176,"","",NKCES,905,14,1,0,0,0,0,0,0,0,0,0,0,0,0,0,0,0,0,0,0,0,0,1,1,1
20192020,019,CAMPBELL,176,Fort Thomas Independent,"",---District Total---,176,"","",NKCES,905,12,142,104,0,1,1,0,0,0,1,5,6,1,2,3,0,0,0,2,2,4,100,132,232,246
20192020,019,CAMPBELL,176,Fort Thomas Independent,"",---District Total---,176,"","",NKCES,905,All Students,1527,1570,17,15,32,1,2,3,16,31,47,42,41,83,1,0,1,67,50,117,1426,1388,2814,3097
20192020,019,CAMPBELL,176,Fort Thomas Independent,"",---District Total---,176,"","",NKCES,905,PS,24,32,0,1,1,0,0,0,2,2,4,2,0,2,0,0,0,1,2,3,27,19,46,56
20192020,019,CAMPBELL,176,Fort Thomas Independent,"",---District Total---,176,"","",NKCES,905,KG,99,108,0,1,1,0,0,0,0,2,2,3,5,8,0,0,0,6,3,9,99,88,187,207
20192020,019,CAMPBELL,176,Fort Thomas Independent,"",---District Total---,176,"","",NKCES,905,01,101,92,1,0,1,0,1,1,2,2,4,1,5,6,0,0,0,4,2,6,84,91,175,193
20192020,019,CAMPBELL,176,Fort Thomas Independent,010,Highlands High School,176010,019176010,210204000428,NKCES,905,12,142,104,0,1,1,0,0,0,1,5,6,1,2,3,0,0,0,2,2,4,100,132,232,246
20192020,019,CAMPBELL,176,Fort Thomas Independent,010,Highlands High School,176010,019176010,210204000428,NKCES,905,All Students,522,495,5,4,9,0,0,0,6,12,18,13,8,21,1,0,1,13,10,23,457,488,945,1017
20192020,019,CAMPBELL,176,Fort Thomas Independent,010,Highlands High School,176010,019176010,210204000428,NKCES,905,09,115,134,3,1,4,0,0,0,2,1,3,3,3,6,0,0,0,4,6,10,122,104,226,249
20192020,019,CAMPBELL,176,Fort Thomas Independent,010,Highlands High School,176010,019176010,210204000428,NKCES,905,10,129,135,1,1,2,0,0,0,0,2,2,5,0,5,0,0,0,6,2,8,123,124,247,264
20192020,019,CAMPBELL,176,Fort Thomas Independent,010,Highlands High School,176010,019176010,210204000428,NKCES,905,11,135,122,1,1,2,0,0,0,3,4,7,4,3,7,1,0,1,1,0,1,112,127,239,257
20192020,019,CAMPBELL,176,Fort Thomas Independent,010,Highlands High School,176010,019176010,210204000428,NKCES,905,14,1,0,0,0,0,0,0,0,0,0,0,0,0,0,0,0,0,0,0,0,0,1,1,1
20192020,019,CAMPBELL,176,Fort Thomas Independent,011,Highlands Middle School,176011,019176011,210204001400,NKCES,905,07,123,125,3,1,4,0,0,0,3,2,5,4,7,11,0,0,0,6,5,11,109,108,217,248
20192020,019,CAMPBELL,176,Fort Thomas Independent,011,Highlands Middle School,176011,019176011,210204001400,NKCES,905,All Students,358,426,6,2,8,0,0,0,6,7,13,9,11,20,0,0,0,22,14,36,383,324,707,784
20192020,019,CAMPBELL,176,Fort Thomas Independent,011,Highlands Middle School,176011,019176011,210204001400,NKCES,905,06,126,153,1,1,2,0,0,0,3,3,6,2,1,3,0,0,0,5,5,10,142,116,258,279
20192020,019,CAMPBELL,176,Fort Thomas Independent,011,Highlands Middle School,176011,019176011,210204001400,NKCES,905,08,109,148,2,0,2,0,0,0,0,2,2,3,3,6,0,0,0,11,4,15,132,100,232,257
20192020,019,CAMPBELL,176,Fort Thomas Independent,020,Johnson Elementary School,176020,019176020,210204000429,NKCES,905,04,28,40,0,0,0,0,0,0,0,0,0,1,0,1,0,0,0,0,1,1,39,27,66,68
20192020,019,CAMPBELL,176,Fort Thomas Independent,020,Johnson Elementary School,176020,019176020,210204000429,NKCES,905,All Students,194,203,2,2,4,1,0,1,0,2,2,2,3,5,0,0,0,6,2,8,192,185,377,397
20192020,019,CAMPBELL,176,Fort Thomas Independent,020,Johnson Elementary School,176020,019176020,210204000429,NKCES,905,KG,28,31,0,0,0,0,0,0,0,1,1,0,1,1,0,0,0,2,0,2,29,26,55,59
20192020,019,CAMPBELL,176,Fort Thomas Independent,020,Johnson Elementary School,176020,019176020,210204000429,NKCES,905,01,35,28,1,0,1,0,0,0,0,0,0,0,2,2,0,0,0,0,0,0,27,33,60,63
20192020,019,CAMPBELL,176,Fort Thomas Independent,020,Johnson Elementary School,176020,019176020,210204000429,NKCES,905,02,31,34,0,1,1,0,0,0,0,1,1,0,0,0,0,0,0,3,0,3,31,29,60,65
20192020,019,CAMPBELL,176,Fort Thomas Independent,020,Johnson Elementary School,176020,019176020,210204000429,NKCES,905,03,37,34,1,1,2,0,0,0,0,0,0,0,0,0,0,0,0,0,0,0,33,36,69,71
20192020,019,CAMPBELL,176,Fort Thomas Independent,020,Johnson Elementary School,176020,019176020,210204000429,NKCES,905,05,35,36,0,0,0,1,0,1,0,0,0,1,0,1,0,0,0,1,1,2,33,34,67,71
20192020,019,CAMPBELL,176,Fort Thomas Independent,030,Moyer Elementary School,176030,019176030,210204000430,NKCES,905,04,44,51,1,1,2,0,0,0,0,2,2,2,3,5,0,0,0,4,2,6,44,36,80,95
20192020,019,CAMPBELL,176,Fort Thomas Independent,030,Moyer Elementary School,176030,019176030,210204000430,NKCES,905,All Students,273,244,3,4,7,0,1,1,4,9,13,12,15,27,0,0,0,14,16,30,211,228,439,517
20192020,019,CAMPBELL,176,Fort Thomas Independent,030,Moyer Elementary School,176030,019176030,210204000430,NKCES,905,PS,24,32,0,1,1,0,0,0,2,2,4,2,0,2,0,0,0,1,2,3,27,19,46,56
20192020,019,CAMPBELL,176,Fort Thomas Independent,030,Moyer Elementary School,176030,019176030,210204000430,NKCES,905,KG,42,43,0,1,1,0,0,0,0,1,1,2,4,6,0,0,0,3,2,5,38,34,72,85
20192020,019,CAMPBELL,176,Fort Thomas Independent,030,Moyer Elementary School,176030,019176030,210204000430,NKCES,905,01,38,36,0,0,0,0,0,0,2,2,4,0,2,2,0,0,0,1,2,3,33,32,65,74
20192020,019,CAMPBELL,176,Fort Thomas Independent,030,Moyer Elementary School,176030,019176030,210204000430,NKCES,905,02,48,48,2,2,4,0,0,0,0,0,0,4,2,6,0,0,0,3,3,6,39,41,80,96
20192020,019,CAMPBELL,176,Fort Thomas Independent,030,Moyer Elementary School,176030,019176030,210204000430,NKCES,905,03,51,32,0,0,0,0,0,0,1,2,3,2,2,4,0,0,0,1,2,3,28,45,73,83
20192020,019,CAMPBELL,176,Fort Thomas Independent,030,Moyer Elementary School,176030,019176030,210204000430,NKCES,905,05,50,34,0,0,0,0,1,1,1,2,3,2,2,4,0,0,0,2,5,7,29,40,69,84
20192020,019,CAMPBELL,176,Fort Thomas Independent,040,Woodfill Elementary School,176040,019176040,210204000431,NKCES,905,05,45,44,0,0,0,0,0,0,0,1,1,1,1,2,0,0,0,4,3,7,39,40,79,89
20192020,019,CAMPBELL,176,Fort Thomas Independent,040,Woodfill Elementary School,176040,019176040,210204000431,NKCES,905,All Students,180,202,1,3,4,0,1,1,0,1,1,6,4,10,0,0,0,12,8,20,183,163,346,382
20192020,019,CAMPBELL,176,Fort Thomas Independent,040,Woodfill Elementary School,176040,019176040,210204000431,NKCES,905,KG,29,34,0,0,0,0,0,0,0,0,0,1,0,1,0,0,0,1,1,2,32,28,60,63
20192020,019,CAMPBELL,176,Fort Thomas Independent,040,Woodfill Elementary School,176040,019176040,210204000431,NKCES,905,01,28,28,0,0,0,0,1,1,0,0,0,1,1,2,0,0,0,3,0,3,24,26,50,56
20192020,019,CAMPBELL,176,Fort Thomas Independent,040,Woodfill Elementary School,176040,019176040,210204000431,NKCES,905,02,27,33,1,1,2,0,0,0,0,0,0,2,0,2,0,0,0,2,2,4,28,24,52,60
20192020,019,CAMPBELL,176,Fort Thomas Independent,040,Woodfill Elementary School,176040,019176040,210204000431,NKCES,905,03,23,34,0,1,1,0,0,0,0,0,0,0,0,0,0,0,0,1,1,2,33,21,54,57
20192020,019,CAMPBELL,176,Fort Thomas Independent,040,Woodfill Elementary School,176040,019176040,210204000431,NKCES,905,04,28,29,0,1,1,0,0,0,0,0,0,1,2,3,0,0,0,1,1,2,27,24,51,57
20192020,037,FRANKLIN,177,Frankfort Independent,"",---District Total---,177,"","",CKEC,901,KG,34,29,5,8,13,0,0,0,0,0,0,4,2,6,0,0,0,3,2,5,17,22,39,63
20192020,037,FRANKLIN,177,Frankfort Independent,"",---District Total---,177,"","",CKEC,901,All Students,428,451,78,74,152,0,0,0,1,0,1,21,21,42,0,0,0,39,48,87,312,285,597,879
20192020,037,FRANKLIN,177,Frankfort Independent,"",---District Total---,177,"","",CKEC,901,PS,33,30,6,5,11,0,0,0,1,0,1,2,0,2,0,0,0,2,3,5,19,25,44,63
20192020,037,FRANKLIN,177,Frankfort Independent,"",---District Total---,177,"","",CKEC,901,01,31,38,3,4,7,0,0,0,1,0,1,2,1,3,0,0,0,4,4,8,28,22,50,69
20192020,037,FRANKLIN,177,Frankfort Independent,"",---District Total---,177,"","",CKEC,901,02,34,25,3,8,11,0,0,0,0,0,0,0,2,2,0,0,0,4,1,5,18,23,41,59
20192020,037,FRANKLIN,177,Frankfort Independent,"",---District Total---,177,"","",CKEC,901,03,29,28,7,7,14,0,0,0,0,0,0,1,2,3,0,0,0,5,3,8,15,17,32,57
20192020,037,FRANKLIN,177,Frankfort Independent,"",---District Total---,177,"","",CKEC,901,04,27,35,6,5,11,0,0,0,0,0,0,3,0,3,0,0,0,2,1,3,24,21,45,62
20192020,037,FRANKLIN,177,Frankfort Independent,"",---District Total---,177,"","",CKEC,901,05,31,34,7,6,13,0,0,0,0,0,0,1,3,4,0,0,0,0,5,5,26,17,43,65
20192020,037,FRANKLIN,177,Frankfort Independent,"",---District Total---,177,"","",CKEC,901,06,40,32,7,5,12,0,0,0,0,0,0,2,2,4,0,0,0,0,1,1,23,32,55,72
20192020,037,FRANKLIN,177,Frankfort Independent,"",---District Total---,177,"","",CKEC,901,07,30,41,12,3,15,0,0,0,0,0,0,3,1,4,0,0,0,2,3,5,24,23,47,71
20192020,037,FRANKLIN,177,Frankfort Independent,"",---District Total---,177,"","",CKEC,901,08,40,35,8,10,18,0,0,0,0,0,0,1,3,4,0,0,0,2,6,8,24,21,45,75
20192020,037,FRANKLIN,177,Frankfort Independent,"",---District Total---,177,"","",CKEC,901,09,40,48,10,2,12,0,0,0,0,0,0,3,4,7,0,0,0,3,8,11,32,26,58,88
20192020,037,FRANKLIN,177,Frankfort Independent,"",---District Total---,177,"","",CKEC,901,10,42,44,6,6,12,0,0,0,0,0,0,0,0,0,0,0,0,7,7,14,31,29,60,86
20192020,037,FRANKLIN,177,Frankfort Independent,"",---District Total---,177,"","",CKEC,901,11,20,41,2,3,5,0,0,0,0,0,0,1,1,2,0,0,0,5,2,7,33,14,47,61
20192020,037,FRANKLIN,177,Frankfort Independent,"",---District Total---,177,"","",CKEC,901,12,30,21,2,7,9,0,0,0,0,0,0,0,0,0,0,0,0,2,5,7,17,18,35,51
20192020,037,FRANKLIN,177,Frankfort Independent,040,Frankfort Early Learning Academy,177040,037177040,210198002334,CKEC,901,PS,33,30,6,5,11,0,0,0,1,0,1,2,0,2,0,0,0,2,3,5,19,25,44,63
20192020,037,FRANKLIN,177,Frankfort Independent,040,Frankfort Early Learning Academy,177040,037177040,210198002334,CKEC,901,All Students,0,0,0,0,0,0,0,0,0,0,0,0,0,0,0,0,0,0,0,0,0,0,0,0
20192020,037,FRANKLIN,177,Frankfort Independent,050,Second Street School,177050,037177050,210198000432,CKEC,901,All Students,296,296,58,56,114,0,0,0,1,0,1,17,16,33,0,0,0,22,26,48,198,198,396,592
20192020,037,FRANKLIN,177,Frankfort Independent,050,Second Street School,177050,037177050,210198000432,CKEC,901,KG,34,29,5,8,13,0,0,0,0,0,0,4,2,6,0,0,0,3,2,5,17,22,39,63
20192020,037,FRANKLIN,177,Frankfort Independent,050,Second Street School,177050,037177050,210198000432,CKEC,901,01,31,38,3,4,7,0,0,0,1,0,1,2,1,3,0,0,0,4,4,8,28,22,50,69
20192020,037,FRANKLIN,177,Frankfort Independent,050,Second Street School,177050,037177050,210198000432,CKEC,901,07,30,41,12,3,15,0,0,0,0,0,0,3,1,4,0,0,0,2,3,5,24,23,47,71
20192020,037,FRANKLIN,177,Frankfort Independent,050,Second Street School,177050,037177050,210198000432,CKEC,901,03,29,28,7,7,14,0,0,0,0,0,0,1,2,3,0,0,0,5,3,8,15,17,32,57
20192020,037,FRANKLIN,177,Frankfort Independent,050,Second Street School,177050,037177050,210198000432,CKEC,901,04,27,35,6,5,11,0,0,0,0,0,0,3,0,3,0,0,0,2,1,3,24,21,45,62
20192020,037,FRANKLIN,177,Frankfort Independent,050,Second Street School,177050,037177050,210198000432,CKEC,901,05,31,34,7,6,13,0,0,0,0,0,0,1,3,4,0,0,0,0,5,5,26,17,43,65
20192020,037,FRANKLIN,177,Frankfort Independent,050,Second Street School,177050,037177050,210198000432,CKEC,901,06,40,32,7,5,12,0,0,0,0,0,0,2,2,4,0,0,0,0,1,1,23,32,55,72
20192020,037,FRANKLIN,177,Frankfort Independent,050,Second Street School,177050,037177050,210198000432,CKEC,901,02,34,25,3,8,11,0,0,0,0,0,0,0,2,2,0,0,0,4,1,5,18,23,41,59
20192020,037,FRANKLIN,177,Frankfort Independent,050,Second Street School,177050,037177050,210198000432,CKEC,901,08,40,34,8,10,18,0,0,0,0,0,0,1,3,4,0,0,0,2,6,8,23,21,44,74
20192020,037,FRANKLIN,177,Frankfort Independent,070,Frankfort High School,177070,037177070,210198000433,CKEC,901,10,37,35,6,5,11,0,0,0,0,0,0,0,0,0,0,0,0,5,7,12,24,25,49,72
20192020,037,FRANKLIN,177,Frankfort Independent,070,Frankfort High School,177070,037177070,210198000433,CKEC,901,12,26,16,2,6,8,0,0,0,0,0,0,0,0,0,0,0,0,2,4,6,12,16,28,42
20192020,037,FRANKLIN,177,Frankfort Independent,070,Frankfort High School,177070,037177070,210198000433,CKEC,901,All Students,120,135,19,15,34,0,0,0,0,0,0,4,5,9,0,0,0,14,20,34,98,80,178,255
20192020,037,FRANKLIN,177,Frankfort Independent,070,Frankfort High School,177070,037177070,210198000433,CKEC,901,08,0,1,0,0,0,0,0,0,0,0,0,0,0,0,0,0,0,0,0,0,1,0,1,1
20192020,037,FRANKLIN,177,Frankfort Independent,070,Frankfort High School,177070,037177070,210198000433,CKEC,901,09,38,46,9,1,10,0,0,0,0,0,0,3,4,7,0,0,0,3,7,10,31,26,57,84
20192020,037,FRANKLIN,177,Frankfort Independent,070,Frankfort High School,177070,037177070,210198000433,CKEC,901,11,19,37,2,3,5,0,0,0,0,0,0,1,1,2,0,0,0,4,2,6,30,13,43,56
20192020,037,FRANKLIN,177,Frankfort Independent,080,Panther Transition Academy,177080,037177080,210198001524,CKEC,901,10,5,9,0,1,1,0,0,0,0,0,0,0,0,0,0,0,0,2,0,2,7,4,11,14
20192020,037,FRANKLIN,177,Frankfort Independent,080,Panther Transition Academy,177080,037177080,210198001524,CKEC,901,12,4,5,0,1,1,0,0,0,0,0,0,0,0,0,0,0,0,0,1,1,5,2,7,9
20192020,037,FRANKLIN,177,Frankfort Independent,080,Panther Transition Academy,177080,037177080,210198001524,CKEC,901,All Students,12,20,1,3,4,0,0,0,0,0,0,0,0,0,0,0,0,3,2,5,16,7,23,32
20192020,037,FRANKLIN,177,Frankfort Independent,080,Panther Transition Academy,177080,037177080,210198001524,CKEC,901,09,2,2,1,1,2,0,0,0,0,0,0,0,0,0,0,0,0,0,1,1,1,0,1,4
20192020,037,FRANKLIN,177,Frankfort Independent,080,Panther Transition Academy,177080,037177080,210198001524,CKEC,901,11,1,4,0,0,0,0,0,0,0,0,0,0,0,0,0,0,0,1,0,1,3,1,4,5
20192020,037,FRANKLIN,181,Franklin County,"",---District Total---,181,"","",OVEC,906,All Students,3002,3171,304,286,590,10,8,18,73,87,160,279,258,537,0,2,2,225,215,440,2280,2146,4426,6173
20192020,037,FRANKLIN,181,Franklin County,"",---District Total---,181,"","",OVEC,906,PS,99,157,16,11,27,1,1,2,4,1,5,16,8,24,0,0,0,18,10,28,102,68,170,256
20192020,037,FRANKLIN,181,Franklin County,"",---District Total---,181,"","",OVEC,906,KG,229,232,17,19,36,1,1,2,9,6,15,13,29,42,0,0,0,24,16,40,168,158,326,461
20192020,037,FRANKLIN,181,Franklin County,"",---District Total---,181,"","",OVEC,906,01,239,267,24,17,41,2,1,3,9,8,17,22,28,50,0,1,1,22,24,46,188,160,348,506
20192020,037,FRANKLIN,181,Franklin County,"",---District Total---,181,"","",OVEC,906,02,222,172,17,31,48,2,2,4,5,3,8,22,5,27,0,0,0,13,21,34,113,160,273,394
20192020,037,FRANKLIN,181,Franklin County,"",---District Total---,181,"","",OVEC,906,03,204,267,21,20,41,1,0,1,6,6,12,24,19,43,0,0,0,20,25,45,195,134,329,471
20192020,037,FRANKLIN,181,Franklin County,"",---District Total---,181,"","",OVEC,906,04,259,238,22,26,48,0,0,0,3,9,12,27,33,60,0,0,0,16,11,27,170,180,350,497
20192020,037,FRANKLIN,181,Franklin County,"",---District Total---,181,"","",OVEC,906,05,215,272,29,27,56,1,0,1,5,6,11,19,19,38,0,0,0,23,15,38,195,148,343,487
20192020,037,FRANKLIN,181,Franklin County,"",---District Total---,181,"","",OVEC,906,06,240,263,41,28,69,2,1,3,5,7,12,21,20,41,0,0,0,13,23,36,181,161,342,503
20192020,037,FRANKLIN,181,Franklin County,"",---District Total---,181,"","",OVEC,906,07,246,274,24,22,46,0,0,0,2,6,8,21,22,43,0,0,0,17,15,32,210,181,391,520
20192020,037,FRANKLIN,181,Franklin County,"",---District Total---,181,"","",OVEC,906,08,226,267,22,18,40,0,1,1,4,8,12,25,13,38,0,0,0,22,14,36,194,172,366,493
20192020,037,FRANKLIN,181,Franklin County,"",---District Total---,181,"","",OVEC,906,09,272,273,23,24,47,0,0,0,4,6,10,27,16,43,0,1,1,26,20,46,193,205,398,545
20192020,037,FRANKLIN,181,Franklin County,"",---District Total---,181,"","",OVEC,906,10,233,242,27,20,47,1,1,2,13,3,16,18,18,36,0,0,0,12,17,29,171,174,345,475
20192020,037,FRANKLIN,181,Franklin County,"",---District Total---,181,"","",OVEC,906,11,195,199,17,17,34,0,0,0,3,14,17,14,13,27,0,0,0,7,7,14,158,144,302,394
20192020,037,FRANKLIN,181,Franklin County,"",---District Total---,181,"","",OVEC,906,12,222,203,20,17,37,0,1,1,5,5,10,26,23,49,0,0,0,10,7,17,142,169,311,425
20192020,037,FRANKLIN,181,Franklin County,"",---District Total---,181,"","",OVEC,906,14,0,2,0,0,0,0,0,0,0,0,0,0,0,0,0,0,0,0,0,0,2,0,2,2
20192020,037,FRANKLIN,181,Franklin County,011,The Academy,181011,037181011,210201001917,OVEC,906,12,6,14,3,0,3,0,0,0,0,0,0,1,1,2,0,0,0,2,1,3,8,4,12,20
20192020,037,FRANKLIN,181,Franklin County,011,The Academy,181011,037181011,210201001917,OVEC,906,All Students,17,54,7,0,7,0,1,1,0,0,0,5,2,7,0,0,0,7,1,8,35,13,48,71
20192020,037,FRANKLIN,181,Franklin County,011,The Academy,181011,037181011,210201001917,OVEC,906,06,0,2,1,0,1,0,0,0,0,0,0,0,0,0,0,0,0,0,0,0,1,0,1,2
20192020,037,FRANKLIN,181,Franklin County,011,The Academy,181011,037181011,210201001917,OVEC,906,07,1,6,1,0,1,0,0,0,0,0,0,0,0,0,0,0,0,0,0,0,5,1,6,7
20192020,037,FRANKLIN,181,Franklin County,011,The Academy,181011,037181011,210201001917,OVEC,906,08,1,5,0,0,0,0,0,0,0,0,0,1,0,1,0,0,0,1,0,1,3,1,4,6
20192020,037,FRANKLIN,181,Franklin County,011,The Academy,181011,037181011,210201001917,OVEC,906,09,2,12,1,0,1,0,0,0,0,0,0,2,0,2,0,0,0,2,0,2,7,2,9,14
20192020,037,FRANKLIN,181,Franklin County,011,The Academy,181011,037181011,210201001917,OVEC,906,10,5,7,1,0,1,0,1,1,0,0,0,1,0,1,0,0,0,1,0,1,4,4,8,12
20192020,037,FRANKLIN,181,Franklin County,011,The Academy,181011,037181011,210201001917,OVEC,906,11,2,8,0,0,0,0,0,0,0,0,0,0,1,1,0,0,0,1,0,1,7,1,8,10
20192020,037,FRANKLIN,181,Franklin County,012,Franklin County Career and Technical Ctr,181012,037181012,210201002055,OVEC,906,11,0,0,0,0,0,0,0,0,0,0,0,0,0,0,0,0,0,0,0,0,0,0,0,0
20192020,037,FRANKLIN,181,Franklin County,012,Franklin County Career and Technical Ctr,181012,037181012,210201002055,OVEC,906,All Students,0,0,0,0,0,0,0,0,0,0,0,0,0,0,0,0,0,0,0,0,0,0,0,0
20192020,037,FRANKLIN,181,Franklin County,012,Franklin County Career and Technical Ctr,181012,037181012,210201002055,OVEC,906,09,0,0,0,0,0,0,0,0,0,0,0,0,0,0,0,0,0,0,0,0,0,0,0,0
20192020,037,FRANKLIN,181,Franklin County,012,Franklin County Career and Technical Ctr,181012,037181012,210201002055,OVEC,906,10,0,0,0,0,0,0,0,0,0,0,0,0,0,0,0,0,0,0,0,0,0,0,0,0
20192020,037,FRANKLIN,181,Franklin County,012,Franklin County Career and Technical Ctr,181012,037181012,210201002055,OVEC,906,12,0,0,0,0,0,0,0,0,0,0,0,0,0,0,0,0,0,0,0,0,0,0,0,0
20192020,037,FRANKLIN,181,Franklin County,013,Westridge Elementary,181013,037181013,210201001989,OVEC,906,04,32,31,1,2,3,0,0,0,0,0,0,0,1,1,0,0,0,3,2,5,27,27,54,63
20192020,037,FRANKLIN,181,Franklin County,013,Westridge Elementary,181013,037181013,210201001989,OVEC,906,All Students,183,182,9,12,21,3,1,4,5,3,8,11,8,19,0,1,1,10,13,23,144,145,289,365
20192020,037,FRANKLIN,181,Franklin County,013,Westridge Elementary,181013,037181013,210201001989,OVEC,906,PS,15,23,1,1,2,1,0,1,1,1,2,1,0,1,0,0,0,1,1,2,18,12,30,38
20192020,037,FRANKLIN,181,Franklin County,013,Westridge Elementary,181013,037181013,210201001989,OVEC,906,KG,18,22,1,2,3,0,0,0,0,2,2,1,1,2,0,0,0,1,2,3,19,11,30,40
20192020,037,FRANKLIN,181,Franklin County,013,Westridge Elementary,181013,037181013,210201001989,OVEC,906,01,31,38,4,1,5,0,0,0,1,0,1,5,1,6,0,1,1,0,0,0,28,28,56,69
20192020,037,FRANKLIN,181,Franklin County,013,Westridge Elementary,181013,037181013,210201001989,OVEC,906,02,29,15,0,1,1,2,1,3,2,0,2,0,0,0,0,0,0,1,3,4,10,24,34,44
20192020,037,FRANKLIN,181,Franklin County,013,Westridge Elementary,181013,037181013,210201001989,OVEC,906,03,35,44,1,1,2,1,0,1,2,0,2,3,2,5,0,0,0,3,3,6,34,29,63,79
20192020,037,FRANKLIN,181,Franklin County,013,Westridge Elementary,181013,037181013,210201001989,OVEC,906,05,38,32,2,5,7,0,0,0,0,1,1,2,3,5,0,0,0,2,3,5,26,26,52,70
20192020,037,FRANKLIN,181,Franklin County,014,Bridgeport Elementary School,181014,037181014,210201001990,OVEC,906,04,42,47,3,3,6,0,0,0,3,2,5,1,3,4,0,0,0,3,2,5,37,32,69,89
20192020,037,FRANKLIN,181,Franklin County,014,Bridgeport Elementary School,181014,037181014,210201001990,OVEC,906,All Students,210,228,11,18,29,1,1,2,20,9,29,15,10,25,0,0,0,14,17,31,167,155,322,438
20192020,037,FRANKLIN,181,Franklin County,014,Bridgeport Elementary School,181014,037181014,210201001990,OVEC,906,PS,15,23,2,1,3,0,1,1,1,0,1,3,0,3,0,0,0,4,4,8,13,9,22,38
20192020,037,FRANKLIN,181,Franklin County,014,Bridgeport Elementary School,181014,037181014,210201001990,OVEC,906,KG,33,40,0,2,2,0,1,1,8,2,10,0,0,0,0,0,0,1,1,2,31,27,58,73
20192020,037,FRANKLIN,181,Franklin County,014,Bridgeport Elementary School,181014,037181014,210201001990,OVEC,906,01,42,36,0,2,2,0,0,0,3,1,4,0,2,2,0,0,0,2,6,8,31,31,62,78
20192020,037,FRANKLIN,181,Franklin County,014,Bridgeport Elementary School,181014,037181014,210201001990,OVEC,906,02,35,29,1,3,4,0,0,0,3,2,5,9,1,10,0,0,0,1,3,4,15,26,41,64
20192020,037,FRANKLIN,181,Franklin County,014,Bridgeport Elementary School,181014,037181014,210201001990,OVEC,906,03,26,37,3,4,7,0,0,0,2,1,3,2,2,4,0,0,0,3,2,5,27,17,44,63
20192020,037,FRANKLIN,181,Franklin County,014,Bridgeport Elementary School,181014,037181014,210201001990,OVEC,906,05,32,39,4,4,8,1,0,1,1,1,2,3,2,5,0,0,0,4,3,7,26,22,48,71
20192020,037,FRANKLIN,181,Franklin County,015,Bondurant Middle School,181015,037181015,210201000435,OVEC,906,07,118,103,5,8,13,0,0,0,2,5,7,7,11,18,0,0,0,5,3,8,84,91,175,221
20192020,037,FRANKLIN,181,Franklin County,015,Bondurant Middle School,181015,037181015,210201000435,OVEC,906,All Students,336,330,18,20,38,1,2,3,7,15,22,23,24,47,0,0,0,21,17,38,260,258,518,666
20192020,037,FRANKLIN,181,Franklin County,015,Bondurant Middle School,181015,037181015,210201000435,OVEC,906,06,116,112,7,7,14,1,1,2,3,6,9,10,8,18,0,0,0,4,9,13,87,85,172,228
20192020,037,FRANKLIN,181,Franklin County,015,Bondurant Middle School,181015,037181015,210201000435,OVEC,906,08,102,115,6,5,11,0,1,1,2,4,6,6,5,11,0,0,0,12,5,17,89,82,171,217
20192020,037,FRANKLIN,181,Franklin County,016,Early Learning Village,181016,037181016,210201002219,OVEC,906,PS,55,87,12,8,20,0,0,0,2,0,2,8,6,14,0,0,0,9,4,13,56,37,93,142
20192020,037,FRANKLIN,181,Franklin County,016,Early Learning Village,181016,037181016,210201002219,OVEC,906,All Students,138,126,13,13,26,0,0,0,0,2,2,7,22,29,0,0,0,16,11,27,90,90,180,264
20192020,037,FRANKLIN,181,Franklin County,016,Early Learning Village,181016,037181016,210201002219,OVEC,906,KG,138,126,13,13,26,0,0,0,0,2,2,7,22,29,0,0,0,16,11,27,90,90,180,264
20192020,037,FRANKLIN,181,Franklin County,025,Collins Lane,181025,037181025,210201000437,OVEC,906,02,41,24,6,5,11,0,0,0,0,0,0,2,0,2,0,0,0,1,3,4,15,33,48,65
20192020,037,FRANKLIN,181,Franklin County,025,Collins Lane,181025,037181025,210201000437,OVEC,906,All Students,237,256,22,14,36,1,0,1,5,7,12,31,31,62,0,0,0,23,13,36,174,172,346,493
20192020,037,FRANKLIN,181,Franklin County,025,Collins Lane,181025,037181025,210201000437,OVEC,906,PS,14,24,1,1,2,0,0,0,0,0,0,4,2,6,0,0,0,4,1,5,15,10,25,38
20192020,037,FRANKLIN,181,Franklin County,025,Collins Lane,181025,037181025,210201000437,OVEC,906,KG,40,44,3,2,5,1,0,1,1,0,1,5,6,11,0,0,0,6,2,8,28,30,58,84
20192020,037,FRANKLIN,181,Franklin County,025,Collins Lane,181025,037181025,210201000437,OVEC,906,01,38,50,4,2,6,0,0,0,1,2,3,5,8,13,0,0,0,5,2,7,35,24,59,88
20192020,037,FRANKLIN,181,Franklin County,025,Collins Lane,181025,037181025,210201000437,OVEC,906,03,30,50,0,2,2,0,0,0,1,1,2,5,2,7,0,0,0,4,2,6,40,23,63,80
20192020,037,FRANKLIN,181,Franklin County,025,Collins Lane,181025,037181025,210201000437,OVEC,906,04,54,43,7,1,8,0,0,0,0,2,2,10,12,22,0,0,0,4,2,6,22,37,59,97
20192020,037,FRANKLIN,181,Franklin County,025,Collins Lane,181025,037181025,210201000437,OVEC,906,05,34,45,2,2,4,0,0,0,2,2,4,4,3,7,0,0,0,3,2,5,34,25,59,79
20192020,037,FRANKLIN,181,Franklin County,030,Elkhorn Middle School,181030,037181030,210201000438,OVEC,906,06,124,149,33,21,54,1,0,1,2,1,3,11,12,23,0,0,0,9,14,23,93,76,169,273
20192020,037,FRANKLIN,181,Franklin County,030,Elkhorn Middle School,181030,037181030,210201000438,OVEC,906,07,127,165,18,14,32,0,0,0,0,1,1,14,11,25,0,0,0,12,12,24,121,89,210,292
20192020,037,FRANKLIN,181,Franklin County,030,Elkhorn Middle School,181030,037181030,210201000438,OVEC,906,08,120,145,16,13,29,0,0,0,2,4,6,18,8,26,0,0,0,9,9,18,100,86,186,265
20192020,037,FRANKLIN,181,Franklin County,030,Elkhorn Middle School,181030,037181030,210201000438,OVEC,906,All Students,371,459,67,48,115,1,0,1,4,6,10,43,31,74,0,0,0,30,35,65,314,251,565,830
20192020,037,FRANKLIN,181,Franklin County,035,Elkhorn Elementary School,181035,037181035,210201000439,OVEC,906,03,33,47,7,6,13,0,0,0,0,0,0,5,7,12,0,0,0,3,6,9,32,14,46,80
20192020,037,FRANKLIN,181,Franklin County,035,Elkhorn Elementary School,181035,037181035,210201000439,OVEC,906,05,29,55,9,6,15,0,0,0,1,1,2,7,3,10,0,0,0,7,2,9,31,17,48,84
20192020,037,FRANKLIN,181,Franklin County,035,Elkhorn Elementary School,181035,037181035,210201000439,OVEC,906,04,39,41,4,5,9,0,0,0,0,1,1,9,8,17,0,0,0,3,2,5,25,23,48,80
20192020,037,FRANKLIN,181,Franklin County,035,Elkhorn Elementary School,181035,037181035,210201000439,OVEC,906,All Students,188,213,31,33,64,1,1,2,2,3,5,32,29,61,0,0,0,21,23,44,126,99,225,401
20192020,037,FRANKLIN,181,Franklin County,035,Elkhorn Elementary School,181035,037181035,210201000439,OVEC,906,01,41,39,6,5,11,1,0,1,1,1,2,6,9,15,0,0,0,4,6,10,21,20,41,80
20192020,037,FRANKLIN,181,Franklin County,035,Elkhorn Elementary School,181035,037181035,210201000439,OVEC,906,02,46,31,5,11,16,0,1,1,0,0,0,5,2,7,0,0,0,4,7,11,17,25,42,77
20192020,037,FRANKLIN,181,Franklin County,040,Franklin County High School,181040,037181040,210201000440,OVEC,906,12,113,89,8,13,21,0,0,0,2,2,4,12,12,24,0,0,0,4,6,10,63,80,143,202
20192020,037,FRANKLIN,181,Franklin County,040,Franklin County High School,181040,037181040,210201000440,OVEC,906,All Students,484,429,55,58,113,0,0,0,9,10,19,50,37,87,0,0,0,32,29,61,283,350,633,913
20192020,037,FRANKLIN,181,Franklin County,040,Franklin County High School,181040,037181040,210201000440,OVEC,906,09,154,149,16,16,32,0,0,0,0,1,1,17,9,26,0,0,0,18,12,30,98,116,214,303
20192020,037,FRANKLIN,181,Franklin County,040,Franklin County High School,181040,037181040,210201000440,OVEC,906,10,111,110,19,15,34,0,0,0,5,1,6,12,8,20,0,0,0,6,6,12,68,81,149,221
20192020,037,FRANKLIN,181,Franklin County,040,Franklin County High School,181040,037181040,210201000440,OVEC,906,11,106,79,12,14,26,0,0,0,2,6,8,9,8,17,0,0,0,4,5,9,52,73,125,185
20192020,037,FRANKLIN,181,Franklin County,040,Franklin County High School,181040,037181040,210201000440,OVEC,906,14,0,2,0,0,0,0,0,0,0,0,0,0,0,0,0,0,0,0,0,0,2,0,2,2
20192020,037,FRANKLIN,181,Franklin County,045,Hearn Elementary,181045,037181045,210201000441,OVEC,906,04,56,36,4,12,16,0,0,0,0,3,3,4,7,11,0,0,0,2,0,2,26,34,60,92
20192020,037,FRANKLIN,181,Franklin County,045,Hearn Elementary,181045,037181045,210201000441,OVEC,906,All Students,223,215,22,28,50,1,1,2,4,10,14,18,24,42,0,0,0,17,20,37,153,140,293,438
20192020,037,FRANKLIN,181,Franklin County,045,Hearn Elementary,181045,037181045,210201000441,OVEC,906,01,50,50,7,3,10,1,1,2,2,2,4,3,6,9,0,0,0,3,7,10,34,31,65,100
20192020,037,FRANKLIN,181,Franklin County,045,Hearn Elementary,181045,037181045,210201000441,OVEC,906,02,29,30,2,3,5,0,0,0,0,1,1,3,2,5,0,0,0,3,2,5,22,21,43,59
20192020,037,FRANKLIN,181,Franklin County,045,Hearn Elementary,181045,037181045,210201000441,OVEC,906,03,40,50,4,4,8,0,0,0,1,3,4,6,3,9,0,0,0,5,7,12,34,23,57,90
20192020,037,FRANKLIN,181,Franklin County,045,Hearn Elementary,181045,037181045,210201000441,OVEC,906,05,48,49,5,6,11,0,0,0,1,1,2,2,6,8,0,0,0,4,4,8,37,31,68,97
20192020,037,FRANKLIN,181,Franklin County,050,Peaks Mill Elementary,181050,037181050,210201000442,OVEC,906,04,36,40,3,3,6,0,0,0,0,1,1,3,2,5,0,0,0,1,3,4,33,27,60,76
20192020,037,FRANKLIN,181,Franklin County,050,Peaks Mill Elementary,181050,037181050,210201000442,OVEC,906,All Students,189,228,22,22,44,0,0,0,1,4,5,13,9,22,0,0,0,17,15,32,175,139,314,417
20192020,037,FRANKLIN,181,Franklin County,050,Peaks Mill Elementary,181050,037181050,210201000442,OVEC,906,01,37,54,3,4,7,0,0,0,1,2,3,3,2,5,0,0,0,8,3,11,39,26,65,91
20192020,037,FRANKLIN,181,Franklin County,050,Peaks Mill Elementary,181050,037181050,210201000442,OVEC,906,02,42,43,3,8,11,0,0,0,0,0,0,3,0,3,0,0,0,3,3,6,34,31,65,85
20192020,037,FRANKLIN,181,Franklin County,050,Peaks Mill Elementary,181050,037181050,210201000442,OVEC,906,03,40,39,6,3,9,0,0,0,0,1,1,3,3,6,0,0,0,2,5,7,28,28,56,79
20192020,037,FRANKLIN,181,Franklin County,050,Peaks Mill Elementary,181050,037181050,210201000442,OVEC,906,05,34,52,7,4,11,0,0,0,0,0,0,1,2,3,0,0,0,3,1,4,41,27,68,86
20192020,037,FRANKLIN,181,Franklin County,070,Western Hills High School,181070,037181070,210201001420,OVEC,906,11,87,112,5,3,8,0,0,0,1,8,9,5,4,9,0,0,0,2,2,4,99,70,169,199
20192020,037,FRANKLIN,181,Franklin County,070,Western Hills High School,181070,037181070,210201001420,OVEC,906,All Students,395,420,25,17,42,1,1,2,16,18,34,23,27,50,0,1,1,15,20,35,340,311,651,815
20192020,037,FRANKLIN,181,Franklin County,070,Western Hills High School,181070,037181070,210201001420,OVEC,906,08,0,2,0,0,0,0,0,0,0,0,0,0,0,0,0,0,0,0,0,0,2,0,2,2
20192020,037,FRANKLIN,181,Franklin County,070,Western Hills High School,181070,037181070,210201001420,OVEC,906,09,114,112,6,8,14,0,0,0,4,5,9,8,7,15,0,1,1,6,7,13,88,86,174,226
20192020,037,FRANKLIN,181,Franklin County,070,Western Hills High School,181070,037181070,210201001420,OVEC,906,10,112,124,7,4,11,1,0,1,8,2,10,5,10,15,0,0,0,5,11,16,98,85,183,236
20192020,037,FRANKLIN,181,Franklin County,070,Western Hills High School,181070,037181070,210201001420,OVEC,906,12,82,70,7,2,9,0,1,1,3,3,6,5,6,11,0,0,0,2,0,2,53,70,123,152
20192020,037,FRANKLIN,181,Franklin County,072,William Cofield High School,181072,037181072,210201002471,OVEC,906,09,2,0,0,0,0,0,0,0,0,0,0,0,0,0,0,0,0,0,1,1,0,1,1,2
20192020,037,FRANKLIN,181,Franklin County,072,William Cofield High School,181072,037181072,210201002471,OVEC,906,All Students,31,31,2,3,5,0,0,0,0,0,0,8,4,12,0,0,0,2,1,3,19,23,42,62
20192020,037,FRANKLIN,181,Franklin County,072,William Cofield High School,181072,037181072,210201002471,OVEC,906,12,21,30,2,2,4,0,0,0,0,0,0,8,4,12,0,0,0,2,0,2,18,15,33,51
20192020,037,FRANKLIN,181,Franklin County,072,William Cofield High School,181072,037181072,210201002471,OVEC,906,08,3,0,0,0,0,0,0,0,0,0,0,0,0,0,0,0,0,0,0,0,0,3,3,3
20192020,037,FRANKLIN,181,Franklin County,072,William Cofield High School,181072,037181072,210201002471,OVEC,906,10,5,1,0,1,1,0,0,0,0,0,0,0,0,0,0,0,0,0,0,0,1,4,5,6
20192020,038,FULTON,185,Fulton County,"",---District Total---,185,"","",WKEC,908,All Students,273,300,90,82,172,1,2,3,2,0,2,5,9,14,0,0,0,23,22,45,179,158,337,573
20192020,038,FULTON,185,Fulton County,"",---District Total---,185,"","",WKEC,908,PS,44,32,15,10,25,0,1,1,0,0,0,0,0,0,0,0,0,0,6,6,17,27,44,76
20192020,038,FULTON,185,Fulton County,"",---District Total---,185,"","",WKEC,908,KG,24,27,8,4,12,0,1,1,0,0,0,0,0,0,0,0,0,3,2,5,16,17,33,51
20192020,038,FULTON,185,Fulton County,"",---District Total---,185,"","",WKEC,908,01,20,29,9,7,16,0,1,1,0,0,0,0,1,1,0,0,0,3,4,7,17,7,24,49
20192020,038,FULTON,185,Fulton County,"",---District Total---,185,"","",WKEC,908,02,17,19,3,5,8,0,0,0,0,0,0,2,1,3,0,0,0,0,2,2,14,9,23,36
20192020,038,FULTON,185,Fulton County,"",---District Total---,185,"","",WKEC,908,03,22,21,5,8,13,0,0,0,0,0,0,0,0,0,0,0,0,2,1,3,14,13,27,43
20192020,038,FULTON,185,Fulton County,"",---District Total---,185,"","",WKEC,908,04,20,25,11,6,17,0,0,0,0,0,0,0,0,0,0,0,0,1,1,2,13,13,26,45
20192020,038,FULTON,185,Fulton County,"",---District Total---,185,"","",WKEC,908,05,21,18,2,3,5,0,0,0,0,0,0,1,1,2,0,0,0,1,2,3,14,15,29,39
20192020,038,FULTON,185,Fulton County,"",---District Total---,185,"","",WKEC,908,06,25,25,8,9,17,1,0,1,0,0,0,0,0,0,0,0,0,1,2,3,15,14,29,50
20192020,038,FULTON,185,Fulton County,"",---District Total---,185,"","",WKEC,908,07,27,25,10,5,15,0,0,0,0,0,0,0,2,2,0,0,0,1,5,6,14,15,29,52
20192020,038,FULTON,185,Fulton County,"",---District Total---,185,"","",WKEC,908,08,25,17,4,10,14,0,0,0,1,0,1,0,2,2,0,0,0,4,2,6,8,11,19,42
20192020,038,FULTON,185,Fulton County,"",---District Total---,185,"","",WKEC,908,09,17,27,9,7,16,0,0,0,0,0,0,0,0,0,0,0,0,4,0,4,14,10,24,44
20192020,038,FULTON,185,Fulton County,"",---District Total---,185,"","",WKEC,908,10,20,20,9,7,16,0,0,0,0,0,0,0,1,1,0,0,0,1,0,1,10,12,22,40
20192020,038,FULTON,185,Fulton County,"",---District Total---,185,"","",WKEC,908,11,16,30,5,4,9,0,0,0,1,0,1,2,1,3,0,0,0,1,0,1,21,11,32,46
20192020,038,FULTON,185,Fulton County,"",---District Total---,185,"","",WKEC,908,12,19,17,7,7,14,0,0,0,0,0,0,0,0,0,0,0,0,1,1,2,9,11,20,36
20192020,038,FULTON,185,Fulton County,015,Fulton County Middle School,185015,038185015,210210002467,WKEC,908,05,21,18,2,3,5,0,0,0,0,0,0,1,1,2,0,0,0,1,2,3,14,15,29,39
20192020,038,FULTON,185,Fulton County,015,Fulton County Middle School,185015,038185015,210210002467,WKEC,908,06,25,25,8,9,17,1,0,1,0,0,0,0,0,0,0,0,0,1,2,3,15,14,29,50
20192020,038,FULTON,185,Fulton County,015,Fulton County Middle School,185015,038185015,210210002467,WKEC,908,07,27,25,10,5,15,0,0,0,0,0,0,0,2,2,0,0,0,1,5,6,14,15,29,52
20192020,038,FULTON,185,Fulton County,015,Fulton County Middle School,185015,038185015,210210002467,WKEC,908,08,25,17,4,10,14,0,0,0,1,0,1,0,2,2,0,0,0,4,2,6,8,11,19,42
20192020,038,FULTON,185,Fulton County,015,Fulton County Middle School,185015,038185015,210210002467,WKEC,908,All Students,98,85,24,27,51,1,0,1,1,0,1,1,5,6,0,0,0,7,11,18,51,55,106,183
20192020,038,FULTON,185,Fulton County,020,Fulton County Elementary,185020,038185020,210210002113,WKEC,908,02,17,19,3,5,8,0,0,0,0,0,0,2,1,3,0,0,0,0,2,2,14,9,23,36
20192020,038,FULTON,185,Fulton County,020,Fulton County Elementary,185020,038185020,210210002113,WKEC,908,04,20,25,11,6,17,0,0,0,0,0,0,0,0,0,0,0,0,1,1,2,13,13,26,45
20192020,038,FULTON,185,Fulton County,020,Fulton County Elementary,185020,038185020,210210002113,WKEC,908,03,22,21,5,8,13,0,0,0,0,0,0,0,0,0,0,0,0,2,1,3,14,13,27,43
20192020,038,FULTON,185,Fulton County,020,Fulton County Elementary,185020,038185020,210210002113,WKEC,908,All Students,103,121,36,30,66,0,2,2,0,0,0,2,2,4,0,0,0,9,10,19,74,59,133,224
20192020,038,FULTON,185,Fulton County,020,Fulton County Elementary,185020,038185020,210210002113,WKEC,908,PS,44,32,15,10,25,0,1,1,0,0,0,0,0,0,0,0,0,0,6,6,17,27,44,76
20192020,038,FULTON,185,Fulton County,020,Fulton County Elementary,185020,038185020,210210002113,WKEC,908,KG,24,27,8,4,12,0,1,1,0,0,0,0,0,0,0,0,0,3,2,5,16,17,33,51
20192020,038,FULTON,185,Fulton County,020,Fulton County Elementary,185020,038185020,210210002113,WKEC,908,01,20,29,9,7,16,0,1,1,0,0,0,0,1,1,0,0,0,3,4,7,17,7,24,49
20192020,038,FULTON,185,Fulton County,030,Fulton County High School,185030,038185030,210210000445,WKEC,908,11,16,30,5,4,9,0,0,0,1,0,1,2,1,3,0,0,0,1,0,1,21,11,32,46
20192020,038,FULTON,185,Fulton County,030,Fulton County High School,185030,038185030,210210000445,WKEC,908,All Students,72,94,30,25,55,0,0,0,1,0,1,2,2,4,0,0,0,7,1,8,54,44,98,166
20192020,038,FULTON,185,Fulton County,030,Fulton County High School,185030,038185030,210210000445,WKEC,908,09,17,27,9,7,16,0,0,0,0,0,0,0,0,0,0,0,0,4,0,4,14,10,24,44
20192020,038,FULTON,185,Fulton County,030,Fulton County High School,185030,038185030,210210000445,WKEC,908,10,20,20,9,7,16,0,0,0,0,0,0,0,1,1,0,0,0,1,0,1,10,12,22,40
20192020,038,FULTON,185,Fulton County,030,Fulton County High School,185030,038185030,210210000445,WKEC,908,12,19,17,7,7,14,0,0,0,0,0,0,0,0,0,0,0,0,1,1,2,9,11,20,36
20192020,038,FULTON,186,Fulton Independent,"",---District Total---,186,"","",WKEC,908,11,15,10,5,9,14,0,0,0,0,1,1,0,2,2,0,0,0,2,1,3,3,2,5,25
20192020,038,FULTON,186,Fulton Independent,"",---District Total---,186,"","",WKEC,908,All Students,125,145,53,58,111,0,0,0,1,2,3,6,7,13,1,0,1,19,19,38,65,39,104,270
20192020,038,FULTON,186,Fulton Independent,"",---District Total---,186,"","",WKEC,908,PS,15,17,4,6,10,1,0,1,0,0,0,0,0,0,0,0,0,3,5,8,9,4,13,32
20192020,038,FULTON,186,Fulton Independent,"",---District Total---,186,"","",WKEC,908,KG,10,13,4,4,8,0,0,0,0,0,0,2,0,2,0,0,0,2,3,5,5,3,8,23
20192020,038,FULTON,186,Fulton Independent,"",---District Total---,186,"","",WKEC,908,01,9,13,4,4,8,0,0,0,0,0,0,0,0,0,1,0,1,0,1,1,8,4,12,22
20192020,038,FULTON,186,Fulton Independent,"",---District Total---,186,"","",WKEC,908,02,8,12,2,3,5,0,0,0,0,0,0,1,1,2,0,0,0,3,3,6,6,1,7,20
20192020,038,FULTON,186,Fulton Independent,"",---District Total---,186,"","",WKEC,908,03,7,10,5,2,7,0,0,0,0,0,0,0,0,0,0,0,0,1,3,4,4,2,6,17
20192020,038,FULTON,186,Fulton Independent,"",---District Total---,186,"","",WKEC,908,04,12,18,9,4,13,0,0,0,0,0,0,0,0,0,0,0,0,2,4,6,7,4,11,30
20192020,038,FULTON,186,Fulton Independent,"",---District Total---,186,"","",WKEC,908,05,9,14,4,5,9,0,0,0,0,0,0,0,2,2,0,0,0,1,0,1,9,2,11,23
20192020,038,FULTON,186,Fulton Independent,"",---District Total---,186,"","",WKEC,908,06,14,12,5,7,12,0,0,0,0,1,1,0,1,1,0,0,0,3,2,5,4,3,7,26
20192020,038,FULTON,186,Fulton Independent,"",---District Total---,186,"","",WKEC,908,07,4,9,5,1,6,0,0,0,0,0,0,0,0,0,0,0,0,1,1,2,3,2,5,13
20192020,038,FULTON,186,Fulton Independent,"",---District Total---,186,"","",WKEC,908,08,10,6,1,3,4,0,0,0,0,0,0,0,1,1,0,0,0,2,0,2,3,6,9,16
20192020,038,FULTON,186,Fulton Independent,"",---District Total---,186,"","",WKEC,908,09,11,8,1,7,8,0,0,0,0,0,0,1,0,1,0,0,0,0,1,1,6,3,9,19
20192020,038,FULTON,186,Fulton Independent,"",---District Total---,186,"","",WKEC,908,10,8,8,1,5,6,0,0,0,1,0,1,2,0,2,0,0,0,2,0,2,2,3,5,16
20192020,038,FULTON,186,Fulton Independent,"",---District Total---,186,"","",WKEC,908,12,8,12,7,4,11,0,0,0,0,0,0,0,0,0,0,0,0,0,0,0,5,4,9,20
20192020,038,FULTON,186,Fulton Independent,018,Fulton Independent School,186018,038186018,210207002205,WKEC,908,08,10,6,1,3,4,0,0,0,0,0,0,0,1,1,0,0,0,2,0,2,3,6,9,16
20192020,038,FULTON,186,Fulton Independent,018,Fulton Independent School,186018,038186018,210207002205,WKEC,908,All Students,125,145,53,58,111,0,0,0,1,2,3,6,7,13,1,0,1,19,19,38,65,39,104,270
20192020,038,FULTON,186,Fulton Independent,018,Fulton Independent School,186018,038186018,210207002205,WKEC,908,PS,15,17,4,6,10,1,0,1,0,0,0,0,0,0,0,0,0,3,5,8,9,4,13,32
20192020,038,FULTON,186,Fulton Independent,018,Fulton Independent School,186018,038186018,210207002205,WKEC,908,KG,10,13,4,4,8,0,0,0,0,0,0,2,0,2,0,0,0,2,3,5,5,3,8,23
20192020,038,FULTON,186,Fulton Independent,018,Fulton Independent School,186018,038186018,210207002205,WKEC,908,01,9,13,4,4,8,0,0,0,0,0,0,0,0,0,1,0,1,0,1,1,8,4,12,22
20192020,038,FULTON,186,Fulton Independent,018,Fulton Independent School,186018,038186018,210207002205,WKEC,908,02,8,12,2,3,5,0,0,0,0,0,0,1,1,2,0,0,0,3,3,6,6,1,7,20
20192020,038,FULTON,186,Fulton Independent,018,Fulton Independent School,186018,038186018,210207002205,WKEC,908,03,7,10,5,2,7,0,0,0,0,0,0,0,0,0,0,0,0,1,3,4,4,2,6,17
20192020,038,FULTON,186,Fulton Independent,018,Fulton Independent School,186018,038186018,210207002205,WKEC,908,04,12,18,9,4,13,0,0,0,0,0,0,0,0,0,0,0,0,2,4,6,7,4,11,30
20192020,038,FULTON,186,Fulton Independent,018,Fulton Independent School,186018,038186018,210207002205,WKEC,908,05,9,14,4,5,9,0,0,0,0,0,0,0,2,2,0,0,0,1,0,1,9,2,11,23
20192020,038,FULTON,186,Fulton Independent,018,Fulton Independent School,186018,038186018,210207002205,WKEC,908,06,14,12,5,7,12,0,0,0,0,1,1,0,1,1,0,0,0,3,2,5,4,3,7,26
20192020,038,FULTON,186,Fulton Independent,018,Fulton Independent School,186018,038186018,210207002205,WKEC,908,07,4,9,5,1,6,0,0,0,0,0,0,0,0,0,0,0,0,1,1,2,3,2,5,13
20192020,038,FULTON,186,Fulton Independent,018,Fulton Independent School,186018,038186018,210207002205,WKEC,908,09,11,8,1,7,8,0,0,0,0,0,0,1,0,1,0,0,0,0,1,1,6,3,9,19
20192020,038,FULTON,186,Fulton Independent,018,Fulton Independent School,186018,038186018,210207002205,WKEC,908,10,8,8,1,5,6,0,0,0,1,0,1,2,0,2,0,0,0,2,0,2,2,3,5,16
20192020,038,FULTON,186,Fulton Independent,018,Fulton Independent School,186018,038186018,210207002205,WKEC,908,11,15,10,5,9,14,0,0,0,0,1,1,0,2,2,0,0,0,2,1,3,3,2,5,25
20192020,038,FULTON,186,Fulton Independent,018,Fulton Independent School,186018,038186018,210207002205,WKEC,908,12,8,12,7,4,11,0,0,0,0,0,0,0,0,0,0,0,0,0,0,0,5,4,9,20
20192020,039,GALLATIN,191,Gallatin County,"",---District Total---,191,"","",OVEC,906,11,59,52,0,1,1,0,0,0,0,0,0,2,7,9,0,0,0,2,1,3,48,50,98,111
20192020,039,GALLATIN,191,Gallatin County,"",---District Total---,191,"","",OVEC,906,All Students,743,722,3,1,4,1,1,2,1,2,3,73,74,147,0,0,0,19,15,34,625,650,1275,1465
20192020,039,GALLATIN,191,Gallatin County,"",---District Total---,191,"","",OVEC,906,PS,59,56,0,0,0,0,0,0,0,0,0,3,9,12,0,0,0,3,3,6,50,47,97,115
20192020,039,GALLATIN,191,Gallatin County,"",---District Total---,191,"","",OVEC,906,KG,58,51,0,0,0,0,0,0,0,0,0,3,7,10,0,0,0,1,1,2,47,50,97,109
20192020,039,GALLATIN,191,Gallatin County,"",---District Total---,191,"","",OVEC,906,01,50,58,0,0,0,0,0,0,0,0,0,8,8,16,0,0,0,1,0,1,49,42,91,108
20192020,039,GALLATIN,191,Gallatin County,"",---District Total---,191,"","",OVEC,906,02,41,60,0,0,0,1,0,1,0,0,0,6,5,11,0,0,0,3,1,4,50,35,85,101
20192020,039,GALLATIN,191,Gallatin County,"",---District Total---,191,"","",OVEC,906,03,58,65,1,0,1,0,0,0,0,1,1,8,6,14,0,0,0,2,2,4,54,49,103,123
20192020,039,GALLATIN,191,Gallatin County,"",---District Total---,191,"","",OVEC,906,04,57,50,1,0,1,0,1,1,0,0,0,5,1,6,0,0,0,1,0,1,43,55,98,107
20192020,039,GALLATIN,191,Gallatin County,"",---District Total---,191,"","",OVEC,906,05,59,36,0,0,0,0,0,0,0,0,0,5,4,9,0,0,0,1,2,3,30,53,83,95
20192020,039,GALLATIN,191,Gallatin County,"",---District Total---,191,"","",OVEC,906,14,0,1,0,0,0,0,0,0,0,0,0,0,0,0,0,0,0,0,0,0,1,0,1,1
20192020,039,GALLATIN,191,Gallatin County,"",---District Total---,191,"","",OVEC,906,12,51,49,0,0,0,0,0,0,1,0,1,7,8,15,0,0,0,1,3,4,40,40,80,100
20192020,039,GALLATIN,191,Gallatin County,"",---District Total---,191,"","",OVEC,906,06,49,66,0,0,0,0,0,0,0,0,0,5,5,10,0,0,0,2,3,5,59,41,100,115
20192020,039,GALLATIN,191,Gallatin County,"",---District Total---,191,"","",OVEC,906,07,61,53,0,0,0,0,0,0,0,1,1,4,7,11,0,0,0,1,1,2,48,52,100,114
20192020,039,GALLATIN,191,Gallatin County,"",---District Total---,191,"","",OVEC,906,08,70,70,0,0,0,0,0,0,0,0,0,7,8,15,0,0,0,2,0,2,61,62,123,140
20192020,039,GALLATIN,191,Gallatin County,"",---District Total---,191,"","",OVEC,906,09,58,62,1,0,1,0,0,0,0,0,0,8,5,13,0,0,0,1,0,1,52,53,105,120
20192020,039,GALLATIN,191,Gallatin County,"",---District Total---,191,"","",OVEC,906,10,72,49,0,0,0,0,0,0,0,0,0,5,3,8,0,0,0,1,1,2,43,68,111,121
20192020,039,GALLATIN,191,Gallatin County,005,Gallatin County Middle School,191005,039191005,210213001609,OVEC,906,08,70,70,0,0,0,0,0,0,0,0,0,7,8,15,0,0,0,2,0,2,61,62,123,140
20192020,039,GALLATIN,191,Gallatin County,005,Gallatin County Middle School,191005,039191005,210213001609,OVEC,906,All Students,180,189,0,0,0,0,0,0,0,1,1,16,20,36,0,0,0,5,4,9,168,155,323,369
20192020,039,GALLATIN,191,Gallatin County,005,Gallatin County Middle School,191005,039191005,210213001609,OVEC,906,06,49,66,0,0,0,0,0,0,0,0,0,5,5,10,0,0,0,2,3,5,59,41,100,115
20192020,039,GALLATIN,191,Gallatin County,005,Gallatin County Middle School,191005,039191005,210213001609,OVEC,906,07,61,53,0,0,0,0,0,0,0,1,1,4,7,11,0,0,0,1,1,2,48,52,100,114
20192020,039,GALLATIN,191,Gallatin County,006,Gallatin County Upper Elementary,191006,039191006,210213001850,OVEC,906,03,58,65,1,0,1,0,0,0,0,1,1,8,6,14,0,0,0,2,2,4,54,49,103,123
20192020,039,GALLATIN,191,Gallatin County,006,Gallatin County Upper Elementary,191006,039191006,210213001850,OVEC,906,04,57,50,1,0,1,0,1,1,0,0,0,5,1,6,0,0,0,1,0,1,43,55,98,107
20192020,039,GALLATIN,191,Gallatin County,006,Gallatin County Upper Elementary,191006,039191006,210213001850,OVEC,906,05,59,36,0,0,0,0,0,0,0,0,0,5,4,9,0,0,0,1,2,3,30,53,83,95
20192020,039,GALLATIN,191,Gallatin County,006,Gallatin County Upper Elementary,191006,039191006,210213001850,OVEC,906,All Students,174,151,2,0,2,0,1,1,0,1,1,18,11,29,0,0,0,4,4,8,127,157,284,325
20192020,039,GALLATIN,191,Gallatin County,010,Gallatin County Lower Elementary,191010,039191010,210213000450,OVEC,906,KG,58,51,0,0,0,0,0,0,0,0,0,3,7,10,0,0,0,1,1,2,47,50,97,109
20192020,039,GALLATIN,191,Gallatin County,010,Gallatin County Lower Elementary,191010,039191010,210213000450,OVEC,906,All Students,149,169,0,0,0,1,0,1,0,0,0,17,20,37,0,0,0,5,2,7,146,127,273,318
20192020,039,GALLATIN,191,Gallatin County,010,Gallatin County Lower Elementary,191010,039191010,210213000450,OVEC,906,PS,59,56,0,0,0,0,0,0,0,0,0,3,9,12,0,0,0,3,3,6,50,47,97,115
20192020,039,GALLATIN,191,Gallatin County,010,Gallatin County Lower Elementary,191010,039191010,210213000450,OVEC,906,01,50,58,0,0,0,0,0,0,0,0,0,8,8,16,0,0,0,1,0,1,49,42,91,108
20192020,039,GALLATIN,191,Gallatin County,010,Gallatin County Lower Elementary,191010,039191010,210213000450,OVEC,906,02,41,60,0,0,0,1,0,1,0,0,0,6,5,11,0,0,0,3,1,4,50,35,85,101
20192020,039,GALLATIN,191,Gallatin County,020,Gallatin County High School,191020,039191020,210213000451,OVEC,906,10,72,49,0,0,0,0,0,0,0,0,0,5,3,8,0,0,0,1,1,2,43,68,111,121
20192020,039,GALLATIN,191,Gallatin County,020,Gallatin County High School,191020,039191020,210213000451,OVEC,906,11,59,52,0,1,1,0,0,0,0,0,0,2,7,9,0,0,0,2,1,3,48,50,98,111
20192020,039,GALLATIN,191,Gallatin County,020,Gallatin County High School,191020,039191020,210213000451,OVEC,906,12,51,49,0,0,0,0,0,0,1,0,1,7,8,15,0,0,0,1,3,4,40,40,80,100
20192020,039,GALLATIN,191,Gallatin County,020,Gallatin County High School,191020,039191020,210213000451,OVEC,906,14,0,1,0,0,0,0,0,0,0,0,0,0,0,0,0,0,0,0,0,0,1,0,1,1
20192020,039,GALLATIN,191,Gallatin County,020,Gallatin County High School,191020,039191020,210213000451,OVEC,906,All Students,240,213,1,1,2,0,0,0,1,0,1,22,23,45,0,0,0,5,5,10,184,211,395,453
20192020,039,GALLATIN,191,Gallatin County,020,Gallatin County High School,191020,039191020,210213000451,OVEC,906,09,58,62,1,0,1,0,0,0,0,0,0,8,5,13,0,0,0,1,0,1,52,53,105,120
20192020,040,GARRARD,195,Garrard County,"",---District Total---,195,"","",SESC,907,03,97,96,3,3,6,0,0,0,0,1,1,4,5,9,0,0,0,4,3,7,85,85,170,193
20192020,040,GARRARD,195,Garrard County,"",---District Total---,195,"","",SESC,907,04,75,100,1,1,2,0,0,0,0,0,0,5,1,6,0,0,0,2,3,5,92,70,162,175
20192020,040,GARRARD,195,Garrard County,"",---District Total---,195,"","",SESC,907,05,105,116,5,2,7,0,0,0,1,1,2,4,9,13,0,0,0,3,1,4,103,92,195,221
20192020,040,GARRARD,195,Garrard County,"",---District Total---,195,"","",SESC,907,06,98,101,0,3,3,0,0,0,1,0,1,4,3,7,0,0,0,3,6,9,93,86,179,199
20192020,040,GARRARD,195,Garrard County,"",---District Total---,195,"","",SESC,907,07,86,106,7,1,8,0,0,0,0,0,0,6,3,9,0,0,0,4,3,7,89,79,168,192
20192020,040,GARRARD,195,Garrard County,"",---District Total---,195,"","",SESC,907,08,96,103,3,4,7,1,1,2,2,0,2,9,10,19,0,0,0,0,5,5,88,76,164,199
20192020,040,GARRARD,195,Garrard County,"",---District Total---,195,"","",SESC,907,09,93,90,4,2,6,0,0,0,0,0,0,8,4,12,0,0,0,1,3,4,77,84,161,183
20192020,040,GARRARD,195,Garrard County,"",---District Total---,195,"","",SESC,907,10,77,76,0,1,1,0,0,0,0,1,1,3,9,12,0,0,0,1,1,2,72,65,137,153
20192020,040,GARRARD,195,Garrard County,"",---District Total---,195,"","",SESC,907,12,93,94,0,1,1,0,0,0,0,1,1,10,6,16,0,0,0,4,4,8,80,81,161,187
20192020,040,GARRARD,195,Garrard County,"",---District Total---,195,"","",SESC,907,11,92,110,1,1,2,0,0,0,0,0,0,3,4,7,0,0,0,3,2,5,103,85,188,202
20192020,040,GARRARD,195,Garrard County,"",---District Total---,195,"","",SESC,907,All Students,1179,1305,31,24,55,1,1,2,7,8,15,73,66,139,0,0,0,35,44,79,1158,1036,2194,2484
20192020,040,GARRARD,195,Garrard County,"",---District Total---,195,"","",SESC,907,PS,51,74,1,1,2,0,0,0,0,0,0,4,4,8,0,0,0,3,1,4,66,45,111,125
20192020,040,GARRARD,195,Garrard County,"",---District Total---,195,"","",SESC,907,KG,86,91,2,1,3,0,0,0,1,1,2,7,5,12,0,0,0,4,5,9,77,74,151,177
20192020,040,GARRARD,195,Garrard County,"",---District Total---,195,"","",SESC,907,01,96,114,2,1,3,0,0,0,2,2,4,7,4,11,0,0,0,3,2,5,100,87,187,210
20192020,040,GARRARD,195,Garrard County,"",---District Total---,195,"","",SESC,907,02,85,108,3,3,6,0,0,0,0,1,1,3,3,6,0,0,0,3,6,9,99,72,171,193
20192020,040,GARRARD,195,Garrard County,050,Camp Dick Robinson Elementary School,195050,040195050,210216000454,SESC,907,04,34,40,0,0,0,0,0,0,0,0,0,2,1,3,0,0,0,2,1,3,36,32,68,74
20192020,040,GARRARD,195,Garrard County,050,Camp Dick Robinson Elementary School,195050,040195050,210216000454,SESC,907,All Students,225,224,2,3,5,0,0,0,1,4,5,7,4,11,0,0,0,8,3,11,206,211,417,449
20192020,040,GARRARD,195,Garrard County,050,Camp Dick Robinson Elementary School,195050,040195050,210216000454,SESC,907,PS,12,26,0,0,0,0,0,0,0,0,0,0,2,2,0,0,0,0,0,0,26,10,36,38
20192020,040,GARRARD,195,Garrard County,050,Camp Dick Robinson Elementary School,195050,040195050,210216000454,SESC,907,KG,37,27,0,0,0,0,0,0,1,1,2,1,1,2,0,0,0,1,1,2,24,34,58,64
20192020,040,GARRARD,195,Garrard County,050,Camp Dick Robinson Elementary School,195050,040195050,210216000454,SESC,907,01,37,48,1,0,1,0,0,0,0,1,1,2,0,2,0,0,0,3,0,3,42,36,78,85
20192020,040,GARRARD,195,Garrard County,050,Camp Dick Robinson Elementary School,195050,040195050,210216000454,SESC,907,02,35,38,0,2,2,0,0,0,0,1,1,1,0,1,0,0,0,1,1,2,36,31,67,73
20192020,040,GARRARD,195,Garrard County,050,Camp Dick Robinson Elementary School,195050,040195050,210216000454,SESC,907,03,37,30,0,1,1,0,0,0,0,1,1,0,2,2,0,0,0,1,0,1,29,33,62,67
20192020,040,GARRARD,195,Garrard County,050,Camp Dick Robinson Elementary School,195050,040195050,210216000454,SESC,907,05,45,41,1,0,1,0,0,0,0,0,0,1,0,1,0,0,0,0,0,0,39,45,84,86
20192020,040,GARRARD,195,Garrard County,060,Garrard County High School,195060,040195060,210216000455,SESC,907,11,92,110,1,1,2,0,0,0,0,0,0,3,4,7,0,0,0,3,2,5,103,85,188,202
20192020,040,GARRARD,195,Garrard County,060,Garrard County High School,195060,040195060,210216000455,SESC,907,All Students,360,372,5,5,10,0,1,1,0,2,2,25,23,48,0,0,0,9,10,19,333,319,652,732
20192020,040,GARRARD,195,Garrard County,060,Garrard County High School,195060,040195060,210216000455,SESC,907,08,5,2,0,0,0,0,1,1,0,0,0,1,0,1,0,0,0,0,0,0,1,4,5,7
20192020,040,GARRARD,195,Garrard County,060,Garrard County High School,195060,040195060,210216000455,SESC,907,09,93,90,4,2,6,0,0,0,0,0,0,8,4,12,0,0,0,1,3,4,77,84,161,183
20192020,040,GARRARD,195,Garrard County,060,Garrard County High School,195060,040195060,210216000455,SESC,907,10,77,76,0,1,1,0,0,0,0,1,1,3,9,12,0,0,0,1,1,2,72,65,137,153
20192020,040,GARRARD,195,Garrard County,060,Garrard County High School,195060,040195060,210216000455,SESC,907,12,93,94,0,1,1,0,0,0,0,1,1,10,6,16,0,0,0,4,4,8,80,81,161,187
20192020,040,GARRARD,195,Garrard County,070,Garrard Middle School,195070,040195070,210216001672,SESC,907,07,86,106,7,1,8,0,0,0,0,0,0,6,3,9,0,0,0,4,3,7,89,79,168,192
20192020,040,GARRARD,195,Garrard County,070,Garrard Middle School,195070,040195070,210216001672,SESC,907,All Students,275,308,10,8,18,1,0,1,3,0,3,18,16,34,0,0,0,7,14,21,269,237,506,583
20192020,040,GARRARD,195,Garrard County,070,Garrard Middle School,195070,040195070,210216001672,SESC,907,06,98,101,0,3,3,0,0,0,1,0,1,4,3,7,0,0,0,3,6,9,93,86,179,199
20192020,040,GARRARD,195,Garrard County,070,Garrard Middle School,195070,040195070,210216001672,SESC,907,08,91,101,3,4,7,1,0,1,2,0,2,8,10,18,0,0,0,0,5,5,87,72,159,192
20192020,040,GARRARD,195,Garrard County,090,Paint Lick Elementary School,195090,040195090,210216000456,SESC,907,02,21,34,1,0,1,0,0,0,0,0,0,2,2,4,0,0,0,0,0,0,31,19,50,55
20192020,040,GARRARD,195,Garrard County,090,Paint Lick Elementary School,195090,040195090,210216000456,SESC,907,All Students,126,173,3,0,3,0,0,0,0,0,0,6,9,15,0,0,0,0,3,3,164,114,278,299
20192020,040,GARRARD,195,Garrard County,090,Paint Lick Elementary School,195090,040195090,210216000456,SESC,907,PS,12,12,0,0,0,0,0,0,0,0,0,1,0,1,0,0,0,0,0,0,11,12,23,24
20192020,040,GARRARD,195,Garrard County,090,Paint Lick Elementary School,195090,040195090,210216000456,SESC,907,KG,14,22,0,0,0,0,0,0,0,0,0,1,0,1,0,0,0,0,1,1,21,13,34,36
20192020,040,GARRARD,195,Garrard County,090,Paint Lick Elementary School,195090,040195090,210216000456,SESC,907,01,24,29,1,0,1,0,0,0,0,0,0,0,2,2,0,0,0,0,0,0,28,22,50,53
20192020,040,GARRARD,195,Garrard County,090,Paint Lick Elementary School,195090,040195090,210216000456,SESC,907,03,25,27,0,0,0,0,0,0,0,0,0,2,0,2,0,0,0,0,0,0,25,25,50,52
20192020,040,GARRARD,195,Garrard County,090,Paint Lick Elementary School,195090,040195090,210216000456,SESC,907,04,15,30,1,0,1,0,0,0,0,0,0,0,0,0,0,0,0,0,1,1,29,14,43,45
20192020,040,GARRARD,195,Garrard County,090,Paint Lick Elementary School,195090,040195090,210216000456,SESC,907,05,27,31,0,0,0,0,0,0,0,0,0,1,5,6,0,0,0,0,1,1,30,21,51,58
20192020,040,GARRARD,195,Garrard County,220,Lancaster Elementary School,195220,040195220,210216000457,SESC,907,05,33,44,4,2,6,0,0,0,1,1,2,2,4,6,0,0,0,3,0,3,34,26,60,77
20192020,040,GARRARD,195,Garrard County,220,Lancaster Elementary School,195220,040195220,210216000457,SESC,907,All Students,193,228,11,8,19,0,0,0,3,2,5,17,14,31,0,0,0,11,14,25,186,155,341,421
20192020,040,GARRARD,195,Garrard County,220,Lancaster Elementary School,195220,040195220,210216000457,SESC,907,PS,27,36,1,1,2,0,0,0,0,0,0,3,2,5,0,0,0,3,1,4,29,23,52,63
20192020,040,GARRARD,195,Garrard County,220,Lancaster Elementary School,195220,040195220,210216000457,SESC,907,KG,35,42,2,1,3,0,0,0,0,0,0,5,4,9,0,0,0,3,3,6,32,27,59,77
20192020,040,GARRARD,195,Garrard County,220,Lancaster Elementary School,195220,040195220,210216000457,SESC,907,01,35,37,0,1,1,0,0,0,2,1,3,5,2,7,0,0,0,0,2,2,30,29,59,72
20192020,040,GARRARD,195,Garrard County,220,Lancaster Elementary School,195220,040195220,210216000457,SESC,907,02,29,36,2,1,3,0,0,0,0,0,0,0,1,1,0,0,0,2,5,7,32,22,54,65
20192020,040,GARRARD,195,Garrard County,220,Lancaster Elementary School,195220,040195220,210216000457,SESC,907,03,35,39,3,2,5,0,0,0,0,0,0,2,3,5,0,0,0,3,3,6,31,27,58,74
20192020,040,GARRARD,195,Garrard County,220,Lancaster Elementary School,195220,040195220,210216000457,SESC,907,04,26,30,0,1,1,0,0,0,0,0,0,3,0,3,0,0,0,0,1,1,27,24,51,56
20192020,005,BARREN,197,Glasgow Independent,"",---District Total---,197,"","",GRREC,902,PS,89,116,6,8,14,0,0,0,1,1,2,22,10,32,0,0,0,10,8,18,77,62,139,205
20192020,005,BARREN,197,Glasgow Independent,"",---District Total---,197,"","",GRREC,902,All Students,1086,1150,104,124,228,2,2,4,11,11,22,158,127,285,4,5,9,117,123,240,754,694,1448,2236
20192020,005,BARREN,197,Glasgow Independent,"",---District Total---,197,"","",GRREC,902,KG,95,124,3,11,14,1,1,2,0,0,0,17,12,29,0,0,0,13,15,28,90,56,146,219
20192020,005,BARREN,197,Glasgow Independent,"",---District Total---,197,"","",GRREC,902,01,84,90,6,7,13,0,0,0,1,0,1,12,5,17,0,2,2,13,13,26,58,57,115,174
20192020,005,BARREN,197,Glasgow Independent,"",---District Total---,197,"","",GRREC,902,02,80,94,5,7,12,0,0,0,0,0,0,20,10,30,1,0,1,11,12,23,57,51,108,174
20192020,005,BARREN,197,Glasgow Independent,"",---District Total---,197,"","",GRREC,902,03,83,79,6,8,14,1,0,1,0,1,1,10,16,26,0,0,0,9,7,16,53,51,104,162
20192020,005,BARREN,197,Glasgow Independent,"",---District Total---,197,"","",GRREC,902,04,72,91,9,7,16,0,1,1,0,0,0,14,12,26,1,0,1,9,9,18,58,43,101,163
20192020,005,BARREN,197,Glasgow Independent,"",---District Total---,197,"","",GRREC,902,05,105,94,5,17,22,0,0,0,0,4,4,9,12,21,1,0,1,14,11,25,65,61,126,199
20192020,005,BARREN,197,Glasgow Independent,"",---District Total---,197,"","",GRREC,902,06,95,79,11,10,21,0,0,0,0,2,2,11,12,23,1,0,1,8,11,19,48,60,108,174
20192020,005,BARREN,197,Glasgow Independent,"",---District Total---,197,"","",GRREC,902,07,82,75,8,11,19,0,0,0,1,0,1,17,12,29,0,1,1,6,8,14,43,50,93,157
20192020,005,BARREN,197,Glasgow Independent,"",---District Total---,197,"","",GRREC,902,08,71,98,8,7,15,0,0,0,1,1,2,12,5,17,0,0,0,6,9,15,71,49,120,169
20192020,005,BARREN,197,Glasgow Independent,"",---District Total---,197,"","",GRREC,902,09,81,75,6,6,12,0,0,0,2,0,2,9,8,17,0,1,1,10,10,20,48,56,104,156
20192020,005,BARREN,197,Glasgow Independent,"",---District Total---,197,"","",GRREC,902,10,76,91,10,10,20,0,0,0,0,0,0,7,6,13,0,0,0,8,5,13,66,55,121,167
20192020,005,BARREN,197,Glasgow Independent,"",---District Total---,197,"","",GRREC,902,11,83,78,10,13,23,0,0,0,2,2,4,8,9,17,0,0,0,6,8,14,52,51,103,161
20192020,005,BARREN,197,Glasgow Independent,"",---District Total---,197,"","",GRREC,902,12,79,82,17,10,27,0,0,0,4,1,5,12,8,20,0,1,1,4,5,9,45,54,99,161
20192020,005,BARREN,197,Glasgow Independent,002,Success Academy,197002,005197002,210222002215,GRREC,902,10,6,6,0,0,0,0,0,0,0,0,0,2,2,4,0,0,0,0,0,0,4,4,8,12
20192020,005,BARREN,197,Glasgow Independent,002,Success Academy,197002,005197002,210222002215,GRREC,902,11,15,11,1,1,2,0,0,0,0,0,0,1,1,2,0,0,0,0,1,1,9,12,21,26
20192020,005,BARREN,197,Glasgow Independent,002,Success Academy,197002,005197002,210222002215,GRREC,902,All Students,39,40,4,4,8,0,0,0,0,0,0,7,5,12,0,0,0,0,2,2,29,28,57,79
20192020,005,BARREN,197,Glasgow Independent,002,Success Academy,197002,005197002,210222002215,GRREC,902,12,17,21,3,3,6,0,0,0,0,0,0,3,2,5,0,0,0,0,1,1,15,11,26,38
20192020,005,BARREN,197,Glasgow Independent,002,Success Academy,197002,005197002,210222002215,GRREC,902,09,1,2,0,0,0,0,0,0,0,0,0,1,0,1,0,0,0,0,0,0,1,1,2,3
20192020,005,BARREN,197,Glasgow Independent,013,Highland Elementary School,197013,005197013,210222001991,GRREC,902,01,50,54,6,3,9,0,0,0,1,0,1,8,4,12,0,2,2,7,11,18,32,30,62,104
20192020,005,BARREN,197,Glasgow Independent,013,Highland Elementary School,197013,005197013,210222001991,GRREC,902,02,33,60,4,3,7,0,0,0,0,0,0,15,5,20,1,0,1,7,3,10,33,22,55,93
20192020,005,BARREN,197,Glasgow Independent,013,Highland Elementary School,197013,005197013,210222001991,GRREC,902,04,46,54,7,6,13,0,0,0,0,0,0,8,8,16,1,0,1,4,3,7,34,29,63,100
20192020,005,BARREN,197,Glasgow Independent,013,Highland Elementary School,197013,005197013,210222001991,GRREC,902,03,40,38,2,2,4,1,0,1,0,1,1,3,7,10,0,0,0,6,2,8,26,28,54,78
20192020,005,BARREN,197,Glasgow Independent,013,Highland Elementary School,197013,005197013,210222001991,GRREC,902,05,62,62,4,9,13,0,0,0,0,3,3,5,7,12,1,0,1,10,6,16,42,37,79,124
20192020,005,BARREN,197,Glasgow Independent,013,Highland Elementary School,197013,005197013,210222001991,GRREC,902,All Students,286,330,23,32,55,2,0,2,1,4,5,45,39,84,3,2,5,42,32,74,214,177,391,616
20192020,005,BARREN,197,Glasgow Independent,013,Highland Elementary School,197013,005197013,210222001991,GRREC,902,PS,53,67,6,5,11,0,0,0,1,1,2,9,6,15,0,0,0,3,6,9,48,35,83,120
20192020,005,BARREN,197,Glasgow Independent,013,Highland Elementary School,197013,005197013,210222001991,GRREC,902,KG,55,62,0,9,9,1,0,1,0,0,0,6,8,14,0,0,0,8,7,15,47,31,78,117
20192020,005,BARREN,197,Glasgow Independent,015,Happy Valley Learning Center,197015,005197015,210222002101,GRREC,902,08,0,1,0,0,0,0,0,0,0,0,0,0,0,0,0,0,0,1,0,1,0,0,0,1
20192020,005,BARREN,197,Glasgow Independent,015,Happy Valley Learning Center,197015,005197015,210222002101,GRREC,902,10,1,3,0,0,0,0,0,0,0,0,0,1,0,1,0,0,0,1,0,1,1,1,2,4
20192020,005,BARREN,197,Glasgow Independent,015,Happy Valley Learning Center,197015,005197015,210222002101,GRREC,902,All Students,3,9,0,0,0,0,0,0,0,0,0,2,0,2,0,0,0,3,1,4,4,2,6,12
20192020,005,BARREN,197,Glasgow Independent,015,Happy Valley Learning Center,197015,005197015,210222002101,GRREC,902,11,0,1,0,0,0,0,0,0,0,0,0,0,0,0,0,0,0,0,0,0,1,0,1,1
20192020,005,BARREN,197,Glasgow Independent,015,Happy Valley Learning Center,197015,005197015,210222002101,GRREC,902,09,2,4,0,0,0,0,0,0,0,0,0,1,0,1,0,0,0,1,1,2,2,1,3,6
20192020,005,BARREN,197,Glasgow Independent,030,Glasgow High School,197030,005197030,210222000461,GRREC,902,All Students,277,278,39,35,74,0,0,0,8,3,11,27,26,53,0,2,2,26,25,51,178,186,364,555
20192020,005,BARREN,197,Glasgow Independent,030,Glasgow High School,197030,005197030,210222000461,GRREC,902,09,78,69,6,6,12,0,0,0,2,0,2,7,8,15,0,1,1,9,9,18,45,54,99,147
20192020,005,BARREN,197,Glasgow Independent,030,Glasgow High School,197030,005197030,210222000461,GRREC,902,10,69,82,10,10,20,0,0,0,0,0,0,4,4,8,0,0,0,7,5,12,61,50,111,151
20192020,005,BARREN,197,Glasgow Independent,030,Glasgow High School,197030,005197030,210222000461,GRREC,902,11,68,66,9,12,21,0,0,0,2,2,4,7,8,15,0,0,0,6,7,13,42,39,81,134
20192020,005,BARREN,197,Glasgow Independent,030,Glasgow High School,197030,005197030,210222000461,GRREC,902,12,62,61,14,7,21,0,0,0,4,1,5,9,6,15,0,1,1,4,4,8,30,43,73,123
20192020,005,BARREN,197,Glasgow Independent,035,Glasgow Middle School,197035,005197035,210222000402,GRREC,902,08,71,97,8,7,15,0,0,0,1,1,2,12,5,17,0,0,0,5,9,14,71,49,120,168
20192020,005,BARREN,197,Glasgow Independent,035,Glasgow Middle School,197035,005197035,210222000402,GRREC,902,All Students,248,251,27,28,55,0,0,0,2,3,5,40,29,69,1,1,2,19,28,47,162,159,321,499
20192020,005,BARREN,197,Glasgow Independent,035,Glasgow Middle School,197035,005197035,210222000402,GRREC,902,06,95,79,11,10,21,0,0,0,0,2,2,11,12,23,1,0,1,8,11,19,48,60,108,174
20192020,005,BARREN,197,Glasgow Independent,035,Glasgow Middle School,197035,005197035,210222000402,GRREC,902,07,82,75,8,11,19,0,0,0,1,0,1,17,12,29,0,1,1,6,8,14,43,50,93,157
20192020,005,BARREN,197,Glasgow Independent,065,South Green Elementary School,197065,005197065,210222001565,GRREC,902,01,34,36,0,4,4,0,0,0,0,0,0,4,1,5,0,0,0,6,2,8,26,27,53,70
20192020,005,BARREN,197,Glasgow Independent,065,South Green Elementary School,197065,005197065,210222001565,GRREC,902,02,47,34,1,4,5,0,0,0,0,0,0,5,5,10,0,0,0,4,9,13,24,29,53,81
20192020,005,BARREN,197,Glasgow Independent,065,South Green Elementary School,197065,005197065,210222001565,GRREC,902,03,43,41,4,6,10,0,0,0,0,0,0,7,9,16,0,0,0,3,5,8,27,23,50,84
20192020,005,BARREN,197,Glasgow Independent,065,South Green Elementary School,197065,005197065,210222001565,GRREC,902,04,26,37,2,1,3,0,1,1,0,0,0,6,4,10,0,0,0,5,6,11,24,14,38,63
20192020,005,BARREN,197,Glasgow Independent,065,South Green Elementary School,197065,005197065,210222001565,GRREC,902,05,43,32,1,8,9,0,0,0,0,1,1,4,5,9,0,0,0,4,5,9,23,24,47,75
20192020,005,BARREN,197,Glasgow Independent,065,South Green Elementary School,197065,005197065,210222001565,GRREC,902,All Students,233,242,11,25,36,0,2,2,0,1,1,37,28,65,0,0,0,27,35,62,167,142,309,475
20192020,005,BARREN,197,Glasgow Independent,065,South Green Elementary School,197065,005197065,210222001565,GRREC,902,PS,36,49,0,3,3,0,0,0,0,0,0,13,4,17,0,0,0,7,2,9,29,27,56,85
20192020,005,BARREN,197,Glasgow Independent,065,South Green Elementary School,197065,005197065,210222001565,GRREC,902,KG,40,62,3,2,5,0,1,1,0,0,0,11,4,15,0,0,0,5,8,13,43,25,68,102
20192020,041,GRANT,201,Grant County,"",---District Total---,201,"","",OVEC,906,09,162,133,0,2,2,0,0,0,0,0,0,5,5,10,0,0,0,3,3,6,125,152,277,295
20192020,041,GRANT,201,Grant County,"",---District Total---,201,"","",OVEC,906,10,126,124,0,0,0,0,0,0,0,0,0,3,5,8,0,0,0,2,3,5,119,118,237,250
20192020,041,GRANT,201,Grant County,"",---District Total---,201,"","",OVEC,906,11,142,114,1,1,2,0,1,1,0,1,1,7,8,15,0,0,0,1,5,6,105,126,231,256
20192020,041,GRANT,201,Grant County,"",---District Total---,201,"","",OVEC,906,14,1,1,0,0,0,0,0,0,0,0,0,0,0,0,0,0,0,0,0,0,1,1,2,2
20192020,041,GRANT,201,Grant County,"",---District Total---,201,"","",OVEC,906,12,104,132,0,0,0,0,0,0,0,1,1,8,3,11,0,0,0,2,3,5,122,97,219,236
20192020,041,GRANT,201,Grant County,"",---District Total---,201,"","",OVEC,906,All Students,1742,1745,13,11,24,2,2,4,2,5,7,88,70,158,3,0,3,50,57,107,1587,1597,3184,3487
20192020,041,GRANT,201,Grant County,"",---District Total---,201,"","",OVEC,906,PS,44,79,2,0,2,0,0,0,0,0,0,6,0,6,0,0,0,2,0,2,69,44,113,123
20192020,041,GRANT,201,Grant County,"",---District Total---,201,"","",OVEC,906,KG,114,126,0,1,1,0,0,0,1,0,1,5,4,9,0,0,0,2,2,4,118,107,225,240
20192020,041,GRANT,201,Grant County,"",---District Total---,201,"","",OVEC,906,01,101,149,2,0,2,0,0,0,0,0,0,11,5,16,0,0,0,12,2,14,124,94,218,250
20192020,041,GRANT,201,Grant County,"",---District Total---,201,"","",OVEC,906,02,102,141,1,1,2,0,0,0,0,0,0,4,3,7,1,0,1,5,3,8,130,95,225,243
20192020,041,GRANT,201,Grant County,"",---District Total---,201,"","",OVEC,906,03,134,135,1,5,6,1,1,2,0,0,0,10,3,13,0,0,0,2,6,8,121,119,240,269
20192020,041,GRANT,201,Grant County,"",---District Total---,201,"","",OVEC,906,04,142,115,1,0,1,1,0,1,0,1,1,11,8,19,0,0,0,1,5,6,101,128,229,257
20192020,041,GRANT,201,Grant County,"",---District Total---,201,"","",OVEC,906,05,146,139,3,0,3,0,0,0,0,0,0,6,7,13,0,0,0,4,3,7,126,136,262,285
20192020,041,GRANT,201,Grant County,"",---District Total---,201,"","",OVEC,906,06,167,140,1,1,2,0,0,0,1,0,1,3,8,11,2,0,2,3,9,12,130,149,279,307
20192020,041,GRANT,201,Grant County,"",---District Total---,201,"","",OVEC,906,07,156,159,2,0,2,0,0,0,0,2,2,5,4,9,0,0,0,7,8,15,145,142,287,315
20192020,041,GRANT,201,Grant County,"",---District Total---,201,"","",OVEC,906,08,145,137,1,0,1,0,0,0,0,0,0,10,7,17,0,0,0,6,5,11,120,133,253,282
20192020,041,GRANT,201,Grant County,016,Sherman Elementary,201016,041201016,210225002201,OVEC,906,04,34,27,0,0,0,0,0,0,0,0,0,5,2,7,0,0,0,0,3,3,22,29,51,61
20192020,041,GRANT,201,Grant County,016,Sherman Elementary,201016,041201016,210225002201,OVEC,906,All Students,193,208,0,1,1,0,1,1,0,0,0,27,10,37,1,0,1,9,9,18,171,172,343,401
20192020,041,GRANT,201,Grant County,016,Sherman Elementary,201016,041201016,210225002201,OVEC,906,PS,17,21,0,0,0,0,0,0,0,0,0,2,0,2,0,0,0,0,0,0,19,17,36,38
20192020,041,GRANT,201,Grant County,016,Sherman Elementary,201016,041201016,210225002201,OVEC,906,KG,34,37,0,0,0,0,0,0,0,0,0,3,2,5,0,0,0,2,1,3,32,31,63,71
20192020,041,GRANT,201,Grant County,016,Sherman Elementary,201016,041201016,210225002201,OVEC,906,01,29,36,0,0,0,0,0,0,0,0,0,5,3,8,0,0,0,4,0,4,27,26,53,65
20192020,041,GRANT,201,Grant County,016,Sherman Elementary,201016,041201016,210225002201,OVEC,906,02,24,35,0,0,0,0,0,0,0,0,0,4,1,5,1,0,1,1,1,2,29,22,51,59
20192020,041,GRANT,201,Grant County,016,Sherman Elementary,201016,041201016,210225002201,OVEC,906,03,34,43,0,1,1,0,1,1,0,0,0,6,0,6,0,0,0,0,4,4,37,28,65,77
20192020,041,GRANT,201,Grant County,016,Sherman Elementary,201016,041201016,210225002201,OVEC,906,05,38,30,0,0,0,0,0,0,0,0,0,4,2,6,0,0,0,2,0,2,24,36,60,68
20192020,041,GRANT,201,Grant County,020,Crittenden-Mt. Zion Elementary,201020,041201020,210225000465,OVEC,906,04,46,34,0,0,0,0,0,0,0,1,1,3,1,4,0,0,0,1,1,2,30,43,73,80
20192020,041,GRANT,201,Grant County,020,Crittenden-Mt. Zion Elementary,201020,041201020,210225000465,OVEC,906,All Students,229,237,3,3,6,0,0,0,1,1,2,10,10,20,0,0,0,7,7,14,216,208,424,466
20192020,041,GRANT,201,Grant County,020,Crittenden-Mt. Zion Elementary,201020,041201020,210225000465,OVEC,906,PS,13,32,2,0,2,0,0,0,0,0,0,3,0,3,0,0,0,0,0,0,27,13,40,45
20192020,041,GRANT,201,Grant County,020,Crittenden-Mt. Zion Elementary,201020,041201020,210225000465,OVEC,906,KG,32,37,0,0,0,0,0,0,1,0,1,1,1,2,0,0,0,0,1,1,35,30,65,69
20192020,041,GRANT,201,Grant County,020,Crittenden-Mt. Zion Elementary,201020,041201020,210225000465,OVEC,906,01,27,46,1,0,1,0,0,0,0,0,0,3,1,4,0,0,0,3,1,4,39,25,64,73
20192020,041,GRANT,201,Grant County,020,Crittenden-Mt. Zion Elementary,201020,041201020,210225000465,OVEC,906,02,34,49,1,1,2,0,0,0,0,0,0,0,2,2,0,0,0,1,2,3,47,29,76,83
20192020,041,GRANT,201,Grant County,020,Crittenden-Mt. Zion Elementary,201020,041201020,210225000465,OVEC,906,03,39,32,0,2,2,0,0,0,0,0,0,2,2,4,0,0,0,1,1,2,29,34,63,71
20192020,041,GRANT,201,Grant County,020,Crittenden-Mt. Zion Elementary,201020,041201020,210225000465,OVEC,906,05,51,39,1,0,1,0,0,0,0,0,0,1,3,4,0,0,0,1,1,2,36,47,83,90
20192020,041,GRANT,201,Grant County,030,Dry Ridge Elementary,201030,041201030,210225000466,OVEC,906,05,33,43,2,0,2,0,0,0,0,0,0,1,2,3,0,0,0,1,1,2,39,30,69,76
20192020,041,GRANT,201,Grant County,030,Dry Ridge Elementary,201030,041201030,210225000466,OVEC,906,All Students,184,223,4,2,6,2,0,2,0,0,0,6,9,15,0,0,0,10,3,13,201,170,371,407
20192020,041,GRANT,201,Grant County,030,Dry Ridge Elementary,201030,041201030,210225000466,OVEC,906,PS,7,13,0,0,0,0,0,0,0,0,0,0,0,0,0,0,0,2,0,2,11,7,18,20
20192020,041,GRANT,201,Grant County,030,Dry Ridge Elementary,201030,041201030,210225000466,OVEC,906,KG,29,29,0,1,1,0,0,0,0,0,0,0,1,1,0,0,0,0,0,0,29,27,56,58
20192020,041,GRANT,201,Grant County,030,Dry Ridge Elementary,201030,041201030,210225000466,OVEC,906,01,26,47,1,0,1,0,0,0,0,0,0,1,1,2,0,0,0,5,0,5,40,25,65,73
20192020,041,GRANT,201,Grant County,030,Dry Ridge Elementary,201030,041201030,210225000466,OVEC,906,02,24,35,0,0,0,0,0,0,0,0,0,0,0,0,0,0,0,3,0,3,32,24,56,59
20192020,041,GRANT,201,Grant County,030,Dry Ridge Elementary,201030,041201030,210225000466,OVEC,906,03,35,33,1,1,2,1,0,1,0,0,0,1,1,2,0,0,0,1,1,2,29,32,61,68
20192020,041,GRANT,201,Grant County,030,Dry Ridge Elementary,201030,041201030,210225000466,OVEC,906,04,37,36,0,0,0,1,0,1,0,0,0,3,4,7,0,0,0,0,1,1,32,32,64,73
20192020,041,GRANT,201,Grant County,040,Grant County High School,201040,041201040,210225000467,OVEC,906,12,104,132,0,0,0,0,0,0,0,1,1,8,3,11,0,0,0,2,3,5,122,97,219,236
20192020,041,GRANT,201,Grant County,040,Grant County High School,201040,041201040,210225000467,OVEC,906,All Students,535,504,1,3,4,0,1,1,0,2,2,23,21,44,0,0,0,8,14,22,472,494,966,1039
20192020,041,GRANT,201,Grant County,040,Grant County High School,201040,041201040,210225000467,OVEC,906,09,162,133,0,2,2,0,0,0,0,0,0,5,5,10,0,0,0,3,3,6,125,152,277,295
20192020,041,GRANT,201,Grant County,040,Grant County High School,201040,041201040,210225000467,OVEC,906,10,126,124,0,0,0,0,0,0,0,0,0,3,5,8,0,0,0,2,3,5,119,118,237,250
20192020,041,GRANT,201,Grant County,040,Grant County High School,201040,041201040,210225000467,OVEC,906,11,142,114,1,1,2,0,1,1,0,1,1,7,8,15,0,0,0,1,5,6,105,126,231,256
20192020,041,GRANT,201,Grant County,040,Grant County High School,201040,041201040,210225000467,OVEC,906,14,1,1,0,0,0,0,0,0,0,0,0,0,0,0,0,0,0,0,0,0,1,1,2,2
20192020,041,GRANT,201,Grant County,050,Mason-Corinth Elementary,201050,041201050,210225001701,OVEC,906,PS,7,13,0,0,0,0,0,0,0,0,0,1,0,1,0,0,0,0,0,0,12,7,19,20
20192020,041,GRANT,201,Grant County,050,Mason-Corinth Elementary,201050,041201050,210225001701,OVEC,906,All Students,133,137,1,1,2,0,0,0,0,0,0,4,1,5,0,0,0,0,2,2,132,129,261,270
20192020,041,GRANT,201,Grant County,050,Mason-Corinth Elementary,201050,041201050,210225001701,OVEC,906,KG,19,23,0,0,0,0,0,0,0,0,0,1,0,1,0,0,0,0,0,0,22,19,41,42
20192020,041,GRANT,201,Grant County,050,Mason-Corinth Elementary,201050,041201050,210225001701,OVEC,906,01,19,20,0,0,0,0,0,0,0,0,0,2,0,2,0,0,0,0,1,1,18,18,36,39
20192020,041,GRANT,201,Grant County,050,Mason-Corinth Elementary,201050,041201050,210225001701,OVEC,906,02,20,22,0,0,0,0,0,0,0,0,0,0,0,0,0,0,0,0,0,0,22,20,42,42
20192020,041,GRANT,201,Grant County,050,Mason-Corinth Elementary,201050,041201050,210225001701,OVEC,906,03,26,27,0,1,1,0,0,0,0,0,0,1,0,1,0,0,0,0,0,0,26,25,51,53
20192020,041,GRANT,201,Grant County,050,Mason-Corinth Elementary,201050,041201050,210225001701,OVEC,906,04,25,18,1,0,1,0,0,0,0,0,0,0,1,1,0,0,0,0,0,0,17,24,41,43
20192020,041,GRANT,201,Grant County,050,Mason-Corinth Elementary,201050,041201050,210225001701,OVEC,906,05,24,27,0,0,0,0,0,0,0,0,0,0,0,0,0,0,0,0,1,1,27,23,50,51
20192020,041,GRANT,201,Grant County,080,Grant County Middle School,201080,041201080,210225000469,OVEC,906,07,156,159,2,0,2,0,0,0,0,2,2,5,4,9,0,0,0,7,8,15,145,142,287,315
20192020,041,GRANT,201,Grant County,080,Grant County Middle School,201080,041201080,210225000469,OVEC,906,08,145,137,1,0,1,0,0,0,0,0,0,10,7,17,0,0,0,6,5,11,120,133,253,282
20192020,041,GRANT,201,Grant County,080,Grant County Middle School,201080,041201080,210225000469,OVEC,906,All Students,468,436,4,1,5,0,0,0,1,2,3,18,19,37,2,0,2,16,22,38,395,424,819,904
20192020,041,GRANT,201,Grant County,080,Grant County Middle School,201080,041201080,210225000469,OVEC,906,06,167,140,1,1,2,0,0,0,1,0,1,3,8,11,2,0,2,3,9,12,130,149,279,307
20192020,042,GRAVES,205,Graves County,"",---District Total---,205,"","",WKEC,908,KG,148,161,3,3,6,0,0,0,0,1,1,16,14,30,0,0,0,6,8,14,136,122,258,309
20192020,042,GRAVES,205,Graves County,"",---District Total---,205,"","",WKEC,908,01,173,169,1,4,5,0,0,0,0,0,0,11,13,24,0,0,0,8,5,13,149,151,300,342
20192020,042,GRAVES,205,Graves County,"",---District Total---,205,"","",WKEC,908,02,119,152,4,2,6,0,0,0,0,0,0,11,8,19,0,0,0,5,11,16,132,98,230,271
20192020,042,GRAVES,205,Graves County,"",---District Total---,205,"","",WKEC,908,03,143,148,3,3,6,1,0,1,1,2,3,4,8,12,0,0,0,12,4,16,127,126,253,291
20192020,042,GRAVES,205,Graves County,"",---District Total---,205,"","",WKEC,908,04,151,156,6,2,8,0,0,0,1,1,2,13,9,22,0,0,0,6,9,15,130,130,260,307
20192020,042,GRAVES,205,Graves County,"",---District Total---,205,"","",WKEC,908,05,150,172,3,2,5,0,0,0,0,2,2,10,11,21,0,0,0,10,6,16,149,129,278,322
20192020,042,GRAVES,205,Graves County,"",---District Total---,205,"","",WKEC,908,10,146,146,1,2,3,0,0,0,3,1,4,6,12,18,0,0,0,6,5,11,130,126,256,292
20192020,042,GRAVES,205,Graves County,"",---District Total---,205,"","",WKEC,908,06,150,149,3,3,6,0,0,0,0,0,0,10,12,22,0,0,0,10,15,25,126,120,246,299
20192020,042,GRAVES,205,Graves County,"",---District Total---,205,"","",WKEC,908,07,153,165,3,0,3,0,0,0,2,1,3,19,13,32,0,0,0,9,5,14,132,134,266,318
20192020,042,GRAVES,205,Graves County,"",---District Total---,205,"","",WKEC,908,12,165,152,1,4,5,0,0,0,0,0,0,10,12,22,0,1,1,4,3,7,137,145,282,317
20192020,042,GRAVES,205,Graves County,"",---District Total---,205,"","",WKEC,908,08,134,149,1,1,2,0,1,1,0,2,2,13,8,21,0,0,0,9,7,16,126,115,241,283
20192020,042,GRAVES,205,Graves County,"",---District Total---,205,"","",WKEC,908,11,133,158,3,0,3,0,0,0,0,1,1,14,7,21,0,0,0,5,3,8,136,122,258,291
20192020,042,GRAVES,205,Graves County,"",---District Total---,205,"","",WKEC,908,09,152,145,3,2,5,0,0,0,1,0,1,8,10,18,0,0,0,8,5,13,125,135,260,297
20192020,042,GRAVES,205,Graves County,"",---District Total---,205,"","",WKEC,908,14,1,5,0,0,0,0,0,0,0,0,0,0,0,0,0,0,0,0,0,0,5,1,6,6
20192020,042,GRAVES,205,Graves County,"",---District Total---,205,"","",WKEC,908,All Students,1918,2027,35,28,63,1,1,2,8,11,19,145,137,282,0,1,1,98,86,184,1740,1654,3394,3945
20192020,042,GRAVES,205,Graves County,"",---District Total---,205,"","",WKEC,908,PS,107,140,3,2,5,0,0,0,0,0,0,12,9,21,0,0,0,8,7,15,117,89,206,247
20192020,042,GRAVES,205,Graves County,011,Mayfield Youth Development Center,205011,042205011,210228001754,WKEC,908,09,0,7,3,0,3,0,0,0,0,0,0,0,0,0,0,0,0,2,0,2,2,0,2,7
20192020,042,GRAVES,205,Graves County,011,Mayfield Youth Development Center,205011,042205011,210228001754,WKEC,908,All Students,0,18,5,0,5,0,0,0,1,0,1,0,0,0,0,0,0,3,0,3,9,0,9,18
20192020,042,GRAVES,205,Graves County,011,Mayfield Youth Development Center,205011,042205011,210228001754,WKEC,908,07,0,1,0,0,0,0,0,0,1,0,1,0,0,0,0,0,0,0,0,0,0,0,0,1
20192020,042,GRAVES,205,Graves County,011,Mayfield Youth Development Center,205011,042205011,210228001754,WKEC,908,08,0,1,0,0,0,0,0,0,0,0,0,0,0,0,0,0,0,0,0,0,1,0,1,1
20192020,042,GRAVES,205,Graves County,011,Mayfield Youth Development Center,205011,042205011,210228001754,WKEC,908,10,0,3,1,0,1,0,0,0,0,0,0,0,0,0,0,0,0,1,0,1,1,0,1,3
20192020,042,GRAVES,205,Graves County,011,Mayfield Youth Development Center,205011,042205011,210228001754,WKEC,908,11,0,1,1,0,1,0,0,0,0,0,0,0,0,0,0,0,0,0,0,0,0,0,0,1
20192020,042,GRAVES,205,Graves County,011,Mayfield Youth Development Center,205011,042205011,210228001754,WKEC,908,12,0,5,0,0,0,0,0,0,0,0,0,0,0,0,0,0,0,0,0,0,5,0,5,5
20192020,042,GRAVES,205,Graves County,012,Gateway Academy High School,205012,042205012,210228001924,WKEC,908,08,0,1,0,0,0,0,0,0,0,0,0,0,0,0,0,0,0,0,0,0,1,0,1,1
20192020,042,GRAVES,205,Graves County,012,Gateway Academy High School,205012,042205012,210228001924,WKEC,908,09,0,1,0,0,0,0,0,0,0,0,0,0,0,0,0,0,0,0,0,0,1,0,1,1
20192020,042,GRAVES,205,Graves County,012,Gateway Academy High School,205012,042205012,210228001924,WKEC,908,10,1,3,0,0,0,0,0,0,0,0,0,0,0,0,0,0,0,0,1,1,3,0,3,4
20192020,042,GRAVES,205,Graves County,012,Gateway Academy High School,205012,042205012,210228001924,WKEC,908,11,3,2,0,0,0,0,0,0,0,0,0,0,0,0,0,0,0,0,1,1,2,2,4,5
20192020,042,GRAVES,205,Graves County,012,Gateway Academy High School,205012,042205012,210228001924,WKEC,908,12,19,9,0,1,1,0,0,0,0,0,0,1,3,4,0,1,1,1,1,2,7,13,20,28
20192020,042,GRAVES,205,Graves County,012,Gateway Academy High School,205012,042205012,210228001924,WKEC,908,All Students,23,16,0,1,1,0,0,0,0,0,0,1,3,4,0,1,1,1,3,4,14,15,29,39
20192020,042,GRAVES,205,Graves County,013,Graves County Central Elementary,205013,042205013,210228001992,WKEC,908,02,26,32,0,0,0,0,0,0,0,0,0,3,4,7,0,0,0,1,2,3,28,20,48,58
20192020,042,GRAVES,205,Graves County,013,Graves County Central Elementary,205013,042205013,210228001992,WKEC,908,03,33,26,1,1,2,0,0,0,0,2,2,1,1,2,0,0,0,5,1,6,19,28,47,59
20192020,042,GRAVES,205,Graves County,013,Graves County Central Elementary,205013,042205013,210228001992,WKEC,908,05,35,36,0,0,0,0,0,0,0,1,1,2,5,7,0,0,0,5,2,7,29,27,56,71
20192020,042,GRAVES,205,Graves County,013,Graves County Central Elementary,205013,042205013,210228001992,WKEC,908,04,36,21,1,0,1,0,0,0,0,1,1,4,0,4,0,0,0,0,4,4,16,31,47,57
20192020,042,GRAVES,205,Graves County,013,Graves County Central Elementary,205013,042205013,210228001992,WKEC,908,06,32,30,0,0,0,0,0,0,0,0,0,3,3,6,0,0,0,1,2,3,26,27,53,62
20192020,042,GRAVES,205,Graves County,013,Graves County Central Elementary,205013,042205013,210228001992,WKEC,908,All Students,256,220,3,1,4,0,0,0,0,4,4,21,23,44,0,0,0,15,18,33,181,210,391,476
20192020,042,GRAVES,205,Graves County,013,Graves County Central Elementary,205013,042205013,210228001992,WKEC,908,PS,17,30,1,0,1,0,0,0,0,0,0,7,3,10,0,0,0,1,1,2,21,13,34,47
20192020,042,GRAVES,205,Graves County,013,Graves County Central Elementary,205013,042205013,210228001992,WKEC,908,KG,37,34,1,0,1,0,0,0,0,0,0,5,2,7,0,0,0,1,5,6,27,30,57,71
20192020,042,GRAVES,205,Graves County,013,Graves County Central Elementary,205013,042205013,210228001992,WKEC,908,01,57,41,0,0,0,0,0,0,0,0,0,3,8,11,0,0,0,2,2,4,36,47,83,98
20192020,042,GRAVES,205,Graves County,040,Fancy Farm Elementary School,205040,042205040,210228000471,WKEC,908,04,13,21,0,0,0,0,0,0,0,0,0,1,0,1,0,0,0,0,2,2,20,11,31,34
20192020,042,GRAVES,205,Graves County,040,Fancy Farm Elementary School,205040,042205040,210228000471,WKEC,908,06,18,10,0,0,0,0,0,0,0,0,0,0,0,0,0,0,0,1,1,2,9,17,26,28
20192020,042,GRAVES,205,Graves County,040,Fancy Farm Elementary School,205040,042205040,210228000471,WKEC,908,All Students,80,106,0,0,0,0,0,0,0,0,0,1,2,3,0,0,0,5,8,13,100,70,170,186
20192020,042,GRAVES,205,Graves County,040,Fancy Farm Elementary School,205040,042205040,210228000471,WKEC,908,PS,9,14,0,0,0,0,0,0,0,0,0,0,0,0,0,0,0,2,1,3,12,8,20,23
20192020,042,GRAVES,205,Graves County,040,Fancy Farm Elementary School,205040,042205040,210228000471,WKEC,908,KG,14,12,0,0,0,0,0,0,0,0,0,0,1,1,0,0,0,0,0,0,12,13,25,26
20192020,042,GRAVES,205,Graves County,040,Fancy Farm Elementary School,205040,042205040,210228000471,WKEC,908,01,8,18,0,0,0,0,0,0,0,0,0,0,0,0,0,0,0,2,1,3,16,7,23,26
20192020,042,GRAVES,205,Graves County,040,Fancy Farm Elementary School,205040,042205040,210228000471,WKEC,908,02,10,22,0,0,0,0,0,0,0,0,0,0,1,1,0,0,0,1,3,4,21,6,27,32
20192020,042,GRAVES,205,Graves County,040,Fancy Farm Elementary School,205040,042205040,210228000471,WKEC,908,03,7,13,0,0,0,0,0,0,0,0,0,0,0,0,0,0,0,1,1,2,12,6,18,20
20192020,042,GRAVES,205,Graves County,040,Fancy Farm Elementary School,205040,042205040,210228000471,WKEC,908,05,10,10,0,0,0,0,0,0,0,0,0,0,0,0,0,0,0,0,0,0,10,10,20,20
20192020,042,GRAVES,205,Graves County,060,Farmington Elementary School,205060,042205060,210228000473,WKEC,908,04,19,16,1,0,1,0,0,0,0,0,0,2,2,4,0,0,0,0,1,1,13,16,29,35
20192020,042,GRAVES,205,Graves County,060,Farmington Elementary School,205060,042205060,210228000473,WKEC,908,06,23,19,0,1,1,0,0,0,0,0,0,1,1,2,0,0,0,4,3,7,14,18,32,42
20192020,042,GRAVES,205,Graves County,060,Farmington Elementary School,205060,042205060,210228000473,WKEC,908,All Students,125,122,3,1,4,0,0,0,0,1,1,7,8,15,0,0,0,6,8,14,106,107,213,247
20192020,042,GRAVES,205,Graves County,060,Farmington Elementary School,205060,042205060,210228000473,WKEC,908,PS,11,17,0,0,0,0,0,0,0,0,0,1,1,2,0,0,0,1,1,2,15,9,24,28
20192020,042,GRAVES,205,Graves County,060,Farmington Elementary School,205060,042205060,210228000473,WKEC,908,KG,17,18,0,0,0,0,0,0,0,0,0,1,3,4,0,0,0,0,3,3,17,11,28,35
20192020,042,GRAVES,205,Graves County,060,Farmington Elementary School,205060,042205060,210228000473,WKEC,908,01,17,18,0,0,0,0,0,0,0,0,0,0,1,1,0,0,0,0,0,0,18,16,34,35
20192020,042,GRAVES,205,Graves County,060,Farmington Elementary School,205060,042205060,210228000473,WKEC,908,02,20,17,0,0,0,0,0,0,0,0,0,2,1,3,0,0,0,0,1,1,15,18,33,37
20192020,042,GRAVES,205,Graves County,060,Farmington Elementary School,205060,042205060,210228000473,WKEC,908,03,15,15,0,0,0,0,0,0,0,0,0,0,0,0,0,0,0,1,0,1,14,15,29,30
20192020,042,GRAVES,205,Graves County,060,Farmington Elementary School,205060,042205060,210228000473,WKEC,908,05,14,19,2,0,2,0,0,0,0,1,1,1,0,1,0,0,0,1,0,1,15,13,28,33
20192020,042,GRAVES,205,Graves County,100,Graves County Middle School,205100,042205100,210228001436,WKEC,908,All Students,287,311,4,1,5,0,1,1,1,3,4,32,21,53,0,0,0,18,12,30,256,249,505,598
20192020,042,GRAVES,205,Graves County,100,Graves County Middle School,205100,042205100,210228001436,WKEC,908,08,134,147,1,1,2,0,1,1,0,2,2,13,8,21,0,0,0,9,7,16,124,115,239,281
20192020,042,GRAVES,205,Graves County,100,Graves County Middle School,205100,042205100,210228001436,WKEC,908,07,153,164,3,0,3,0,0,0,1,1,2,19,13,32,0,0,0,9,5,14,132,134,266,317
20192020,042,GRAVES,205,Graves County,110,Lowes Elementary School,205110,042205110,210228000475,WKEC,908,PS,11,19,0,1,1,0,0,0,0,0,0,1,2,3,0,0,0,2,0,2,16,8,24,30
20192020,042,GRAVES,205,Graves County,110,Lowes Elementary School,205110,042205110,210228000475,WKEC,908,All Students,109,130,5,4,9,0,0,0,0,0,0,18,21,39,0,0,0,3,5,8,104,79,183,239
20192020,042,GRAVES,205,Graves County,110,Lowes Elementary School,205110,042205110,210228000475,WKEC,908,KG,22,23,0,1,1,0,0,0,0,0,0,3,5,8,0,0,0,1,0,1,19,16,35,45
20192020,042,GRAVES,205,Graves County,110,Lowes Elementary School,205110,042205110,210228000475,WKEC,908,01,13,18,1,2,3,0,0,0,0,0,0,3,2,5,0,0,0,0,1,1,14,8,22,31
20192020,042,GRAVES,205,Graves County,110,Lowes Elementary School,205110,042205110,210228000475,WKEC,908,02,14,14,1,0,1,0,0,0,0,0,0,3,2,5,0,0,0,0,1,1,10,11,21,28
20192020,042,GRAVES,205,Graves County,110,Lowes Elementary School,205110,042205110,210228000475,WKEC,908,03,16,15,0,1,1,0,0,0,0,0,0,1,5,6,0,0,0,1,0,1,13,10,23,31
20192020,042,GRAVES,205,Graves County,110,Lowes Elementary School,205110,042205110,210228000475,WKEC,908,04,17,18,3,0,3,0,0,0,0,0,0,1,4,5,0,0,0,0,0,0,14,13,27,35
20192020,042,GRAVES,205,Graves County,110,Lowes Elementary School,205110,042205110,210228000475,WKEC,908,05,15,21,0,0,0,0,0,0,0,0,0,4,1,5,0,0,0,0,2,2,17,12,29,36
20192020,042,GRAVES,205,Graves County,110,Lowes Elementary School,205110,042205110,210228000475,WKEC,908,06,12,21,0,0,0,0,0,0,0,0,0,3,2,5,0,0,0,1,1,2,17,9,26,33
20192020,042,GRAVES,205,Graves County,150,Sedalia Elementary School,205150,042205150,210228000477,WKEC,908,05,22,29,1,0,1,0,0,0,0,0,0,2,2,4,0,0,0,3,0,3,23,20,43,51
20192020,042,GRAVES,205,Graves County,150,Sedalia Elementary School,205150,042205150,210228000477,WKEC,908,All Students,157,178,5,7,12,0,0,0,1,0,1,17,11,28,0,0,0,13,9,22,142,130,272,335
20192020,042,GRAVES,205,Graves County,150,Sedalia Elementary School,205150,042205150,210228000477,WKEC,908,PS,20,18,1,0,1,0,0,0,0,0,0,2,3,5,0,0,0,1,0,1,14,17,31,38
20192020,042,GRAVES,205,Graves County,150,Sedalia Elementary School,205150,042205150,210228000477,WKEC,908,06,21,16,0,0,0,0,0,0,0,0,0,2,2,4,0,0,0,0,2,2,14,17,31,37
20192020,042,GRAVES,205,Graves County,150,Sedalia Elementary School,205150,042205150,210228000477,WKEC,908,KG,16,27,1,2,3,0,0,0,0,0,0,4,1,5,0,0,0,2,0,2,20,13,33,43
20192020,042,GRAVES,205,Graves County,150,Sedalia Elementary School,205150,042205150,210228000477,WKEC,908,01,23,28,0,1,1,0,0,0,0,0,0,4,1,5,0,0,0,2,1,3,22,20,42,51
20192020,042,GRAVES,205,Graves County,150,Sedalia Elementary School,205150,042205150,210228000477,WKEC,908,02,20,26,2,2,4,0,0,0,0,0,0,1,0,1,0,0,0,1,3,4,22,15,37,46
20192020,042,GRAVES,205,Graves County,150,Sedalia Elementary School,205150,042205150,210228000477,WKEC,908,03,32,27,1,0,1,0,0,0,1,0,1,1,2,3,0,0,0,3,2,5,21,28,49,59
20192020,042,GRAVES,205,Graves County,150,Sedalia Elementary School,205150,042205150,210228000477,WKEC,908,04,23,25,0,2,2,0,0,0,0,0,0,3,3,6,0,0,0,2,1,3,20,17,37,48
20192020,042,GRAVES,205,Graves County,170,Symsonia Elementary School,205170,042205170,210228000479,WKEC,908,KG,15,14,0,0,0,0,0,0,0,0,0,0,1,1,0,0,0,0,0,0,14,14,28,29
20192020,042,GRAVES,205,Graves County,170,Symsonia Elementary School,205170,042205170,210228000479,WKEC,908,All Students,141,140,2,2,4,1,0,1,0,0,0,2,3,5,0,0,0,4,6,10,131,130,261,281
20192020,042,GRAVES,205,Graves County,170,Symsonia Elementary School,205170,042205170,210228000479,WKEC,908,PS,12,14,0,0,0,0,0,0,0,0,0,0,0,0,0,0,0,0,2,2,14,10,24,26
20192020,042,GRAVES,205,Graves County,170,Symsonia Elementary School,205170,042205170,210228000479,WKEC,908,01,23,24,0,0,0,0,0,0,0,0,0,0,0,0,0,0,0,1,0,1,23,23,46,47
20192020,042,GRAVES,205,Graves County,170,Symsonia Elementary School,205170,042205170,210228000479,WKEC,908,02,15,13,0,0,0,0,0,0,0,0,0,1,0,1,0,0,0,0,1,1,12,14,26,28
20192020,042,GRAVES,205,Graves County,170,Symsonia Elementary School,205170,042205170,210228000479,WKEC,908,03,21,23,0,1,1,1,0,1,0,0,0,0,0,0,0,0,0,0,0,0,22,20,42,44
20192020,042,GRAVES,205,Graves County,170,Symsonia Elementary School,205170,042205170,210228000479,WKEC,908,04,19,16,0,0,0,0,0,0,0,0,0,0,0,0,0,0,0,1,0,1,15,19,34,35
20192020,042,GRAVES,205,Graves County,170,Symsonia Elementary School,205170,042205170,210228000479,WKEC,908,05,24,25,0,1,1,0,0,0,0,0,0,0,0,0,0,0,0,1,2,3,24,21,45,49
20192020,042,GRAVES,205,Graves County,170,Symsonia Elementary School,205170,042205170,210228000479,WKEC,908,06,24,25,2,0,2,0,0,0,0,0,0,1,2,3,0,0,0,1,3,4,21,19,40,49
20192020,042,GRAVES,205,Graves County,200,Wingo Elementary School,205200,042205200,210228000481,WKEC,908,04,24,39,1,0,1,0,0,0,1,0,1,2,0,2,0,0,0,3,1,4,32,23,55,63
20192020,042,GRAVES,205,Graves County,200,Wingo Elementary School,205200,042205200,210228000481,WKEC,908,06,20,28,1,2,3,0,0,0,0,0,0,0,2,2,0,0,0,2,3,5,25,13,38,48
20192020,042,GRAVES,205,Graves County,200,Wingo Elementary School,205200,042205200,210228000481,WKEC,908,03,19,29,1,0,1,0,0,0,0,0,0,1,0,1,0,0,0,1,0,1,26,19,45,48
20192020,042,GRAVES,205,Graves County,200,Wingo Elementary School,205200,042205200,210228000481,WKEC,908,All Students,166,211,5,4,9,0,0,0,1,1,2,9,7,16,0,0,0,11,4,15,185,150,335,377
20192020,042,GRAVES,205,Graves County,200,Wingo Elementary School,205200,042205200,210228000481,WKEC,908,05,30,32,0,1,1,0,0,0,0,0,0,1,3,4,0,0,0,0,0,0,31,26,57,62
20192020,042,GRAVES,205,Graves County,200,Wingo Elementary School,205200,042205200,210228000481,WKEC,908,PS,27,28,1,1,2,0,0,0,0,0,0,1,0,1,0,0,0,1,2,3,25,24,49,55
20192020,042,GRAVES,205,Graves County,200,Wingo Elementary School,205200,042205200,210228000481,WKEC,908,KG,27,33,1,0,1,0,0,0,0,1,1,3,1,4,0,0,0,2,0,2,27,25,52,60
20192020,042,GRAVES,205,Graves County,200,Wingo Elementary School,205200,042205200,210228000481,WKEC,908,01,32,22,0,1,1,0,0,0,0,0,0,1,1,2,0,0,0,1,0,1,20,30,50,54
20192020,042,GRAVES,205,Graves County,200,Wingo Elementary School,205200,042205200,210228000481,WKEC,908,02,14,28,1,0,1,0,0,0,0,0,0,1,0,1,0,0,0,2,0,2,24,14,38,42
20192020,042,GRAVES,205,Graves County,215,Graves County High School,205215,042205215,210228001490,WKEC,908,09,152,137,0,2,2,0,0,0,1,0,1,8,10,18,0,0,0,6,5,11,122,135,257,289
20192020,042,GRAVES,205,Graves County,215,Graves County High School,205215,042205215,210228001490,WKEC,908,11,130,155,2,0,2,0,0,0,0,1,1,14,7,21,0,0,0,5,2,7,134,120,254,285
20192020,042,GRAVES,205,Graves County,215,Graves County High School,205215,042205215,210228001490,WKEC,908,14,1,5,0,0,0,0,0,0,0,0,0,0,0,0,0,0,0,0,0,0,5,1,6,6
20192020,042,GRAVES,205,Graves County,215,Graves County High School,205215,042205215,210228001490,WKEC,908,12,146,138,1,3,4,0,0,0,0,0,0,9,9,18,0,0,0,3,2,5,125,132,257,284
20192020,042,GRAVES,205,Graves County,215,Graves County High School,205215,042205215,210228001490,WKEC,908,All Students,574,575,3,7,10,0,0,0,4,2,6,37,38,75,0,0,0,19,13,32,512,514,1026,1149
20192020,042,GRAVES,205,Graves County,215,Graves County High School,205215,042205215,210228001490,WKEC,908,10,145,140,0,2,2,0,0,0,3,1,4,6,12,18,0,0,0,5,4,9,126,126,252,285
20192020,043,GRAYSON,211,Grayson County,"",---District Total---,211,"","",GRREC,902,09,157,192,0,0,0,2,0,2,0,0,0,4,4,8,0,0,0,4,3,7,182,150,332,349
20192020,043,GRAYSON,211,Grayson County,"",---District Total---,211,"","",GRREC,902,All Students,1914,2110,9,6,15,4,4,8,7,4,11,33,38,71,0,0,0,33,44,77,2024,1818,3842,4024
20192020,043,GRAYSON,211,Grayson County,"",---District Total---,211,"","",GRREC,902,PS,89,132,0,0,0,0,0,0,0,0,0,2,2,4,0,0,0,3,4,7,127,83,210,221
20192020,043,GRAYSON,211,Grayson County,"",---District Total---,211,"","",GRREC,902,KG,149,136,0,2,2,0,0,0,0,0,0,1,3,4,0,0,0,1,6,7,134,138,272,285
20192020,043,GRAYSON,211,Grayson County,"",---District Total---,211,"","",GRREC,902,01,162,165,1,0,1,0,1,1,1,1,2,3,2,5,0,0,0,7,3,10,153,155,308,327
20192020,043,GRAYSON,211,Grayson County,"",---District Total---,211,"","",GRREC,902,02,136,152,0,0,0,0,1,1,2,0,2,3,1,4,0,0,0,3,3,6,144,131,275,288
20192020,043,GRAYSON,211,Grayson County,"",---District Total---,211,"","",GRREC,902,03,136,124,2,0,2,0,0,0,0,1,1,5,2,7,0,0,0,2,2,4,115,131,246,260
20192020,043,GRAYSON,211,Grayson County,"",---District Total---,211,"","",GRREC,902,04,142,146,2,2,4,0,0,0,1,0,1,0,4,4,0,0,0,2,1,3,141,135,276,288
20192020,043,GRAYSON,211,Grayson County,"",---District Total---,211,"","",GRREC,902,05,143,171,1,0,1,1,0,1,0,0,0,3,6,9,0,0,0,2,4,6,164,133,297,314
20192020,043,GRAYSON,211,Grayson County,"",---District Total---,211,"","",GRREC,902,06,149,165,0,0,0,0,0,0,0,0,0,3,3,6,0,0,0,2,5,7,160,141,301,314
20192020,043,GRAYSON,211,Grayson County,"",---District Total---,211,"","",GRREC,902,07,138,194,1,0,1,1,1,2,2,1,3,3,4,7,0,0,0,3,4,7,184,128,312,332
20192020,043,GRAYSON,211,Grayson County,"",---District Total---,211,"","",GRREC,902,08,160,168,0,0,0,0,1,1,1,0,1,1,3,4,0,0,0,1,3,4,165,153,318,328
20192020,043,GRAYSON,211,Grayson County,"",---District Total---,211,"","",GRREC,902,11,149,162,0,2,2,0,0,0,0,0,0,3,3,6,0,0,0,2,2,4,157,142,299,311
20192020,043,GRAYSON,211,Grayson County,"",---District Total---,211,"","",GRREC,902,12,156,163,0,0,0,0,0,0,0,1,1,1,2,3,0,0,0,1,4,5,161,149,310,319
20192020,043,GRAYSON,211,Grayson County,"",---District Total---,211,"","",GRREC,902,14,0,2,0,0,0,0,0,0,0,0,0,0,0,0,0,0,0,0,0,0,2,0,2,2
20192020,043,GRAYSON,211,Grayson County,"",---District Total---,211,"","",GRREC,902,10,137,170,2,0,2,0,0,0,0,0,0,3,1,4,0,0,0,3,4,7,162,132,294,307
20192020,043,GRAYSON,211,Grayson County,010,H W Wilkey Elementary School,211010,043211010,210230000483,GRREC,902,05,31,43,1,0,1,0,0,0,0,0,0,0,3,3,0,0,0,0,2,2,42,26,68,74
20192020,043,GRAYSON,211,Grayson County,010,H W Wilkey Elementary School,211010,043211010,210230000483,GRREC,902,All Students,213,224,3,1,4,0,1,1,2,0,2,5,7,12,0,0,0,4,13,17,210,191,401,437
20192020,043,GRAYSON,211,Grayson County,010,H W Wilkey Elementary School,211010,043211010,210230000483,GRREC,902,PS,38,64,0,0,0,0,0,0,0,0,0,1,1,2,0,0,0,3,2,5,60,35,95,102
20192020,043,GRAYSON,211,Grayson County,010,H W Wilkey Elementary School,211010,043211010,210230000483,GRREC,902,KG,36,41,0,0,0,0,0,0,0,0,0,1,0,1,0,0,0,1,4,5,39,32,71,77
20192020,043,GRAYSON,211,Grayson County,010,H W Wilkey Elementary School,211010,043211010,210230000483,GRREC,902,01,39,42,1,0,1,0,0,0,1,0,1,1,1,2,0,0,0,2,3,5,37,35,72,81
20192020,043,GRAYSON,211,Grayson County,010,H W Wilkey Elementary School,211010,043211010,210230000483,GRREC,902,02,38,36,0,0,0,0,1,1,0,0,0,1,1,2,0,0,0,1,3,4,34,33,67,74
20192020,043,GRAYSON,211,Grayson County,010,H W Wilkey Elementary School,211010,043211010,210230000483,GRREC,902,03,27,26,0,0,0,0,0,0,0,0,0,2,0,2,0,0,0,0,1,1,24,26,50,53
20192020,043,GRAYSON,211,Grayson County,010,H W Wilkey Elementary School,211010,043211010,210230000483,GRREC,902,04,42,36,1,1,2,0,0,0,1,0,1,0,2,2,0,0,0,0,0,0,34,39,73,78
20192020,043,GRAYSON,211,Grayson County,030,Caneyville Elementary School,211030,043211030,210230000484,GRREC,902,04,23,35,1,0,1,0,0,0,0,0,0,0,0,0,0,0,0,2,0,2,32,23,55,58
20192020,043,GRAYSON,211,Grayson County,030,Caneyville Elementary School,211030,043211030,210230000484,GRREC,902,All Students,174,178,2,2,4,0,0,0,0,0,0,0,1,1,0,0,0,5,2,7,171,169,340,352
20192020,043,GRAYSON,211,Grayson County,030,Caneyville Elementary School,211030,043211030,210230000484,GRREC,902,PS,18,21,0,0,0,0,0,0,0,0,0,0,1,1,0,0,0,0,0,0,21,17,38,39
20192020,043,GRAYSON,211,Grayson County,030,Caneyville Elementary School,211030,043211030,210230000484,GRREC,902,KG,35,27,0,2,2,0,0,0,0,0,0,0,1,1,0,0,0,0,1,1,27,31,58,62
20192020,043,GRAYSON,211,Grayson County,030,Caneyville Elementary School,211030,043211030,210230000484,GRREC,902,01,31,31,0,0,0,0,0,0,0,0,0,0,0,0,0,0,0,2,0,2,29,31,60,62
20192020,043,GRAYSON,211,Grayson County,030,Caneyville Elementary School,211030,043211030,210230000484,GRREC,902,02,27,35,0,0,0,0,0,0,0,0,0,0,0,0,0,0,0,0,0,0,35,27,62,62
20192020,043,GRAYSON,211,Grayson County,030,Caneyville Elementary School,211030,043211030,210230000484,GRREC,902,03,26,20,1,0,1,0,0,0,0,0,0,0,0,0,0,0,0,0,0,0,19,26,45,46
20192020,043,GRAYSON,211,Grayson County,030,Caneyville Elementary School,211030,043211030,210230000484,GRREC,902,05,32,30,0,0,0,0,0,0,0,0,0,0,0,0,0,0,0,1,1,2,29,31,60,62
20192020,043,GRAYSON,211,Grayson County,050,Oran P Lawler Elementary School,211050,043211050,210230001702,GRREC,902,02,27,30,0,0,0,0,0,0,2,0,2,1,0,1,0,0,0,0,0,0,27,27,54,57
20192020,043,GRAYSON,211,Grayson County,050,Oran P Lawler Elementary School,211050,043211050,210230001702,GRREC,902,All Students,203,212,0,0,0,1,1,2,2,1,3,5,5,10,0,0,0,3,2,5,201,194,395,415
20192020,043,GRAYSON,211,Grayson County,050,Oran P Lawler Elementary School,211050,043211050,210230001702,GRREC,902,PS,10,9,0,0,0,0,0,0,0,0,0,1,0,1,0,0,0,0,1,1,8,9,17,19
20192020,043,GRAYSON,211,Grayson County,050,Oran P Lawler Elementary School,211050,043211050,210230001702,GRREC,902,KG,36,32,0,0,0,0,0,0,0,0,0,0,0,0,0,0,0,0,1,1,32,35,67,68
20192020,043,GRAYSON,211,Grayson County,050,Oran P Lawler Elementary School,211050,043211050,210230001702,GRREC,902,01,47,43,0,0,0,0,1,1,0,1,1,0,1,1,0,0,0,2,0,2,41,44,85,90
20192020,043,GRAYSON,211,Grayson County,050,Oran P Lawler Elementary School,211050,043211050,210230001702,GRREC,902,03,31,30,0,0,0,0,0,0,0,0,0,3,1,4,0,0,0,1,1,2,26,29,55,61
20192020,043,GRAYSON,211,Grayson County,050,Oran P Lawler Elementary School,211050,043211050,210230001702,GRREC,902,04,28,34,0,0,0,0,0,0,0,0,0,0,1,1,0,0,0,0,0,0,34,27,61,62
20192020,043,GRAYSON,211,Grayson County,050,Oran P Lawler Elementary School,211050,043211050,210230001702,GRREC,902,05,34,43,0,0,0,1,0,1,0,0,0,1,2,3,0,0,0,0,0,0,41,32,73,77
20192020,043,GRAYSON,211,Grayson County,080,Clarkson Elementary School,211080,043211080,210230000485,GRREC,902,05,46,55,0,0,0,0,0,0,0,0,0,2,1,3,0,0,0,1,1,2,52,44,96,101
20192020,043,GRAYSON,211,Grayson County,080,Clarkson Elementary School,211080,043211080,210230000485,GRREC,902,All Students,278,280,1,1,2,0,0,0,0,1,1,5,5,10,0,0,0,5,2,7,269,269,538,558
20192020,043,GRAYSON,211,Grayson County,080,Clarkson Elementary School,211080,043211080,210230000485,GRREC,902,PS,23,38,0,0,0,0,0,0,0,0,0,0,0,0,0,0,0,0,1,1,38,22,60,61
20192020,043,GRAYSON,211,Grayson County,080,Clarkson Elementary School,211080,043211080,210230000485,GRREC,902,KG,42,36,0,0,0,0,0,0,0,0,0,0,2,2,0,0,0,0,0,0,36,40,76,78
20192020,043,GRAYSON,211,Grayson County,080,Clarkson Elementary School,211080,043211080,210230000485,GRREC,902,01,45,49,0,0,0,0,0,0,0,0,0,2,0,2,0,0,0,1,0,1,46,45,91,94
20192020,043,GRAYSON,211,Grayson County,080,Clarkson Elementary School,211080,043211080,210230000485,GRREC,902,02,44,51,0,0,0,0,0,0,0,0,0,1,0,1,0,0,0,2,0,2,48,44,92,95
20192020,043,GRAYSON,211,Grayson County,080,Clarkson Elementary School,211080,043211080,210230000485,GRREC,902,03,52,48,1,0,1,0,0,0,0,1,1,0,1,1,0,0,0,1,0,1,46,50,96,100
20192020,043,GRAYSON,211,Grayson County,080,Clarkson Elementary School,211080,043211080,210230000485,GRREC,902,04,49,41,0,1,1,0,0,0,0,0,0,0,1,1,0,0,0,0,1,1,41,46,87,90
20192020,043,GRAYSON,211,Grayson County,085,Grayson County High School,211085,043211085,210230000486,GRREC,902,12,156,163,0,0,0,0,0,0,0,1,1,1,2,3,0,0,0,1,4,5,161,149,310,319
20192020,043,GRAYSON,211,Grayson County,085,Grayson County High School,211085,043211085,210230000486,GRREC,902,All Students,615,697,2,2,4,2,0,2,0,1,1,11,10,21,0,0,0,10,13,23,672,589,1261,1312
20192020,043,GRAYSON,211,Grayson County,085,Grayson County High School,211085,043211085,210230000486,GRREC,902,08,16,8,0,0,0,0,0,0,0,0,0,0,0,0,0,0,0,0,0,0,8,16,24,24
20192020,043,GRAYSON,211,Grayson County,085,Grayson County High School,211085,043211085,210230000486,GRREC,902,09,157,192,0,0,0,2,0,2,0,0,0,4,4,8,0,0,0,4,3,7,182,150,332,349
20192020,043,GRAYSON,211,Grayson County,085,Grayson County High School,211085,043211085,210230000486,GRREC,902,10,137,170,2,0,2,0,0,0,0,0,0,3,1,4,0,0,0,3,4,7,162,132,294,307
20192020,043,GRAYSON,211,Grayson County,085,Grayson County High School,211085,043211085,210230000486,GRREC,902,11,149,162,0,2,2,0,0,0,0,0,0,3,3,6,0,0,0,2,2,4,157,142,299,311
20192020,043,GRAYSON,211,Grayson County,085,Grayson County High School,211085,043211085,210230000486,GRREC,902,14,0,2,0,0,0,0,0,0,0,0,0,0,0,0,0,0,0,0,0,0,2,0,2,2
20192020,043,GRAYSON,211,Grayson County,095,Grayson County Middle School,211095,043211095,210230000487,GRREC,902,06,149,165,0,0,0,0,0,0,0,0,0,3,3,6,0,0,0,2,5,7,160,141,301,314
20192020,043,GRAYSON,211,Grayson County,095,Grayson County Middle School,211095,043211095,210230000487,GRREC,902,08,144,160,0,0,0,0,1,1,1,0,1,1,3,4,0,0,0,1,3,4,157,137,294,304
20192020,043,GRAYSON,211,Grayson County,095,Grayson County Middle School,211095,043211095,210230000487,GRREC,902,All Students,431,519,1,0,1,1,2,3,3,1,4,7,10,17,0,0,0,6,12,18,501,406,907,950
20192020,043,GRAYSON,211,Grayson County,095,Grayson County Middle School,211095,043211095,210230000487,GRREC,902,07,138,194,1,0,1,1,1,2,2,1,3,3,4,7,0,0,0,3,4,7,184,128,312,332
20192020,043,GRAYSON,211,Grayson County,220,Grayson Co. Alternative Education,211220,043211220,210230001852,GRREC,902,All Students,0,0,0,0,0,0,0,0,0,0,0,0,0,0,0,0,0,0,0,0,0,0,0,0
20192020,043,GRAYSON,211,Grayson County,220,Grayson Co. Alternative Education,211220,043211220,210230001852,GRREC,902,06,0,0,0,0,0,0,0,0,0,0,0,0,0,0,0,0,0,0,0,0,0,0,0,0
20192020,043,GRAYSON,211,Grayson County,220,Grayson Co. Alternative Education,211220,043211220,210230001852,GRREC,902,07,0,0,0,0,0,0,0,0,0,0,0,0,0,0,0,0,0,0,0,0,0,0,0,0
20192020,043,GRAYSON,211,Grayson County,220,Grayson Co. Alternative Education,211220,043211220,210230001852,GRREC,902,08,0,0,0,0,0,0,0,0,0,0,0,0,0,0,0,0,0,0,0,0,0,0,0,0
20192020,043,GRAYSON,211,Grayson County,220,Grayson Co. Alternative Education,211220,043211220,210230001852,GRREC,902,09,0,0,0,0,0,0,0,0,0,0,0,0,0,0,0,0,0,0,0,0,0,0,0,0
20192020,043,GRAYSON,211,Grayson County,220,Grayson Co. Alternative Education,211220,043211220,210230001852,GRREC,902,10,0,0,0,0,0,0,0,0,0,0,0,0,0,0,0,0,0,0,0,0,0,0,0,0
20192020,043,GRAYSON,211,Grayson County,220,Grayson Co. Alternative Education,211220,043211220,210230001852,GRREC,902,11,0,0,0,0,0,0,0,0,0,0,0,0,0,0,0,0,0,0,0,0,0,0,0,0
20192020,043,GRAYSON,211,Grayson County,220,Grayson Co. Alternative Education,211220,043211220,210230001852,GRREC,902,12,0,0,0,0,0,0,0,0,0,0,0,0,0,0,0,0,0,0,0,0,0,0,0,0
20192020,043,GRAYSON,211,Grayson County,908,Grayson County Area Vocational Ed Center,211908,043211908,210230002381,GRREC,902,12,0,0,0,0,0,0,0,0,0,0,0,0,0,0,0,0,0,0,0,0,0,0,0,0
20192020,043,GRAYSON,211,Grayson County,908,Grayson County Area Vocational Ed Center,211908,043211908,210230002381,GRREC,902,09,0,0,0,0,0,0,0,0,0,0,0,0,0,0,0,0,0,0,0,0,0,0,0,0
20192020,043,GRAYSON,211,Grayson County,908,Grayson County Area Vocational Ed Center,211908,043211908,210230002381,GRREC,902,10,0,0,0,0,0,0,0,0,0,0,0,0,0,0,0,0,0,0,0,0,0,0,0,0
20192020,043,GRAYSON,211,Grayson County,908,Grayson County Area Vocational Ed Center,211908,043211908,210230002381,GRREC,902,All Students,0,0,0,0,0,0,0,0,0,0,0,0,0,0,0,0,0,0,0,0,0,0,0,0
20192020,043,GRAYSON,211,Grayson County,908,Grayson County Area Vocational Ed Center,211908,043211908,210230002381,GRREC,902,11,0,0,0,0,0,0,0,0,0,0,0,0,0,0,0,0,0,0,0,0,0,0,0,0
20192020,044,GREEN,215,Green County,"",---District Total---,215,"","",GRREC,902,02,49,59,1,0,1,0,0,0,0,0,0,2,5,7,0,0,0,3,0,3,53,44,97,108
20192020,044,GREEN,215,Green County,"",---District Total---,215,"","",GRREC,902,03,53,68,0,0,0,0,0,0,0,0,0,1,1,2,0,0,0,2,3,5,65,49,114,121
20192020,044,GREEN,215,Green County,"",---District Total---,215,"","",GRREC,902,04,58,52,2,0,2,0,0,0,0,0,0,2,2,4,0,0,0,4,0,4,44,56,100,110
20192020,044,GREEN,215,Green County,"",---District Total---,215,"","",GRREC,902,05,63,69,2,0,2,0,1,1,0,0,0,3,2,5,0,0,0,4,1,5,60,59,119,132
20192020,044,GREEN,215,Green County,"",---District Total---,215,"","",GRREC,902,06,66,63,2,2,4,0,0,0,1,0,1,1,3,4,0,0,0,2,2,4,57,59,116,129
20192020,044,GREEN,215,Green County,"",---District Total---,215,"","",GRREC,902,07,64,61,1,0,1,0,0,0,0,1,1,3,3,6,0,0,0,2,3,5,55,57,112,125
20192020,044,GREEN,215,Green County,"",---District Total---,215,"","",GRREC,902,08,57,56,0,1,1,0,0,0,0,0,0,2,2,4,0,0,0,3,2,5,51,52,103,113
20192020,044,GREEN,215,Green County,"",---District Total---,215,"","",GRREC,902,09,60,58,1,1,2,0,0,0,0,0,0,2,1,3,0,0,0,3,1,4,52,57,109,118
20192020,044,GREEN,215,Green County,"",---District Total---,215,"","",GRREC,902,10,54,72,4,0,4,0,0,0,1,0,1,3,0,3,0,0,0,2,0,2,62,54,116,126
20192020,044,GREEN,215,Green County,"",---District Total---,215,"","",GRREC,902,12,54,67,2,0,2,1,0,1,0,0,0,1,0,1,0,0,0,1,1,2,62,53,115,121
20192020,044,GREEN,215,Green County,"",---District Total---,215,"","",GRREC,902,11,54,55,0,1,1,0,0,0,1,0,1,2,1,3,0,0,0,0,4,4,52,48,100,109
20192020,044,GREEN,215,Green County,"",---District Total---,215,"","",GRREC,902,All Students,763,810,16,7,23,1,1,2,4,2,6,26,29,55,0,0,0,29,21,50,734,703,1437,1573
20192020,044,GREEN,215,Green County,"",---District Total---,215,"","",GRREC,902,PS,39,38,0,1,1,0,0,0,0,0,0,1,3,4,0,0,0,2,2,4,35,33,68,77
20192020,044,GREEN,215,Green County,"",---District Total---,215,"","",GRREC,902,KG,57,64,0,0,0,0,0,0,0,1,1,2,2,4,0,0,0,2,2,4,60,52,112,121
20192020,044,GREEN,215,Green County,"",---District Total---,215,"","",GRREC,902,01,74,66,1,2,3,0,0,0,1,0,1,2,7,9,0,0,0,1,2,3,61,63,124,140
20192020,044,GREEN,215,Green County,030,Green County Primary School,215030,044215030,210234002244,GRREC,902,KG,57,64,0,0,0,0,0,0,0,1,1,2,2,4,0,0,0,2,2,4,60,52,112,121
20192020,044,GREEN,215,Green County,030,Green County Primary School,215030,044215030,210234002244,GRREC,902,02,49,59,1,0,1,0,0,0,0,0,0,2,5,7,0,0,0,3,0,3,53,44,97,108
20192020,044,GREEN,215,Green County,030,Green County Primary School,215030,044215030,210234002244,GRREC,902,All Students,180,189,2,2,4,0,0,0,1,1,2,6,14,20,0,0,0,6,4,10,174,159,333,369
20192020,044,GREEN,215,Green County,030,Green County Primary School,215030,044215030,210234002244,GRREC,902,PS,39,38,0,1,1,0,0,0,0,0,0,1,3,4,0,0,0,2,2,4,35,33,68,77
20192020,044,GREEN,215,Green County,030,Green County Primary School,215030,044215030,210234002244,GRREC,902,01,74,66,1,2,3,0,0,0,1,0,1,2,7,9,0,0,0,1,2,3,61,63,124,140
20192020,044,GREEN,215,Green County,040,Green County Intermediate School,215040,044215040,210234002257,GRREC,902,All Students,174,189,4,0,4,0,1,1,0,0,0,6,5,11,0,0,0,10,4,14,169,164,333,363
20192020,044,GREEN,215,Green County,040,Green County Intermediate School,215040,044215040,210234002257,GRREC,902,05,63,69,2,0,2,0,1,1,0,0,0,3,2,5,0,0,0,4,1,5,60,59,119,132
20192020,044,GREEN,215,Green County,040,Green County Intermediate School,215040,044215040,210234002257,GRREC,902,04,58,52,2,0,2,0,0,0,0,0,0,2,2,4,0,0,0,4,0,4,44,56,100,110
20192020,044,GREEN,215,Green County,040,Green County Intermediate School,215040,044215040,210234002257,GRREC,902,03,53,68,0,0,0,0,0,0,0,0,0,1,1,2,0,0,0,2,3,5,65,49,114,121
20192020,044,GREEN,215,Green County,055,Green County Middle School,215055,044215055,210234001526,GRREC,902,07,64,61,1,0,1,0,0,0,0,1,1,3,3,6,0,0,0,2,3,5,55,57,112,125
20192020,044,GREEN,215,Green County,055,Green County Middle School,215055,044215055,210234001526,GRREC,902,All Students,187,180,3,3,6,0,0,0,1,1,2,6,8,14,0,0,0,7,7,14,163,168,331,367
20192020,044,GREEN,215,Green County,055,Green County Middle School,215055,044215055,210234001526,GRREC,902,06,66,63,2,2,4,0,0,0,1,0,1,1,3,4,0,0,0,2,2,4,57,59,116,129
20192020,044,GREEN,215,Green County,055,Green County Middle School,215055,044215055,210234001526,GRREC,902,08,57,56,0,1,1,0,0,0,0,0,0,2,2,4,0,0,0,3,2,5,51,52,103,113
20192020,044,GREEN,215,Green County,065,Green County High School,215065,044215065,210234000490,GRREC,902,11,54,55,0,1,1,0,0,0,1,0,1,2,1,3,0,0,0,0,4,4,52,48,100,109
20192020,044,GREEN,215,Green County,065,Green County High School,215065,044215065,210234000490,GRREC,902,All Students,222,252,7,2,9,1,0,1,2,0,2,8,2,10,0,0,0,6,6,12,228,212,440,474
20192020,044,GREEN,215,Green County,065,Green County High School,215065,044215065,210234000490,GRREC,902,12,54,67,2,0,2,1,0,1,0,0,0,1,0,1,0,0,0,1,1,2,62,53,115,121
20192020,044,GREEN,215,Green County,065,Green County High School,215065,044215065,210234000490,GRREC,902,10,54,72,4,0,4,0,0,0,1,0,1,3,0,3,0,0,0,2,0,2,62,54,116,126
20192020,044,GREEN,215,Green County,065,Green County High School,215065,044215065,210234000490,GRREC,902,09,60,58,1,1,2,0,0,0,0,0,0,2,1,3,0,0,0,3,1,4,52,57,109,118
20192020,045,GREENUP,221,Greenup County,"",---District Total---,221,"","",KEDC,903,08,119,115,0,0,0,1,0,1,1,0,1,2,1,3,0,0,0,1,1,2,110,117,227,234
20192020,045,GREENUP,221,Greenup County,"",---District Total---,221,"","",KEDC,903,All Students,1282,1417,13,12,25,2,3,5,4,1,5,26,22,48,0,0,0,25,22,47,1347,1222,2569,2699
20192020,045,GREENUP,221,Greenup County,"",---District Total---,221,"","",KEDC,903,PS,64,67,0,0,0,0,0,0,1,0,1,1,3,4,0,0,0,1,2,3,64,59,123,131
20192020,045,GREENUP,221,Greenup County,"",---District Total---,221,"","",KEDC,903,KG,102,123,1,0,1,0,0,0,1,1,2,2,1,3,0,0,0,2,1,3,117,99,216,225
20192020,045,GREENUP,221,Greenup County,"",---District Total---,221,"","",KEDC,903,01,98,83,0,1,1,0,0,0,0,0,0,3,3,6,0,0,0,0,3,3,80,91,171,181
20192020,045,GREENUP,221,Greenup County,"",---District Total---,221,"","",KEDC,903,02,77,107,2,2,4,0,0,0,0,0,0,2,0,2,0,0,0,3,1,4,100,74,174,184
20192020,045,GREENUP,221,Greenup County,"",---District Total---,221,"","",KEDC,903,03,92,107,2,0,2,0,1,1,0,0,0,4,1,5,0,0,0,3,1,4,98,89,187,199
20192020,045,GREENUP,221,Greenup County,"",---District Total---,221,"","",KEDC,903,04,85,105,0,1,1,0,0,0,0,0,0,1,2,3,0,0,0,1,0,1,103,82,185,190
20192020,045,GREENUP,221,Greenup County,"",---District Total---,221,"","",KEDC,903,05,110,113,1,1,2,0,1,1,0,0,0,2,2,4,0,0,0,3,3,6,107,103,210,223
20192020,045,GREENUP,221,Greenup County,"",---District Total---,221,"","",KEDC,903,06,119,113,2,4,6,0,0,0,1,0,1,2,4,6,0,0,0,3,4,7,105,107,212,232
20192020,045,GREENUP,221,Greenup County,"",---District Total---,221,"","",KEDC,903,07,90,111,0,0,0,0,0,0,1,0,1,2,1,3,0,0,0,3,1,4,105,88,193,201
20192020,045,GREENUP,221,Greenup County,"",---District Total---,221,"","",KEDC,903,09,134,135,0,0,0,0,0,0,0,0,0,1,3,4,0,0,0,4,3,7,130,128,258,269
20192020,045,GREENUP,221,Greenup County,"",---District Total---,221,"","",KEDC,903,10,100,109,1,2,3,0,0,0,0,0,0,1,1,2,0,0,0,1,1,2,106,96,202,209
20192020,045,GREENUP,221,Greenup County,"",---District Total---,221,"","",KEDC,903,11,90,103,2,0,2,0,1,1,0,0,0,1,1,2,0,0,0,1,2,3,99,86,185,193
20192020,045,GREENUP,221,Greenup County,"",---District Total---,221,"","",KEDC,903,12,66,93,2,1,3,1,0,1,0,0,0,3,2,5,0,0,0,0,1,1,87,62,149,159
20192020,045,GREENUP,221,Greenup County,010,Argillite Elementary School,221010,045221010,210240000493,KEDC,903,05,20,19,0,0,0,0,1,1,0,0,0,0,0,0,0,0,0,0,0,0,19,19,38,39
20192020,045,GREENUP,221,Greenup County,010,Argillite Elementary School,221010,045221010,210240000493,KEDC,903,All Students,114,107,1,0,1,0,1,1,0,0,0,1,3,4,0,0,0,1,3,4,104,107,211,221
20192020,045,GREENUP,221,Greenup County,010,Argillite Elementary School,221010,045221010,210240000493,KEDC,903,PS,17,7,0,0,0,0,0,0,0,0,0,0,2,2,0,0,0,0,2,2,7,13,20,24
20192020,045,GREENUP,221,Greenup County,010,Argillite Elementary School,221010,045221010,210240000493,KEDC,903,KG,34,15,0,0,0,0,0,0,0,0,0,0,0,0,0,0,0,0,1,1,15,33,48,49
20192020,045,GREENUP,221,Greenup County,010,Argillite Elementary School,221010,045221010,210240000493,KEDC,903,01,15,8,0,0,0,0,0,0,0,0,0,0,1,1,0,0,0,0,2,2,8,12,20,23
20192020,045,GREENUP,221,Greenup County,010,Argillite Elementary School,221010,045221010,210240000493,KEDC,903,02,11,22,1,0,1,0,0,0,0,0,0,1,0,1,0,0,0,1,0,1,19,11,30,33
20192020,045,GREENUP,221,Greenup County,010,Argillite Elementary School,221010,045221010,210240000493,KEDC,903,03,19,19,0,0,0,0,0,0,0,0,0,0,1,1,0,0,0,0,0,0,19,18,37,38
20192020,045,GREENUP,221,Greenup County,010,Argillite Elementary School,221010,045221010,210240000493,KEDC,903,04,15,24,0,0,0,0,0,0,0,0,0,0,1,1,0,0,0,0,0,0,24,14,38,39
20192020,045,GREENUP,221,Greenup County,024,Wurtland Middle School,221024,045221024,210240001610,KEDC,903,07,36,49,0,0,0,0,0,0,0,0,0,0,0,0,0,0,0,0,0,0,49,36,85,85
20192020,045,GREENUP,221,Greenup County,024,Wurtland Middle School,221024,045221024,210240001610,KEDC,903,All Students,145,170,2,3,5,0,0,0,1,0,1,3,1,4,0,0,0,0,2,2,164,139,303,315
20192020,045,GREENUP,221,Greenup County,024,Wurtland Middle School,221024,045221024,210240001610,KEDC,903,06,54,63,2,3,5,0,0,0,1,0,1,2,1,3,0,0,0,0,1,1,58,49,107,117
20192020,045,GREENUP,221,Greenup County,024,Wurtland Middle School,221024,045221024,210240001610,KEDC,903,08,55,58,0,0,0,0,0,0,0,0,0,1,0,1,0,0,0,0,1,1,57,54,111,113
20192020,045,GREENUP,221,Greenup County,027,Greenup County High School,221027,045221027,210240000496,KEDC,903,11,90,103,2,0,2,0,1,1,0,0,0,1,1,2,0,0,0,1,2,3,99,86,185,193
20192020,045,GREENUP,221,Greenup County,027,Greenup County High School,221027,045221027,210240000496,KEDC,903,All Students,390,440,5,3,8,1,1,2,0,0,0,6,7,13,0,0,0,6,7,13,422,372,794,830
20192020,045,GREENUP,221,Greenup County,027,Greenup County High School,221027,045221027,210240000496,KEDC,903,09,134,135,0,0,0,0,0,0,0,0,0,1,3,4,0,0,0,4,3,7,130,128,258,269
20192020,045,GREENUP,221,Greenup County,027,Greenup County High School,221027,045221027,210240000496,KEDC,903,10,100,109,1,2,3,0,0,0,0,0,0,1,1,2,0,0,0,1,1,2,106,96,202,209
20192020,045,GREENUP,221,Greenup County,027,Greenup County High School,221027,045221027,210240000496,KEDC,903,12,66,93,2,1,3,1,0,1,0,0,0,3,2,5,0,0,0,0,1,1,87,62,149,159
20192020,045,GREENUP,221,Greenup County,040,Greysbranch Elementary School,221040,045221040,210240000497,KEDC,903,04,23,22,0,1,1,0,0,0,0,0,0,0,0,0,0,0,0,0,0,0,22,22,44,45
20192020,045,GREENUP,221,Greenup County,040,Greysbranch Elementary School,221040,045221040,210240000497,KEDC,903,All Students,148,163,2,2,4,0,0,0,0,0,0,4,0,4,0,0,0,2,1,3,155,145,300,311
20192020,045,GREENUP,221,Greenup County,040,Greysbranch Elementary School,221040,045221040,210240000497,KEDC,903,PS,13,14,0,0,0,0,0,0,0,0,0,1,0,1,0,0,0,0,0,0,13,13,26,27
20192020,045,GREENUP,221,Greenup County,040,Greysbranch Elementary School,221040,045221040,210240000497,KEDC,903,KG,16,26,0,0,0,0,0,0,0,0,0,0,0,0,0,0,0,0,0,0,26,16,42,42
20192020,045,GREENUP,221,Greenup County,040,Greysbranch Elementary School,221040,045221040,210240000497,KEDC,903,01,32,19,0,0,0,0,0,0,0,0,0,1,0,1,0,0,0,0,1,1,18,31,49,51
20192020,045,GREENUP,221,Greenup County,040,Greysbranch Elementary School,221040,045221040,210240000497,KEDC,903,02,21,28,0,0,0,0,0,0,0,0,0,1,0,1,0,0,0,1,0,1,26,21,47,49
20192020,045,GREENUP,221,Greenup County,040,Greysbranch Elementary School,221040,045221040,210240000497,KEDC,903,03,24,37,2,0,2,0,0,0,0,0,0,2,0,2,0,0,0,1,0,1,32,24,56,61
20192020,045,GREENUP,221,Greenup County,040,Greysbranch Elementary School,221040,045221040,210240000497,KEDC,903,05,32,31,0,1,1,0,0,0,0,0,0,0,0,0,0,0,0,0,0,0,31,31,62,63
20192020,045,GREENUP,221,Greenup County,060,Mckell Elementary School,221060,045221060,210240000499,KEDC,903,04,35,41,0,0,0,0,0,0,0,0,0,1,1,2,0,0,0,1,0,1,39,34,73,76
20192020,045,GREENUP,221,Greenup County,060,Mckell Elementary School,221060,045221060,210240000499,KEDC,903,All Students,209,253,1,0,1,0,1,1,1,1,2,7,3,10,0,0,0,5,2,7,239,202,441,462
20192020,045,GREENUP,221,Greenup County,060,Mckell Elementary School,221060,045221060,210240000499,KEDC,903,PS,20,33,0,0,0,0,0,0,1,0,1,0,1,1,0,0,0,1,0,1,31,19,50,53
20192020,045,GREENUP,221,Greenup County,060,Mckell Elementary School,221060,045221060,210240000499,KEDC,903,KG,36,57,0,0,0,0,0,0,1,1,2,2,0,2,0,0,0,1,0,1,53,35,88,93
20192020,045,GREENUP,221,Greenup County,060,Mckell Elementary School,221060,045221060,210240000499,KEDC,903,01,41,32,0,0,0,0,0,0,0,0,0,2,1,3,0,0,0,0,0,0,30,40,70,73
20192020,045,GREENUP,221,Greenup County,060,Mckell Elementary School,221060,045221060,210240000499,KEDC,903,02,25,44,1,0,1,0,0,0,0,0,0,0,0,0,0,0,0,0,0,0,43,25,68,69
20192020,045,GREENUP,221,Greenup County,060,Mckell Elementary School,221060,045221060,210240000499,KEDC,903,03,36,37,0,0,0,0,1,1,0,0,0,1,0,1,0,0,0,1,0,1,35,35,70,73
20192020,045,GREENUP,221,Greenup County,060,Mckell Elementary School,221060,045221060,210240000499,KEDC,903,05,36,42,0,0,0,0,0,0,0,0,0,1,1,2,0,0,0,2,2,4,39,33,72,78
20192020,045,GREENUP,221,Greenup County,105,Mckell Middle School,221105,045221105,210240001611,KEDC,903,07,54,62,0,0,0,0,0,0,1,0,1,2,1,3,0,0,0,3,1,4,56,52,108,116
20192020,045,GREENUP,221,Greenup County,105,Mckell Middle School,221105,045221105,210240001611,KEDC,903,All Students,183,169,0,1,1,1,0,1,2,0,2,3,5,8,0,0,0,7,4,11,156,173,329,352
20192020,045,GREENUP,221,Greenup County,105,Mckell Middle School,221105,045221105,210240001611,KEDC,903,06,65,50,0,1,1,0,0,0,0,0,0,0,3,3,0,0,0,3,3,6,47,58,105,115
20192020,045,GREENUP,221,Greenup County,105,Mckell Middle School,221105,045221105,210240001611,KEDC,903,08,64,57,0,0,0,1,0,1,1,0,1,1,1,2,0,0,0,1,0,1,53,63,116,121
20192020,045,GREENUP,221,Greenup County,110,Wurtland Elementary School,221110,045221110,210240000504,KEDC,903,02,20,13,0,2,2,0,0,0,0,0,0,0,0,0,0,0,0,1,1,2,12,17,29,33
20192020,045,GREENUP,221,Greenup County,110,Wurtland Elementary School,221110,045221110,210240000504,KEDC,903,All Students,93,115,2,3,5,0,0,0,0,0,0,2,3,5,0,0,0,4,3,7,107,84,191,208
20192020,045,GREENUP,221,Greenup County,110,Wurtland Elementary School,221110,045221110,210240000504,KEDC,903,PS,14,13,0,0,0,0,0,0,0,0,0,0,0,0,0,0,0,0,0,0,13,14,27,27
20192020,045,GREENUP,221,Greenup County,110,Wurtland Elementary School,221110,045221110,210240000504,KEDC,903,KG,16,25,1,0,1,0,0,0,0,0,0,0,1,1,0,0,0,1,0,1,23,15,38,41
20192020,045,GREENUP,221,Greenup County,110,Wurtland Elementary School,221110,045221110,210240000504,KEDC,903,01,10,24,0,1,1,0,0,0,0,0,0,0,1,1,0,0,0,0,0,0,24,8,32,34
20192020,045,GREENUP,221,Greenup County,110,Wurtland Elementary School,221110,045221110,210240000504,KEDC,903,03,13,14,0,0,0,0,0,0,0,0,0,1,0,1,0,0,0,1,1,2,12,12,24,27
20192020,045,GREENUP,221,Greenup County,110,Wurtland Elementary School,221110,045221110,210240000504,KEDC,903,04,12,18,0,0,0,0,0,0,0,0,0,0,0,0,0,0,0,0,0,0,18,12,30,30
20192020,045,GREENUP,221,Greenup County,110,Wurtland Elementary School,221110,045221110,210240000504,KEDC,903,05,22,21,1,0,1,0,0,0,0,0,0,1,1,2,0,0,0,1,1,2,18,20,38,43
20192020,046,HANCOCK,225,Hancock County,"",---District Total---,225,"","",GRREC,902,12,58,63,1,0,1,0,0,0,2,3,5,4,1,5,0,0,0,1,2,3,55,52,107,121
20192020,046,HANCOCK,225,Hancock County,"",---District Total---,225,"","",GRREC,902,All Students,727,832,8,4,12,1,0,1,4,10,14,17,26,43,1,2,3,23,21,44,778,664,1442,1559
20192020,046,HANCOCK,225,Hancock County,"",---District Total---,225,"","",GRREC,902,PS,38,42,0,0,0,0,0,0,0,0,0,1,2,3,0,0,0,1,0,1,40,36,76,80
20192020,046,HANCOCK,225,Hancock County,"",---District Total---,225,"","",GRREC,902,KG,52,49,0,0,0,1,0,1,0,0,0,1,2,3,0,1,1,0,0,0,47,49,96,101
20192020,046,HANCOCK,225,Hancock County,"",---District Total---,225,"","",GRREC,902,01,60,54,0,0,0,0,0,0,0,0,0,1,3,4,0,1,1,1,1,2,52,55,107,114
20192020,046,HANCOCK,225,Hancock County,"",---District Total---,225,"","",GRREC,902,02,52,53,0,1,1,0,0,0,0,0,0,1,1,2,0,0,0,3,1,4,49,49,98,105
20192020,046,HANCOCK,225,Hancock County,"",---District Total---,225,"","",GRREC,902,03,54,54,0,0,0,0,0,0,0,1,1,3,3,6,0,0,0,1,1,2,50,49,99,108
20192020,046,HANCOCK,225,Hancock County,"",---District Total---,225,"","",GRREC,902,04,58,65,1,1,2,0,0,0,0,0,0,1,2,3,0,0,0,1,2,3,62,53,115,123
20192020,046,HANCOCK,225,Hancock County,"",---District Total---,225,"","",GRREC,902,05,48,70,2,0,2,0,0,0,0,0,0,2,2,4,0,0,0,2,3,5,64,43,107,118
20192020,046,HANCOCK,225,Hancock County,"",---District Total---,225,"","",GRREC,902,06,59,74,2,1,3,0,0,0,0,3,3,0,2,2,0,0,0,2,1,3,70,52,122,133
20192020,046,HANCOCK,225,Hancock County,"",---District Total---,225,"","",GRREC,902,07,51,79,0,0,0,0,0,0,0,1,1,0,1,1,0,0,0,4,1,5,75,48,123,130
20192020,046,HANCOCK,225,Hancock County,"",---District Total---,225,"","",GRREC,902,08,62,72,0,0,0,0,0,0,0,0,0,1,2,3,0,0,0,0,3,3,71,57,128,134
20192020,046,HANCOCK,225,Hancock County,"",---District Total---,225,"","",GRREC,902,09,66,71,1,0,1,0,0,0,0,0,0,2,2,4,0,0,0,2,4,6,66,60,126,137
20192020,046,HANCOCK,225,Hancock County,"",---District Total---,225,"","",GRREC,902,10,56,74,0,0,0,0,0,0,2,2,4,1,4,5,1,0,1,4,2,6,66,48,114,130
20192020,046,HANCOCK,225,Hancock County,"",---District Total---,225,"","",GRREC,902,11,51,54,1,1,2,0,0,0,0,0,0,0,1,1,0,0,0,2,0,2,51,49,100,105
20192020,046,HANCOCK,225,Hancock County,005,Hancock County High School,225005,046225005,210246000507,GRREC,902,11,51,54,1,1,2,0,0,0,0,0,0,0,1,1,0,0,0,2,0,2,51,49,100,105
20192020,046,HANCOCK,225,Hancock County,005,Hancock County High School,225005,046225005,210246000507,GRREC,902,All Students,231,262,3,1,4,0,0,0,4,5,9,7,8,15,1,0,1,9,8,17,238,209,447,493
20192020,046,HANCOCK,225,Hancock County,005,Hancock County High School,225005,046225005,210246000507,GRREC,902,09,66,71,1,0,1,0,0,0,0,0,0,2,2,4,0,0,0,2,4,6,66,60,126,137
20192020,046,HANCOCK,225,Hancock County,005,Hancock County High School,225005,046225005,210246000507,GRREC,902,10,56,74,0,0,0,0,0,0,2,2,4,1,4,5,1,0,1,4,2,6,66,48,114,130
20192020,046,HANCOCK,225,Hancock County,005,Hancock County High School,225005,046225005,210246000507,GRREC,902,12,58,63,1,0,1,0,0,0,2,3,5,4,1,5,0,0,0,1,2,3,55,52,107,121
20192020,046,HANCOCK,225,Hancock County,006,North Hancock Elementary School,225006,046225006,210246001993,GRREC,902,04,38,44,0,0,0,0,0,0,0,0,0,1,1,2,0,0,0,1,2,3,42,35,77,82
20192020,046,HANCOCK,225,Hancock County,006,North Hancock Elementary School,225006,046225006,210246001993,GRREC,902,All Students,208,238,2,0,2,1,0,1,0,0,0,8,9,17,0,2,2,4,8,12,223,189,412,446
20192020,046,HANCOCK,225,Hancock County,006,North Hancock Elementary School,225006,046225006,210246001993,GRREC,902,PS,30,28,0,0,0,0,0,0,0,0,0,1,2,3,0,0,0,1,0,1,26,28,54,58
20192020,046,HANCOCK,225,Hancock County,006,North Hancock Elementary School,225006,046225006,210246001993,GRREC,902,KG,34,31,0,0,0,1,0,1,0,0,0,1,1,2,0,1,1,0,0,0,29,32,61,65
20192020,046,HANCOCK,225,Hancock County,006,North Hancock Elementary School,225006,046225006,210246001993,GRREC,902,01,32,36,0,0,0,0,0,0,0,0,0,1,2,3,0,1,1,0,1,1,35,28,63,68
20192020,046,HANCOCK,225,Hancock County,006,North Hancock Elementary School,225006,046225006,210246001993,GRREC,902,02,36,38,0,0,0,0,0,0,0,0,0,0,1,1,0,0,0,1,1,2,37,34,71,74
20192020,046,HANCOCK,225,Hancock County,006,North Hancock Elementary School,225006,046225006,210246001993,GRREC,902,03,35,36,0,0,0,0,0,0,0,0,0,3,3,6,0,0,0,0,1,1,33,31,64,71
20192020,046,HANCOCK,225,Hancock County,006,North Hancock Elementary School,225006,046225006,210246001993,GRREC,902,05,33,53,2,0,2,0,0,0,0,0,0,2,1,3,0,0,0,2,3,5,47,29,76,86
20192020,046,HANCOCK,225,Hancock County,007,Hancock County Middle School,225007,046225007,210246000508,GRREC,902,07,51,79,0,0,0,0,0,0,0,1,1,0,1,1,0,0,0,4,1,5,75,48,123,130
20192020,046,HANCOCK,225,Hancock County,007,Hancock County Middle School,225007,046225007,210246000508,GRREC,902,All Students,172,225,2,1,3,0,0,0,0,4,4,1,5,6,0,0,0,6,5,11,216,157,373,397
20192020,046,HANCOCK,225,Hancock County,007,Hancock County Middle School,225007,046225007,210246000508,GRREC,902,06,59,74,2,1,3,0,0,0,0,3,3,0,2,2,0,0,0,2,1,3,70,52,122,133
20192020,046,HANCOCK,225,Hancock County,007,Hancock County Middle School,225007,046225007,210246000508,GRREC,902,08,62,72,0,0,0,0,0,0,0,0,0,1,2,3,0,0,0,0,3,3,71,57,128,134
20192020,046,HANCOCK,225,Hancock County,070,South Hancock Elementary School,225070,046225070,210246000511,GRREC,902,03,19,18,0,0,0,0,0,0,0,1,1,0,0,0,0,0,0,1,0,1,17,18,35,37
20192020,046,HANCOCK,225,Hancock County,070,South Hancock Elementary School,225070,046225070,210246000511,GRREC,902,All Students,116,107,1,2,3,0,0,0,0,1,1,1,4,5,0,0,0,4,0,4,101,109,210,223
20192020,046,HANCOCK,225,Hancock County,070,South Hancock Elementary School,225070,046225070,210246000511,GRREC,902,PS,8,14,0,0,0,0,0,0,0,0,0,0,0,0,0,0,0,0,0,0,14,8,22,22
20192020,046,HANCOCK,225,Hancock County,070,South Hancock Elementary School,225070,046225070,210246000511,GRREC,902,KG,18,18,0,0,0,0,0,0,0,0,0,0,1,1,0,0,0,0,0,0,18,17,35,36
20192020,046,HANCOCK,225,Hancock County,070,South Hancock Elementary School,225070,046225070,210246000511,GRREC,902,01,28,18,0,0,0,0,0,0,0,0,0,0,1,1,0,0,0,1,0,1,17,27,44,46
20192020,046,HANCOCK,225,Hancock County,070,South Hancock Elementary School,225070,046225070,210246000511,GRREC,902,05,15,17,0,0,0,0,0,0,0,0,0,0,1,1,0,0,0,0,0,0,17,14,31,32
20192020,046,HANCOCK,225,Hancock County,070,South Hancock Elementary School,225070,046225070,210246000511,GRREC,902,02,16,15,0,1,1,0,0,0,0,0,0,1,0,1,0,0,0,2,0,2,12,15,27,31
20192020,046,HANCOCK,225,Hancock County,070,South Hancock Elementary School,225070,046225070,210246000511,GRREC,902,04,20,21,1,1,2,0,0,0,0,0,0,0,1,1,0,0,0,0,0,0,20,18,38,41
20192020,047,HARDIN,231,Hardin County,"",---District Total---,231,"","",GRREC,902,05,517,523,61,60,121,2,0,2,10,7,17,45,54,99,1,3,4,56,53,109,348,340,688,1040
20192020,047,HARDIN,231,Hardin County,"",---District Total---,231,"","",GRREC,902,All Students,6936,7207,1004,950,1954,13,18,31,96,101,197,622,591,1213,47,37,84,607,613,1220,4818,4626,9444,14143
20192020,047,HARDIN,231,Hardin County,"",---District Total---,231,"","",GRREC,902,KG,514,549,55,63,118,1,0,1,4,5,9,54,39,93,10,2,12,60,49,109,365,356,721,1063
20192020,047,HARDIN,231,Hardin County,"",---District Total---,231,"","",GRREC,902,01,536,556,74,64,138,2,0,2,10,14,24,57,41,98,6,2,8,62,56,118,345,359,704,1092
20192020,047,HARDIN,231,Hardin County,"",---District Total---,231,"","",GRREC,902,02,498,456,47,70,117,1,2,3,7,6,13,40,36,76,2,3,5,42,54,96,317,327,644,954
20192020,047,HARDIN,231,Hardin County,"",---District Total---,231,"","",GRREC,902,03,522,540,71,61,132,1,3,4,4,9,13,49,50,99,6,4,10,41,57,98,368,338,706,1062
20192020,047,HARDIN,231,Hardin County,"",---District Total---,231,"","",GRREC,902,04,487,529,74,76,150,0,1,1,4,5,9,43,50,93,1,0,1,52,49,101,355,306,661,1016
20192020,047,HARDIN,231,Hardin County,"",---District Total---,231,"","",GRREC,902,06,558,592,95,73,168,1,1,2,6,5,11,48,58,106,3,2,5,53,54,107,386,365,751,1150
20192020,047,HARDIN,231,Hardin County,"",---District Total---,231,"","",GRREC,902,07,571,581,75,72,147,1,1,2,5,5,10,50,55,105,2,5,7,51,52,103,397,381,778,1152
20192020,047,HARDIN,231,Hardin County,"",---District Total---,231,"","",GRREC,902,08,543,579,75,73,148,0,2,2,10,3,13,41,46,87,2,4,6,47,46,93,404,369,773,1122
20192020,047,HARDIN,231,Hardin County,"",---District Total---,231,"","",GRREC,902,09,570,588,82,83,165,1,3,4,9,7,16,61,44,105,3,2,5,48,40,88,384,391,775,1158
20192020,047,HARDIN,231,Hardin County,"",---District Total---,231,"","",GRREC,902,10,564,574,101,93,194,0,1,1,12,12,24,46,44,90,4,3,7,39,35,74,372,376,748,1138
20192020,047,HARDIN,231,Hardin County,"",---District Total---,231,"","",GRREC,902,11,521,605,105,77,182,0,1,1,12,11,23,51,40,91,2,2,4,35,30,65,400,360,760,1126
20192020,047,HARDIN,231,Hardin County,"",---District Total---,231,"","",GRREC,902,12,530,523,85,84,169,2,3,5,3,12,15,37,33,70,5,5,10,19,38,57,372,355,727,1053
20192020,047,HARDIN,231,Hardin County,"",---District Total---,231,"","",GRREC,902,14,5,12,4,1,5,1,0,1,0,0,0,0,1,1,0,0,0,2,0,2,5,3,8,17
20192020,047,HARDIN,231,Hardin County,005,East Hardin Middle School,231005,047231005,210249000512,GRREC,902,06,129,122,2,1,3,0,1,1,0,2,2,5,5,10,1,0,1,3,12,15,111,108,219,251
20192020,047,HARDIN,231,Hardin County,005,East Hardin Middle School,231005,047231005,210249000512,GRREC,902,07,134,131,3,5,8,1,1,2,1,1,2,7,9,16,0,1,1,5,6,11,114,111,225,265
20192020,047,HARDIN,231,Hardin County,005,East Hardin Middle School,231005,047231005,210249000512,GRREC,902,08,141,128,3,2,5,0,0,0,0,0,0,5,8,13,0,0,0,4,6,10,116,125,241,269
20192020,047,HARDIN,231,Hardin County,005,East Hardin Middle School,231005,047231005,210249000512,GRREC,902,All Students,404,381,8,8,16,1,2,3,1,3,4,17,22,39,1,1,2,12,24,36,341,344,685,785
20192020,047,HARDIN,231,Hardin County,008,Woodland Elementary School,231008,047231008,210249001471,GRREC,902,03,29,67,19,7,26,0,0,0,0,1,1,11,4,15,1,0,1,5,8,13,31,9,40,96
20192020,047,HARDIN,231,Hardin County,008,Woodland Elementary School,231008,047231008,210249001471,GRREC,902,05,47,50,19,9,28,0,0,0,1,0,1,9,7,16,0,0,0,3,7,10,18,24,42,97
20192020,047,HARDIN,231,Hardin County,008,Woodland Elementary School,231008,047231008,210249001471,GRREC,902,04,54,70,23,18,41,0,0,0,0,0,0,9,10,19,0,0,0,8,9,17,30,17,47,124
20192020,047,HARDIN,231,Hardin County,008,Woodland Elementary School,231008,047231008,210249001471,GRREC,902,All Students,229,297,85,54,139,0,0,0,2,1,3,48,33,81,1,0,1,37,43,80,124,98,222,526
20192020,047,HARDIN,231,Hardin County,008,Woodland Elementary School,231008,047231008,210249001471,GRREC,902,01,41,57,11,6,17,0,0,0,1,0,1,10,6,16,0,0,0,13,7,20,22,22,44,98
20192020,047,HARDIN,231,Hardin County,008,Woodland Elementary School,231008,047231008,210249001471,GRREC,902,02,58,53,13,14,27,0,0,0,0,0,0,9,6,15,0,0,0,8,12,20,23,26,49,111
20192020,047,HARDIN,231,Hardin County,013,John Hardin High School,231013,047231013,210249001910,GRREC,902,12,94,93,22,23,45,0,0,0,2,4,6,6,10,16,0,1,1,6,11,17,57,45,102,187
20192020,047,HARDIN,231,Hardin County,013,John Hardin High School,231013,047231013,210249001910,GRREC,902,All Students,347,400,96,80,176,0,1,1,10,13,23,44,34,78,2,4,6,33,34,67,215,181,396,747
20192020,047,HARDIN,231,Hardin County,013,John Hardin High School,231013,047231013,210249001910,GRREC,902,09,70,92,17,14,31,0,1,1,4,3,7,15,6,21,0,1,1,10,10,20,46,35,81,162
20192020,047,HARDIN,231,Hardin County,013,John Hardin High School,231013,047231013,210249001910,GRREC,902,10,92,110,26,20,46,0,0,0,3,2,5,9,7,16,2,2,4,6,8,14,64,53,117,202
20192020,047,HARDIN,231,Hardin County,013,John Hardin High School,231013,047231013,210249001910,GRREC,902,11,90,98,27,22,49,0,0,0,1,4,5,14,11,25,0,0,0,9,5,14,47,48,95,188
20192020,047,HARDIN,231,Hardin County,013,John Hardin High School,231013,047231013,210249001910,GRREC,902,14,1,7,4,1,5,0,0,0,0,0,0,0,0,0,0,0,0,2,0,2,1,0,1,8
20192020,047,HARDIN,231,Hardin County,014,Lakewood Elementary School,231014,047231014,210249001963,GRREC,902,02,34,28,0,3,3,0,0,0,0,0,0,1,0,1,0,0,0,0,1,1,27,30,57,62
20192020,047,HARDIN,231,Hardin County,014,Lakewood Elementary School,231014,047231014,210249001963,GRREC,902,All Students,219,211,7,9,16,1,1,2,2,3,5,9,6,15,0,1,1,4,7,11,188,192,380,430
20192020,047,HARDIN,231,Hardin County,014,Lakewood Elementary School,231014,047231014,210249001963,GRREC,902,KG,38,37,1,2,3,0,0,0,0,0,0,1,2,3,0,0,0,0,0,0,35,34,69,75
20192020,047,HARDIN,231,Hardin County,014,Lakewood Elementary School,231014,047231014,210249001963,GRREC,902,01,33,34,4,1,5,1,0,1,1,2,3,1,0,1,0,1,1,4,2,6,23,27,50,67
20192020,047,HARDIN,231,Hardin County,014,Lakewood Elementary School,231014,047231014,210249001963,GRREC,902,03,32,40,1,1,2,0,1,1,1,0,1,5,0,5,0,0,0,0,2,2,33,28,61,72
20192020,047,HARDIN,231,Hardin County,014,Lakewood Elementary School,231014,047231014,210249001963,GRREC,902,04,40,34,1,1,2,0,0,0,0,1,1,1,2,3,0,0,0,0,0,0,32,36,68,74
20192020,047,HARDIN,231,Hardin County,014,Lakewood Elementary School,231014,047231014,210249001963,GRREC,902,05,42,38,0,1,1,0,0,0,0,0,0,0,2,2,0,0,0,0,2,2,38,37,75,80
20192020,047,HARDIN,231,Hardin County,015,Bluegrass Middle School,231015,047231015,210249001673,GRREC,902,07,112,103,17,16,33,0,0,0,1,1,2,12,15,27,1,4,5,13,14,27,59,62,121,215
20192020,047,HARDIN,231,Hardin County,015,Bluegrass Middle School,231015,047231015,210249001673,GRREC,902,08,84,92,15,19,34,0,0,0,4,1,5,6,8,14,0,1,1,12,14,26,55,41,96,176
20192020,047,HARDIN,231,Hardin County,015,Bluegrass Middle School,231015,047231015,210249001673,GRREC,902,All Students,293,299,62,48,110,0,0,0,6,3,9,29,36,65,1,5,6,37,38,75,164,163,327,592
20192020,047,HARDIN,231,Hardin County,015,Bluegrass Middle School,231015,047231015,210249001673,GRREC,902,06,97,104,30,13,43,0,0,0,1,1,2,11,13,24,0,0,0,12,10,22,50,60,110,201
20192020,047,HARDIN,231,Hardin County,017,Creekside Elementary School,231017,047231017,210249001994,GRREC,902,02,31,26,1,1,2,0,0,0,0,0,0,1,1,2,0,0,0,1,0,1,23,29,52,57
20192020,047,HARDIN,231,Hardin County,017,Creekside Elementary School,231017,047231017,210249001994,GRREC,902,03,27,32,1,1,2,0,0,0,0,0,0,0,1,1,0,0,0,2,3,5,29,22,51,59
20192020,047,HARDIN,231,Hardin County,017,Creekside Elementary School,231017,047231017,210249001994,GRREC,902,05,38,38,0,1,1,0,0,0,0,1,1,4,1,5,0,0,0,3,4,7,31,31,62,76
20192020,047,HARDIN,231,Hardin County,017,Creekside Elementary School,231017,047231017,210249001994,GRREC,902,04,25,36,1,1,2,0,0,0,0,0,0,2,1,3,0,0,0,3,0,3,30,23,53,61
20192020,047,HARDIN,231,Hardin County,017,Creekside Elementary School,231017,047231017,210249001994,GRREC,902,All Students,181,183,5,4,9,0,0,0,0,1,1,7,5,12,0,0,0,12,9,21,159,162,321,364
20192020,047,HARDIN,231,Hardin County,017,Creekside Elementary School,231017,047231017,210249001994,GRREC,902,KG,25,24,0,0,0,0,0,0,0,0,0,0,0,0,0,0,0,2,1,3,22,24,46,49
20192020,047,HARDIN,231,Hardin County,017,Creekside Elementary School,231017,047231017,210249001994,GRREC,902,01,35,27,2,0,2,0,0,0,0,0,0,0,1,1,0,0,0,1,1,2,24,33,57,62
20192020,047,HARDIN,231,Hardin County,018,Heartland Elementary School,231018,047231018,210249002209,GRREC,902,03,54,54,1,6,7,0,0,0,2,3,5,4,6,10,0,1,1,4,9,13,43,29,72,108
20192020,047,HARDIN,231,Hardin County,018,Heartland Elementary School,231018,047231018,210249002209,GRREC,902,All Students,286,301,26,45,71,1,1,2,13,11,24,19,25,44,1,1,2,27,31,58,214,172,386,587
20192020,047,HARDIN,231,Hardin County,018,Heartland Elementary School,231018,047231018,210249002209,GRREC,902,KG,53,57,5,4,9,0,0,0,1,1,2,2,7,9,0,0,0,6,6,12,43,35,78,110
20192020,047,HARDIN,231,Hardin County,018,Heartland Elementary School,231018,047231018,210249002209,GRREC,902,01,47,49,6,8,14,0,0,0,3,2,5,3,2,5,0,0,0,5,5,10,32,30,62,96
20192020,047,HARDIN,231,Hardin County,018,Heartland Elementary School,231018,047231018,210249002209,GRREC,902,05,35,49,6,7,13,1,0,1,2,2,4,4,3,7,0,0,0,3,3,6,33,20,53,84
20192020,047,HARDIN,231,Hardin County,018,Heartland Elementary School,231018,047231018,210249002209,GRREC,902,02,51,48,5,6,11,0,1,1,2,2,4,3,3,6,1,0,1,6,5,11,31,34,65,99
20192020,047,HARDIN,231,Hardin County,018,Heartland Elementary School,231018,047231018,210249002209,GRREC,902,04,46,44,3,14,17,0,0,0,3,1,4,3,4,7,0,0,0,3,3,6,32,24,56,90
20192020,047,HARDIN,231,Hardin County,020,G C Burkhead Elementary School,231020,047231020,210249000513,GRREC,902,All Students,357,334,25,24,49,1,0,1,6,9,15,29,34,63,0,0,0,27,37,64,246,253,499,691
20192020,047,HARDIN,231,Hardin County,020,G C Burkhead Elementary School,231020,047231020,210249000513,GRREC,902,KG,58,62,2,2,4,1,0,1,0,2,2,9,2,11,0,0,0,3,10,13,47,42,89,120
20192020,047,HARDIN,231,Hardin County,020,G C Burkhead Elementary School,231020,047231020,210249000513,GRREC,902,01,68,57,7,4,11,0,0,0,2,3,5,7,4,11,0,0,0,3,9,12,38,48,86,125
20192020,047,HARDIN,231,Hardin County,020,G C Burkhead Elementary School,231020,047231020,210249000513,GRREC,902,02,61,46,2,5,7,0,0,0,1,0,1,3,3,6,0,0,0,7,5,12,33,48,81,107
20192020,047,HARDIN,231,Hardin County,020,G C Burkhead Elementary School,231020,047231020,210249000513,GRREC,902,03,57,52,5,2,7,0,0,0,1,1,2,2,8,10,0,0,0,3,3,6,41,43,84,109
20192020,047,HARDIN,231,Hardin County,020,G C Burkhead Elementary School,231020,047231020,210249000513,GRREC,902,04,52,61,5,6,11,0,0,0,0,1,1,5,7,12,0,0,0,2,6,8,49,32,81,113
20192020,047,HARDIN,231,Hardin County,020,G C Burkhead Elementary School,231020,047231020,210249000513,GRREC,902,05,61,56,4,5,9,0,0,0,2,2,4,3,10,13,0,0,0,9,4,13,38,40,78,117
20192020,047,HARDIN,231,Hardin County,021,North Park Elementary School,231021,047231021,210249002297,GRREC,902,All Students,192,225,37,40,77,0,0,0,2,2,4,34,16,50,7,1,8,31,22,53,114,111,225,417
20192020,047,HARDIN,231,Hardin County,021,North Park Elementary School,231021,047231021,210249002297,GRREC,902,KG,192,225,37,40,77,0,0,0,2,2,4,34,16,50,7,1,8,31,22,53,114,111,225,417
20192020,047,HARDIN,231,Hardin County,025,College View Campus,231025,047231025,210249002439,GRREC,902,KG,0,1,0,0,0,0,0,0,0,0,0,0,0,0,0,0,0,1,0,1,0,0,0,1
20192020,047,HARDIN,231,Hardin County,025,College View Campus,231025,047231025,210249002439,GRREC,902,01,2,4,1,0,1,0,0,0,0,0,0,0,0,0,0,0,0,2,0,2,1,2,3,6
20192020,047,HARDIN,231,Hardin County,025,College View Campus,231025,047231025,210249002439,GRREC,902,02,0,1,0,0,0,0,0,0,0,0,0,0,0,0,0,0,0,0,0,0,1,0,1,1
20192020,047,HARDIN,231,Hardin County,025,College View Campus,231025,047231025,210249002439,GRREC,902,03,2,1,1,1,2,0,0,0,0,0,0,0,0,0,0,0,0,0,1,1,0,0,0,3
20192020,047,HARDIN,231,Hardin County,025,College View Campus,231025,047231025,210249002439,GRREC,902,05,0,2,1,0,1,0,0,0,0,0,0,0,0,0,0,0,0,0,0,0,1,0,1,2
20192020,047,HARDIN,231,Hardin County,025,College View Campus,231025,047231025,210249002439,GRREC,902,06,9,23,6,4,10,1,0,1,0,0,0,0,0,0,0,0,0,3,1,4,13,4,17,32
20192020,047,HARDIN,231,Hardin County,025,College View Campus,231025,047231025,210249002439,GRREC,902,07,6,14,4,5,9,0,0,0,0,0,0,2,0,2,0,0,0,1,1,2,7,0,7,20
20192020,047,HARDIN,231,Hardin County,025,College View Campus,231025,047231025,210249002439,GRREC,902,08,1,27,9,1,10,0,0,0,1,0,1,3,0,3,0,0,0,2,0,2,12,0,12,28
20192020,047,HARDIN,231,Hardin County,025,College View Campus,231025,047231025,210249002439,GRREC,902,09,12,25,4,5,9,1,0,1,0,0,0,2,1,3,0,0,0,5,0,5,13,6,19,37
20192020,047,HARDIN,231,Hardin County,025,College View Campus,231025,047231025,210249002439,GRREC,902,10,32,27,9,6,15,0,0,0,0,0,0,2,4,6,0,0,0,2,2,4,14,20,34,59
20192020,047,HARDIN,231,Hardin County,025,College View Campus,231025,047231025,210249002439,GRREC,902,11,45,65,19,10,29,0,1,1,0,1,1,3,3,6,0,0,0,7,2,9,36,28,64,110
20192020,047,HARDIN,231,Hardin County,025,College View Campus,231025,047231025,210249002439,GRREC,902,All Students,183,270,66,40,106,3,1,4,1,2,3,21,10,31,1,3,4,25,9,34,153,118,271,453
20192020,047,HARDIN,231,Hardin County,025,College View Campus,231025,047231025,210249002439,GRREC,902,12,74,80,12,8,20,1,0,1,0,1,1,9,2,11,1,3,4,2,2,4,55,58,113,154
20192020,047,HARDIN,231,Hardin County,030,Cecilia Valley Elementary School,231030,047231030,210249000514,GRREC,902,05,28,32,1,0,1,0,0,0,0,0,0,3,2,5,0,0,0,3,1,4,25,25,50,60
20192020,047,HARDIN,231,Hardin County,030,Cecilia Valley Elementary School,231030,047231030,210249000514,GRREC,902,All Students,156,155,2,2,4,0,0,0,0,0,0,10,10,20,0,0,0,13,4,17,130,140,270,311
20192020,047,HARDIN,231,Hardin County,030,Cecilia Valley Elementary School,231030,047231030,210249000514,GRREC,902,KG,30,19,1,1,2,0,0,0,0,0,0,1,3,4,0,0,0,2,1,3,15,25,40,49
20192020,047,HARDIN,231,Hardin County,030,Cecilia Valley Elementary School,231030,047231030,210249000514,GRREC,902,01,30,34,0,0,0,0,0,0,0,0,0,1,2,3,0,0,0,2,0,2,31,28,59,64
20192020,047,HARDIN,231,Hardin County,030,Cecilia Valley Elementary School,231030,047231030,210249000514,GRREC,902,02,21,24,0,0,0,0,0,0,0,0,0,3,0,3,0,0,0,3,1,4,18,20,38,45
20192020,047,HARDIN,231,Hardin County,030,Cecilia Valley Elementary School,231030,047231030,210249000514,GRREC,902,03,25,22,0,1,1,0,0,0,0,0,0,2,2,4,0,0,0,3,0,3,17,22,39,47
20192020,047,HARDIN,231,Hardin County,030,Cecilia Valley Elementary School,231030,047231030,210249000514,GRREC,902,04,22,24,0,0,0,0,0,0,0,0,0,0,1,1,0,0,0,0,1,1,24,20,44,46
20192020,047,HARDIN,231,Hardin County,040,New Highland Elementary School,231040,047231040,210249001446,GRREC,902,04,31,31,8,5,13,0,0,0,0,0,0,2,7,9,0,0,0,6,5,11,15,14,29,62
20192020,047,HARDIN,231,Hardin County,040,New Highland Elementary School,231040,047231040,210249001446,GRREC,902,All Students,202,204,36,39,75,3,0,3,3,6,9,22,30,52,2,2,4,24,25,49,114,100,214,406
20192020,047,HARDIN,231,Hardin County,040,New Highland Elementary School,231040,047231040,210249001446,GRREC,902,KG,37,37,4,9,13,0,0,0,0,0,0,3,5,8,1,0,1,6,5,11,23,18,41,74
20192020,047,HARDIN,231,Hardin County,040,New Highland Elementary School,231040,047231040,210249001446,GRREC,902,01,32,41,7,5,12,1,0,1,1,3,4,9,2,11,1,0,1,2,2,4,20,20,40,73
20192020,047,HARDIN,231,Hardin County,040,New Highland Elementary School,231040,047231040,210249001446,GRREC,902,02,31,22,2,8,10,1,0,1,1,1,2,2,4,6,0,0,0,1,6,7,15,12,27,53
20192020,047,HARDIN,231,Hardin County,040,New Highland Elementary School,231040,047231040,210249001446,GRREC,902,03,38,33,8,7,15,0,0,0,0,1,1,1,5,6,0,1,1,7,2,9,17,22,39,71
20192020,047,HARDIN,231,Hardin County,040,New Highland Elementary School,231040,047231040,210249001446,GRREC,902,05,33,40,7,5,12,1,0,1,1,1,2,5,7,12,0,1,1,2,5,7,24,14,38,73
20192020,047,HARDIN,231,Hardin County,050,Lincoln Trail Elementary School,231050,047231050,210249000515,GRREC,902,02,32,48,1,1,2,0,0,0,1,0,1,1,2,3,0,0,0,0,4,4,45,25,70,80
20192020,047,HARDIN,231,Hardin County,050,Lincoln Trail Elementary School,231050,047231050,210249000515,GRREC,902,05,33,36,0,1,1,0,0,0,1,1,2,1,2,3,0,0,0,1,2,3,33,27,60,69
20192020,047,HARDIN,231,Hardin County,050,Lincoln Trail Elementary School,231050,047231050,210249000515,GRREC,902,04,41,49,1,0,1,0,0,0,0,0,0,2,1,3,0,0,0,2,6,8,44,34,78,90
20192020,047,HARDIN,231,Hardin County,050,Lincoln Trail Elementary School,231050,047231050,210249000515,GRREC,902,All Students,223,256,2,7,9,0,2,2,3,2,5,6,7,13,0,1,1,11,19,30,234,185,419,479
20192020,047,HARDIN,231,Hardin County,050,Lincoln Trail Elementary School,231050,047231050,210249000515,GRREC,902,KG,36,36,0,1,1,0,0,0,0,0,0,0,0,0,0,0,0,3,2,5,33,33,66,72
20192020,047,HARDIN,231,Hardin County,050,Lincoln Trail Elementary School,231050,047231050,210249000515,GRREC,902,01,28,45,0,2,2,0,0,0,1,0,1,1,1,2,0,1,1,3,1,4,40,23,63,73
20192020,047,HARDIN,231,Hardin County,050,Lincoln Trail Elementary School,231050,047231050,210249000515,GRREC,902,03,53,42,0,2,2,0,2,2,0,1,1,1,1,2,0,0,0,2,4,6,39,43,82,95
20192020,047,HARDIN,231,Hardin County,070,Early College and Career Center,231070,047231070,210249002373,GRREC,902,10,0,0,0,0,0,0,0,0,0,0,0,0,0,0,0,0,0,0,0,0,0,0,0,0
20192020,047,HARDIN,231,Hardin County,070,Early College and Career Center,231070,047231070,210249002373,GRREC,902,All Students,0,0,0,0,0,0,0,0,0,0,0,0,0,0,0,0,0,0,0,0,0,0,0,0
20192020,047,HARDIN,231,Hardin County,070,Early College and Career Center,231070,047231070,210249002373,GRREC,902,09,0,0,0,0,0,0,0,0,0,0,0,0,0,0,0,0,0,0,0,0,0,0,0,0
20192020,047,HARDIN,231,Hardin County,070,Early College and Career Center,231070,047231070,210249002373,GRREC,902,11,0,0,0,0,0,0,0,0,0,0,0,0,0,0,0,0,0,0,0,0,0,0,0,0
20192020,047,HARDIN,231,Hardin County,070,Early College and Career Center,231070,047231070,210249002373,GRREC,902,12,0,0,0,0,0,0,0,0,0,0,0,0,0,0,0,0,0,0,0,0,0,0,0,0
20192020,047,HARDIN,231,Hardin County,075,North Hardin High School,231075,047231075,210249000517,GRREC,902,14,0,1,0,0,0,0,0,0,0,0,0,0,0,0,0,0,0,0,0,0,1,0,1,1
20192020,047,HARDIN,231,Hardin County,075,North Hardin High School,231075,047231075,210249000517,GRREC,902,All Students,735,764,193,200,393,1,3,4,18,14,32,86,68,154,9,3,12,65,66,131,392,381,773,1499
20192020,047,HARDIN,231,Hardin County,075,North Hardin High School,231075,047231075,210249000517,GRREC,902,09,200,230,51,55,106,0,1,1,4,2,6,24,25,49,3,0,3,21,21,42,127,96,223,430
20192020,047,HARDIN,231,Hardin County,075,North Hardin High School,231075,047231075,210249000517,GRREC,902,10,199,206,56,61,117,0,0,0,5,8,13,25,21,46,2,1,3,25,14,39,93,94,187,405
20192020,047,HARDIN,231,Hardin County,075,North Hardin High School,231075,047231075,210249000517,GRREC,902,11,164,184,48,35,83,0,0,0,8,2,10,21,10,31,2,1,3,12,14,26,93,102,195,348
20192020,047,HARDIN,231,Hardin County,075,North Hardin High School,231075,047231075,210249000517,GRREC,902,12,172,143,38,49,87,1,2,3,1,2,3,16,12,28,2,1,3,7,17,24,78,89,167,315
20192020,047,HARDIN,231,Hardin County,077,James T Alton Middle School,231077,047231077,210249000518,GRREC,902,07,126,119,15,18,33,0,0,0,1,2,3,15,11,26,0,0,0,15,14,29,73,81,154,245
20192020,047,HARDIN,231,Hardin County,077,James T Alton Middle School,231077,047231077,210249000518,GRREC,902,All Students,346,349,44,52,96,0,2,2,3,4,7,32,36,68,1,3,4,42,30,72,227,219,446,695
20192020,047,HARDIN,231,Hardin County,077,James T Alton Middle School,231077,047231077,210249000518,GRREC,902,06,108,125,18,17,35,0,0,0,2,1,3,8,14,22,0,2,2,19,9,28,78,65,143,233
20192020,047,HARDIN,231,Hardin County,077,James T Alton Middle School,231077,047231077,210249000518,GRREC,902,08,112,105,11,17,28,0,2,2,0,1,1,9,11,20,1,1,2,8,7,15,76,73,149,217
20192020,047,HARDIN,231,Hardin County,079,Radcliff Elementary School,231079,047231079,210249000519,GRREC,902,04,45,50,9,10,19,0,1,1,0,1,1,8,6,14,0,0,0,7,6,13,26,21,47,95
20192020,047,HARDIN,231,Hardin County,079,Radcliff Elementary School,231079,047231079,210249000519,GRREC,902,All Students,235,224,51,45,96,0,1,1,1,3,4,31,29,60,3,2,5,27,38,65,111,117,228,459
20192020,047,HARDIN,231,Hardin County,079,Radcliff Elementary School,231079,047231079,210249000519,GRREC,902,01,52,60,12,11,23,0,0,0,0,0,0,9,7,16,1,0,1,8,4,12,30,30,60,112
20192020,047,HARDIN,231,Hardin County,079,Radcliff Elementary School,231079,047231079,210249000519,GRREC,902,02,51,41,10,12,22,0,0,0,1,1,2,4,9,13,0,1,1,3,7,10,23,21,44,92
20192020,047,HARDIN,231,Hardin County,079,Radcliff Elementary School,231079,047231079,210249000519,GRREC,902,03,45,41,15,5,20,0,0,0,0,1,1,6,6,12,1,0,1,2,8,10,17,25,42,86
20192020,047,HARDIN,231,Hardin County,079,Radcliff Elementary School,231079,047231079,210249000519,GRREC,902,05,42,32,5,7,12,0,0,0,0,0,0,4,1,5,1,1,2,7,13,20,15,20,35,74
20192020,047,HARDIN,231,Hardin County,080,North Middle School,231080,047231080,210249000520,GRREC,902,07,96,113,28,27,55,0,0,0,2,1,3,10,13,23,1,0,1,13,13,26,59,42,101,209
20192020,047,HARDIN,231,Hardin County,080,North Middle School,231080,047231080,210249000520,GRREC,902,All Students,322,336,99,90,189,0,0,0,8,2,10,35,41,76,4,2,6,38,40,78,152,147,299,658
20192020,047,HARDIN,231,Hardin County,080,North Middle School,231080,047231080,210249000520,GRREC,902,06,111,108,38,34,72,0,0,0,2,0,2,12,14,26,2,0,2,12,13,25,42,50,92,219
20192020,047,HARDIN,231,Hardin County,080,North Middle School,231080,047231080,210249000520,GRREC,902,08,115,115,33,29,62,0,0,0,4,1,5,13,14,27,1,2,3,13,14,27,51,55,106,230
20192020,047,HARDIN,231,Hardin County,090,Rineyville Elementary School,231090,047231090,210249000521,GRREC,902,04,38,41,5,1,6,0,0,0,0,0,0,3,2,5,0,0,0,5,2,7,28,33,61,79
20192020,047,HARDIN,231,Hardin County,090,Rineyville Elementary School,231090,047231090,210249000521,GRREC,902,All Students,276,264,14,18,32,0,0,0,2,1,3,19,16,35,4,1,5,25,18,43,200,222,422,540
20192020,047,HARDIN,231,Hardin County,090,Rineyville Elementary School,231090,047231090,210249000521,GRREC,902,KG,45,49,3,4,7,0,0,0,1,0,1,4,4,8,2,1,3,6,2,8,33,34,67,94
20192020,047,HARDIN,231,Hardin County,090,Rineyville Elementary School,231090,047231090,210249000521,GRREC,902,01,46,45,3,4,7,0,0,0,1,1,2,0,3,3,1,0,1,8,3,11,32,35,67,91
20192020,047,HARDIN,231,Hardin County,090,Rineyville Elementary School,231090,047231090,210249000521,GRREC,902,02,39,37,1,1,2,0,0,0,0,0,0,7,1,8,1,0,1,0,4,4,28,33,61,76
20192020,047,HARDIN,231,Hardin County,090,Rineyville Elementary School,231090,047231090,210249000521,GRREC,902,03,56,49,2,4,6,0,0,0,0,0,0,2,2,4,0,0,0,0,5,5,45,45,90,105
20192020,047,HARDIN,231,Hardin County,090,Rineyville Elementary School,231090,047231090,210249000521,GRREC,902,05,52,43,0,4,4,0,0,0,0,0,0,3,4,7,0,0,0,6,2,8,34,42,76,95
20192020,047,HARDIN,231,Hardin County,165,Vine Grove Elementary School,231165,047231165,210249000524,GRREC,902,04,39,46,2,3,5,0,0,0,1,1,2,4,1,5,0,0,0,7,3,10,32,31,63,85
20192020,047,HARDIN,231,Hardin County,165,Vine Grove Elementary School,231165,047231165,210249000524,GRREC,902,All Students,258,255,23,24,47,0,1,1,5,4,9,22,24,46,3,3,6,35,27,62,167,175,342,513
20192020,047,HARDIN,231,Hardin County,165,Vine Grove Elementary School,231165,047231165,210249000524,GRREC,902,01,60,53,5,7,12,0,0,0,0,1,1,6,6,12,1,0,1,5,9,14,36,37,73,113
20192020,047,HARDIN,231,Hardin County,165,Vine Grove Elementary School,231165,047231165,210249000524,GRREC,902,02,45,49,4,5,9,0,1,1,1,1,2,2,2,4,0,2,2,9,4,13,33,30,63,94
20192020,047,HARDIN,231,Hardin County,165,Vine Grove Elementary School,231165,047231165,210249000524,GRREC,902,03,51,54,6,4,10,0,0,0,0,1,1,8,8,16,2,0,2,6,7,13,32,31,63,105
20192020,047,HARDIN,231,Hardin County,165,Vine Grove Elementary School,231165,047231165,210249000524,GRREC,902,05,63,53,6,5,11,0,0,0,3,0,3,2,7,9,0,1,1,8,4,12,34,46,80,116
20192020,047,HARDIN,231,Hardin County,168,West Hardin Middle School,231168,047231168,210249000525,GRREC,902,07,94,99,6,1,7,0,0,0,0,0,0,4,6,10,0,0,0,4,4,8,85,83,168,193
20192020,047,HARDIN,231,Hardin County,168,West Hardin Middle School,231168,047231168,210249000525,GRREC,902,All Students,279,309,8,8,16,0,0,0,2,1,3,21,23,44,0,0,0,15,17,32,263,230,493,588
20192020,047,HARDIN,231,Hardin County,168,West Hardin Middle School,231168,047231168,210249000525,GRREC,902,06,101,108,1,4,5,0,0,0,1,1,2,12,12,24,0,0,0,4,9,13,90,75,165,209
20192020,047,HARDIN,231,Hardin County,168,West Hardin Middle School,231168,047231168,210249000525,GRREC,902,08,84,102,1,3,4,0,0,0,1,0,1,5,5,10,0,0,0,7,4,11,88,72,160,186
20192020,047,HARDIN,231,Hardin County,180,Hardin County Day Treatment Center,231180,047231180,210249000656,GRREC,902,All Students,6,16,6,2,8,0,0,0,0,0,0,2,1,3,0,0,0,4,1,5,4,2,6,22
20192020,047,HARDIN,231,Hardin County,180,Hardin County Day Treatment Center,231180,047231180,210249000656,GRREC,902,07,0,2,2,0,2,0,0,0,0,0,0,0,0,0,0,0,0,0,0,0,0,0,0,2
20192020,047,HARDIN,231,Hardin County,180,Hardin County Day Treatment Center,231180,047231180,210249000656,GRREC,902,08,3,4,2,1,3,0,0,0,0,0,0,0,0,0,0,0,0,1,1,2,1,1,2,7
20192020,047,HARDIN,231,Hardin County,180,Hardin County Day Treatment Center,231180,047231180,210249000656,GRREC,902,09,2,5,1,1,2,0,0,0,0,0,0,1,1,2,0,0,0,1,0,1,2,0,2,7
20192020,047,HARDIN,231,Hardin County,180,Hardin County Day Treatment Center,231180,047231180,210249000656,GRREC,902,10,1,2,0,0,0,0,0,0,0,0,0,1,0,1,0,0,0,1,0,1,0,1,1,3
20192020,047,HARDIN,231,Hardin County,180,Hardin County Day Treatment Center,231180,047231180,210249000656,GRREC,902,11,0,2,1,0,1,0,0,0,0,0,0,0,0,0,0,0,0,1,0,1,0,0,0,2
20192020,047,HARDIN,231,Hardin County,180,Hardin County Day Treatment Center,231180,047231180,210249000656,GRREC,902,12,0,1,0,0,0,0,0,0,0,0,0,0,0,0,0,0,0,0,0,0,1,0,1,1
20192020,047,HARDIN,231,Hardin County,190,Central Hardin High School,231190,047231190,210249000528,GRREC,902,All Students,924,921,40,28,68,1,2,3,8,13,21,46,47,93,2,2,4,26,37,63,798,795,1593,1845
20192020,047,HARDIN,231,Hardin County,190,Central Hardin High School,231190,047231190,210249000528,GRREC,902,09,275,233,9,8,17,0,0,0,1,2,3,18,9,27,0,1,1,11,9,20,194,246,440,508
20192020,047,HARDIN,231,Hardin County,190,Central Hardin High School,231190,047231190,210249000528,GRREC,902,10,234,224,9,6,15,0,1,1,4,2,6,9,12,21,0,0,0,5,11,16,197,202,399,458
20192020,047,HARDIN,231,Hardin County,190,Central Hardin High School,231190,047231190,210249000528,GRREC,902,11,221,255,9,10,19,0,0,0,3,4,7,13,16,29,0,1,1,6,9,15,224,181,405,476
20192020,047,HARDIN,231,Hardin County,190,Central Hardin High School,231190,047231190,210249000528,GRREC,902,12,190,205,13,4,17,0,1,1,0,5,5,6,9,15,2,0,2,4,8,12,180,163,343,395
20192020,047,HARDIN,231,Hardin County,190,Central Hardin High School,231190,047231190,210249000528,GRREC,902,14,4,4,0,0,0,1,0,1,0,0,0,0,1,1,0,0,0,0,0,0,3,3,6,8
20192020,047,HARDIN,231,Hardin County,210,Meadow View Elementary School,231210,047231210,210249001566,GRREC,902,05,43,53,12,15,27,0,0,0,0,0,0,7,8,15,0,0,0,11,6,17,23,14,37,96
20192020,047,HARDIN,231,Hardin County,210,Meadow View Elementary School,231210,047231210,210249001566,GRREC,902,04,54,42,16,17,33,0,0,0,0,0,0,4,8,12,1,0,1,9,8,17,12,21,33,96
20192020,047,HARDIN,231,Hardin County,210,Meadow View Elementary School,231210,047231210,210249001566,GRREC,902,All Students,256,231,65,82,147,1,0,1,0,3,3,32,35,67,5,2,7,37,37,74,91,97,188,487
20192020,047,HARDIN,231,Hardin County,210,Meadow View Elementary School,231210,047231210,210249001566,GRREC,902,KG,0,2,2,0,2,0,0,0,0,0,0,0,0,0,0,0,0,0,0,0,0,0,0,2
20192020,047,HARDIN,231,Hardin County,210,Meadow View Elementary School,231210,047231210,210249001566,GRREC,902,01,62,50,16,16,32,0,0,0,0,2,2,10,7,17,2,0,2,6,13,19,16,24,40,112
20192020,047,HARDIN,231,Hardin County,210,Meadow View Elementary School,231210,047231210,210249001566,GRREC,902,02,44,32,7,14,21,0,0,0,0,1,1,4,5,9,0,0,0,4,5,9,17,19,36,76
20192020,047,HARDIN,231,Hardin County,210,Meadow View Elementary School,231210,047231210,210249001566,GRREC,902,03,53,52,12,20,32,1,0,1,0,0,0,7,7,14,2,2,4,7,5,12,23,19,42,105
20192020,047,HARDIN,231,Hardin County,976,Crossroads Treatment Center,231976,047231976,210249002269,GRREC,902,11,0,1,1,0,1,0,0,0,0,0,0,0,0,0,0,0,0,0,0,0,0,0,0,1
20192020,047,HARDIN,231,Hardin County,976,Crossroads Treatment Center,231976,047231976,210249002269,GRREC,902,All Students,0,14,3,0,3,0,0,0,0,0,0,1,0,1,0,0,0,0,0,0,10,0,10,14
20192020,047,HARDIN,231,Hardin County,976,Crossroads Treatment Center,231976,047231976,210249002269,GRREC,902,08,0,4,1,0,1,0,0,0,0,0,0,0,0,0,0,0,0,0,0,0,3,0,3,4
20192020,047,HARDIN,231,Hardin County,976,Crossroads Treatment Center,231976,047231976,210249002269,GRREC,902,09,0,3,0,0,0,0,0,0,0,0,0,1,0,1,0,0,0,0,0,0,2,0,2,3
20192020,047,HARDIN,231,Hardin County,976,Crossroads Treatment Center,231976,047231976,210249002269,GRREC,902,10,0,5,1,0,1,0,0,0,0,0,0,0,0,0,0,0,0,0,0,0,4,0,4,5
20192020,047,HARDIN,231,Hardin County,976,Crossroads Treatment Center,231976,047231976,210249002269,GRREC,902,12,0,1,0,0,0,0,0,0,0,0,0,0,0,0,0,0,0,0,0,0,1,0,1,1
20192020,047,HARDIN,231,Hardin County,979,Lincoln Trail Behavioral Health Systems,231979,047231979,210249002249,GRREC,902,10,6,0,0,0,0,0,0,0,0,0,0,0,0,0,0,0,0,0,0,0,0,6,6,6
20192020,047,HARDIN,231,Hardin County,979,Lincoln Trail Behavioral Health Systems,231979,047231979,210249002249,GRREC,902,All Students,27,0,0,1,1,0,1,1,0,0,0,0,3,3,0,0,0,0,0,0,0,22,22,27
20192020,047,HARDIN,231,Hardin County,979,Lincoln Trail Behavioral Health Systems,231979,047231979,210249002249,GRREC,902,06,3,0,0,0,0,0,0,0,0,0,0,0,0,0,0,0,0,0,0,0,0,3,3,3
20192020,047,HARDIN,231,Hardin County,979,Lincoln Trail Behavioral Health Systems,231979,047231979,210249002249,GRREC,902,07,3,0,0,0,0,0,0,0,0,0,0,0,1,1,0,0,0,0,0,0,0,2,2,3
20192020,047,HARDIN,231,Hardin County,979,Lincoln Trail Behavioral Health Systems,231979,047231979,210249002249,GRREC,902,08,3,0,0,1,1,0,0,0,0,0,0,0,0,0,0,0,0,0,0,0,0,2,2,3
20192020,047,HARDIN,231,Hardin County,979,Lincoln Trail Behavioral Health Systems,231979,047231979,210249002249,GRREC,902,09,11,0,0,0,0,0,1,1,0,0,0,0,2,2,0,0,0,0,0,0,0,8,8,11
20192020,047,HARDIN,231,Hardin County,979,Lincoln Trail Behavioral Health Systems,231979,047231979,210249002249,GRREC,902,11,1,0,0,0,0,0,0,0,0,0,0,0,0,0,0,0,0,0,0,0,0,1,1,1
20192020,047,HARDIN,231,Hardin County,982,Spectrum Care Academy,231982,047231982,210249002248,GRREC,902,05,0,1,0,0,0,0,0,0,0,0,0,0,0,0,0,0,0,0,0,0,1,0,1,1
20192020,047,HARDIN,231,Hardin County,982,Spectrum Care Academy,231982,047231982,210249002248,GRREC,902,08,0,2,0,0,0,0,0,0,0,0,0,0,0,0,0,0,0,0,0,0,2,0,2,2
20192020,047,HARDIN,231,Hardin County,982,Spectrum Care Academy,231982,047231982,210249002248,GRREC,902,All Students,0,8,1,0,1,0,0,0,0,0,0,0,0,0,0,0,0,0,0,0,7,0,7,8
20192020,047,HARDIN,231,Hardin County,982,Spectrum Care Academy,231982,047231982,210249002248,GRREC,902,02,0,1,1,0,1,0,0,0,0,0,0,0,0,0,0,0,0,0,0,0,0,0,0,1
20192020,047,HARDIN,231,Hardin County,982,Spectrum Care Academy,231982,047231982,210249002248,GRREC,902,03,0,1,0,0,0,0,0,0,0,0,0,0,0,0,0,0,0,0,0,0,1,0,1,1
20192020,047,HARDIN,231,Hardin County,982,Spectrum Care Academy,231982,047231982,210249002248,GRREC,902,04,0,1,0,0,0,0,0,0,0,0,0,0,0,0,0,0,0,0,0,0,1,0,1,1
20192020,047,HARDIN,231,Hardin County,982,Spectrum Care Academy,231982,047231982,210249002248,GRREC,902,06,0,2,0,0,0,0,0,0,0,0,0,0,0,0,0,0,0,0,0,0,2,0,2,2
20192020,048,HARLAN,235,Harlan County,"",---District Total---,235,"","",SESC,907,12,117,106,1,1,2,0,0,0,0,1,1,1,0,1,0,0,0,1,0,1,103,115,218,223
20192020,048,HARLAN,235,Harlan County,"",---District Total---,235,"","",SESC,907,All Students,1801,1882,26,30,56,0,1,1,1,3,4,27,31,58,0,0,0,22,19,41,1806,1717,3523,3683
20192020,048,HARLAN,235,Harlan County,"",---District Total---,235,"","",SESC,907,PS,94,73,1,2,3,0,0,0,0,0,0,0,2,2,0,0,0,0,3,3,72,87,159,167
20192020,048,HARLAN,235,Harlan County,"",---District Total---,235,"","",SESC,907,KG,120,146,3,1,4,0,0,0,1,0,1,3,2,5,0,0,0,6,2,8,133,115,248,266
20192020,048,HARLAN,235,Harlan County,"",---District Total---,235,"","",SESC,907,01,168,159,0,1,1,0,0,0,0,1,1,1,4,5,0,0,0,5,2,7,153,160,313,327
20192020,048,HARLAN,235,Harlan County,"",---District Total---,235,"","",SESC,907,02,143,132,0,1,1,0,0,0,0,0,0,3,1,4,0,0,0,2,1,3,127,140,267,275
20192020,048,HARLAN,235,Harlan County,"",---District Total---,235,"","",SESC,907,03,154,134,1,3,4,0,0,0,0,0,0,2,2,4,0,0,0,0,1,1,131,148,279,288
20192020,048,HARLAN,235,Harlan County,"",---District Total---,235,"","",SESC,907,04,135,141,4,0,4,0,0,0,0,0,0,2,7,9,0,0,0,0,0,0,135,128,263,276
20192020,048,HARLAN,235,Harlan County,"",---District Total---,235,"","",SESC,907,05,149,160,1,2,3,0,0,0,0,0,0,3,2,5,0,0,0,1,6,7,155,139,294,309
20192020,048,HARLAN,235,Harlan County,"",---District Total---,235,"","",SESC,907,06,151,158,6,3,9,0,0,0,0,1,1,2,0,2,0,0,0,2,1,3,148,146,294,309
20192020,048,HARLAN,235,Harlan County,"",---District Total---,235,"","",SESC,907,07,160,169,1,3,4,0,1,1,0,0,0,4,1,5,0,0,0,0,1,1,164,154,318,329
20192020,048,HARLAN,235,Harlan County,"",---District Total---,235,"","",SESC,907,08,149,154,4,1,5,0,0,0,0,0,0,2,3,5,0,0,0,2,2,4,146,143,289,303
20192020,048,HARLAN,235,Harlan County,"",---District Total---,235,"","",SESC,907,09,137,150,1,4,5,0,0,0,0,0,0,1,6,7,0,0,0,2,2,4,146,125,271,287
20192020,048,HARLAN,235,Harlan County,"",---District Total---,235,"","",SESC,907,10,118,129,1,7,8,0,0,0,0,0,0,1,2,3,0,0,0,0,1,1,127,108,235,247
20192020,048,HARLAN,235,Harlan County,"",---District Total---,235,"","",SESC,907,11,100,144,3,3,6,0,0,0,0,0,0,2,1,3,0,0,0,1,0,1,138,96,234,244
20192020,048,HARLAN,235,Harlan County,025,Harlan County High School,235025,048235025,210254002213,SESC,907,All Students,472,529,6,15,21,0,0,0,0,1,1,5,9,14,0,0,0,4,3,7,514,444,958,1001
20192020,048,HARLAN,235,Harlan County,025,Harlan County High School,235025,048235025,210254002213,SESC,907,09,137,150,1,4,5,0,0,0,0,0,0,1,6,7,0,0,0,2,2,4,146,125,271,287
20192020,048,HARLAN,235,Harlan County,025,Harlan County High School,235025,048235025,210254002213,SESC,907,10,118,129,1,7,8,0,0,0,0,0,0,1,2,3,0,0,0,0,1,1,127,108,235,247
20192020,048,HARLAN,235,Harlan County,025,Harlan County High School,235025,048235025,210254002213,SESC,907,11,100,144,3,3,6,0,0,0,0,0,0,2,1,3,0,0,0,1,0,1,138,96,234,244
20192020,048,HARLAN,235,Harlan County,025,Harlan County High School,235025,048235025,210254002213,SESC,907,12,117,106,1,1,2,0,0,0,0,1,1,1,0,1,0,0,0,1,0,1,103,115,218,223
20192020,048,HARLAN,235,Harlan County,060,Black Mountain Elementary School,235060,048235060,210254000532,SESC,907,02,15,17,0,0,0,0,0,0,0,0,0,0,0,0,0,0,0,1,1,2,16,14,30,32
20192020,048,HARLAN,235,Harlan County,060,Black Mountain Elementary School,235060,048235060,210254000532,SESC,907,03,21,7,0,0,0,0,0,0,0,0,0,0,0,0,0,0,0,0,0,0,7,21,28,28
20192020,048,HARLAN,235,Harlan County,060,Black Mountain Elementary School,235060,048235060,210254000532,SESC,907,04,14,20,3,0,3,0,0,0,0,0,0,0,1,1,0,0,0,0,0,0,17,13,30,34
20192020,048,HARLAN,235,Harlan County,060,Black Mountain Elementary School,235060,048235060,210254000532,SESC,907,05,14,18,0,1,1,0,0,0,0,0,0,0,0,0,0,0,0,0,0,0,18,13,31,32
20192020,048,HARLAN,235,Harlan County,060,Black Mountain Elementary School,235060,048235060,210254000532,SESC,907,06,15,16,1,2,3,0,0,0,0,0,0,1,0,1,0,0,0,1,0,1,13,13,26,31
20192020,048,HARLAN,235,Harlan County,060,Black Mountain Elementary School,235060,048235060,210254000532,SESC,907,08,13,10,0,0,0,0,0,0,0,0,0,0,0,0,0,0,0,0,0,0,10,13,23,23
20192020,048,HARLAN,235,Harlan County,060,Black Mountain Elementary School,235060,048235060,210254000532,SESC,907,07,19,24,1,0,1,0,0,0,0,0,0,0,0,0,0,0,0,0,0,0,23,19,42,43
20192020,048,HARLAN,235,Harlan County,060,Black Mountain Elementary School,235060,048235060,210254000532,SESC,907,All Students,148,153,5,3,8,0,0,0,0,0,0,1,2,3,0,0,0,4,2,6,143,141,284,301
20192020,048,HARLAN,235,Harlan County,060,Black Mountain Elementary School,235060,048235060,210254000532,SESC,907,PS,15,12,0,0,0,0,0,0,0,0,0,0,1,1,0,0,0,0,1,1,12,13,25,27
20192020,048,HARLAN,235,Harlan County,060,Black Mountain Elementary School,235060,048235060,210254000532,SESC,907,KG,15,21,0,0,0,0,0,0,0,0,0,0,0,0,0,0,0,1,0,1,20,15,35,36
20192020,048,HARLAN,235,Harlan County,060,Black Mountain Elementary School,235060,048235060,210254000532,SESC,907,01,22,20,0,0,0,0,0,0,0,0,0,0,1,1,0,0,0,1,1,2,19,20,39,42
20192020,048,HARLAN,235,Harlan County,110,Cawood Elementary School,235110,048235110,210254000534,SESC,907,07,12,13,0,0,0,0,0,0,0,0,0,0,0,0,0,0,0,0,1,1,13,11,24,25
20192020,048,HARLAN,235,Harlan County,110,Cawood Elementary School,235110,048235110,210254000534,SESC,907,All Students,118,107,1,0,1,0,0,0,0,0,0,0,1,1,0,0,0,0,2,2,106,115,221,225
20192020,048,HARLAN,235,Harlan County,110,Cawood Elementary School,235110,048235110,210254000534,SESC,907,PS,14,7,0,0,0,0,0,0,0,0,0,0,0,0,0,0,0,0,1,1,7,13,20,21
20192020,048,HARLAN,235,Harlan County,110,Cawood Elementary School,235110,048235110,210254000534,SESC,907,KG,10,12,1,0,1,0,0,0,0,0,0,0,0,0,0,0,0,0,0,0,11,10,21,22
20192020,048,HARLAN,235,Harlan County,110,Cawood Elementary School,235110,048235110,210254000534,SESC,907,01,14,13,0,0,0,0,0,0,0,0,0,0,1,1,0,0,0,0,0,0,13,13,26,27
20192020,048,HARLAN,235,Harlan County,110,Cawood Elementary School,235110,048235110,210254000534,SESC,907,02,15,10,0,0,0,0,0,0,0,0,0,0,0,0,0,0,0,0,0,0,10,15,25,25
20192020,048,HARLAN,235,Harlan County,110,Cawood Elementary School,235110,048235110,210254000534,SESC,907,03,10,7,0,0,0,0,0,0,0,0,0,0,0,0,0,0,0,0,0,0,7,10,17,17
20192020,048,HARLAN,235,Harlan County,110,Cawood Elementary School,235110,048235110,210254000534,SESC,907,04,7,7,0,0,0,0,0,0,0,0,0,0,0,0,0,0,0,0,0,0,7,7,14,14
20192020,048,HARLAN,235,Harlan County,110,Cawood Elementary School,235110,048235110,210254000534,SESC,907,05,18,13,0,0,0,0,0,0,0,0,0,0,0,0,0,0,0,0,1,1,13,17,30,31
20192020,048,HARLAN,235,Harlan County,110,Cawood Elementary School,235110,048235110,210254000534,SESC,907,06,18,15,0,0,0,0,0,0,0,0,0,0,0,0,0,0,0,0,0,0,15,18,33,33
20192020,048,HARLAN,235,Harlan County,110,Cawood Elementary School,235110,048235110,210254000534,SESC,907,08,14,17,0,0,0,0,0,0,0,0,0,0,0,0,0,0,0,0,0,0,17,14,31,31
20192020,048,HARLAN,235,Harlan County,195,Cumberland Elementary School,235195,048235195,210254000091,SESC,907,07,34,27,0,1,1,0,0,0,0,0,0,1,0,1,0,0,0,0,0,0,26,33,59,61
20192020,048,HARLAN,235,Harlan County,195,Cumberland Elementary School,235195,048235195,210254000091,SESC,907,All Students,245,253,8,6,14,0,0,0,1,2,3,5,5,10,0,0,0,8,4,12,231,228,459,498
20192020,048,HARLAN,235,Harlan County,195,Cumberland Elementary School,235195,048235195,210254000091,SESC,907,PS,17,13,0,1,1,0,0,0,0,0,0,0,0,0,0,0,0,0,1,1,13,15,28,30
20192020,048,HARLAN,235,Harlan County,195,Cumberland Elementary School,235195,048235195,210254000091,SESC,907,KG,25,30,1,1,2,0,0,0,1,0,1,0,1,1,0,0,0,3,1,4,25,22,47,55
20192020,048,HARLAN,235,Harlan County,195,Cumberland Elementary School,235195,048235195,210254000091,SESC,907,01,22,22,0,0,0,0,0,0,0,1,1,0,1,1,0,0,0,3,1,4,19,19,38,44
20192020,048,HARLAN,235,Harlan County,195,Cumberland Elementary School,235195,048235195,210254000091,SESC,907,02,25,23,0,0,0,0,0,0,0,0,0,1,1,2,0,0,0,0,0,0,22,24,46,48
20192020,048,HARLAN,235,Harlan County,195,Cumberland Elementary School,235195,048235195,210254000091,SESC,907,03,31,24,0,2,2,0,0,0,0,0,0,0,1,1,0,0,0,0,0,0,24,28,52,55
20192020,048,HARLAN,235,Harlan County,195,Cumberland Elementary School,235195,048235195,210254000091,SESC,907,04,19,31,1,0,1,0,0,0,0,0,0,0,0,0,0,0,0,0,0,0,30,19,49,50
20192020,048,HARLAN,235,Harlan County,195,Cumberland Elementary School,235195,048235195,210254000091,SESC,907,05,25,28,0,1,1,0,0,0,0,0,0,1,0,1,0,0,0,0,1,1,27,23,50,53
20192020,048,HARLAN,235,Harlan County,195,Cumberland Elementary School,235195,048235195,210254000091,SESC,907,06,32,32,4,1,5,0,0,0,0,1,1,0,0,0,0,0,0,1,0,1,27,30,57,64
20192020,048,HARLAN,235,Harlan County,195,Cumberland Elementary School,235195,048235195,210254000091,SESC,907,08,32,36,2,0,2,0,0,0,0,0,0,2,1,3,0,0,0,1,1,2,31,30,61,68
20192020,048,HARLAN,235,Harlan County,290,Evarts Elementary School,235290,048235290,210254000539,SESC,907,05,16,24,1,0,1,0,0,0,0,0,0,0,0,0,0,0,0,0,1,1,23,15,38,40
20192020,048,HARLAN,235,Harlan County,290,Evarts Elementary School,235290,048235290,210254000539,SESC,907,All Students,185,180,2,2,4,0,0,0,0,0,0,5,6,11,0,0,0,1,1,2,172,176,348,365
20192020,048,HARLAN,235,Harlan County,290,Evarts Elementary School,235290,048235290,210254000539,SESC,907,PS,13,13,1,0,1,0,0,0,0,0,0,0,0,0,0,0,0,0,0,0,12,13,25,26
20192020,048,HARLAN,235,Harlan County,290,Evarts Elementary School,235290,048235290,210254000539,SESC,907,KG,17,17,0,0,0,0,0,0,0,0,0,1,0,1,0,0,0,0,0,0,16,17,33,34
20192020,048,HARLAN,235,Harlan County,290,Evarts Elementary School,235290,048235290,210254000539,SESC,907,01,27,20,0,0,0,0,0,0,0,0,0,0,1,1,0,0,0,1,0,1,19,26,45,47
20192020,048,HARLAN,235,Harlan County,290,Evarts Elementary School,235290,048235290,210254000539,SESC,907,02,26,17,0,0,0,0,0,0,0,0,0,1,0,1,0,0,0,0,0,0,16,26,42,43
20192020,048,HARLAN,235,Harlan County,290,Evarts Elementary School,235290,048235290,210254000539,SESC,907,03,17,21,0,0,0,0,0,0,0,0,0,1,1,2,0,0,0,0,0,0,20,16,36,38
20192020,048,HARLAN,235,Harlan County,290,Evarts Elementary School,235290,048235290,210254000539,SESC,907,04,17,18,0,0,0,0,0,0,0,0,0,0,1,1,0,0,0,0,0,0,18,16,34,35
20192020,048,HARLAN,235,Harlan County,290,Evarts Elementary School,235290,048235290,210254000539,SESC,907,06,19,25,0,0,0,0,0,0,0,0,0,1,0,1,0,0,0,0,0,0,24,19,43,44
20192020,048,HARLAN,235,Harlan County,290,Evarts Elementary School,235290,048235290,210254000539,SESC,907,07,21,17,0,2,2,0,0,0,0,0,0,1,1,2,0,0,0,0,0,0,16,18,34,38
20192020,048,HARLAN,235,Harlan County,290,Evarts Elementary School,235290,048235290,210254000539,SESC,907,08,25,21,1,0,1,0,0,0,0,0,0,0,2,2,0,0,0,0,0,0,20,23,43,46
20192020,048,HARLAN,235,Harlan County,325,Green Hills Elementary School,235325,048235325,210254000540,SESC,907,08,6,5,0,0,0,0,0,0,0,0,0,0,0,0,0,0,0,0,0,0,5,6,11,11
20192020,048,HARLAN,235,Harlan County,325,Green Hills Elementary School,235325,048235325,210254000540,SESC,907,All Students,53,69,0,0,0,0,0,0,0,0,0,0,0,0,0,0,0,2,0,2,67,53,120,122
20192020,048,HARLAN,235,Harlan County,325,Green Hills Elementary School,235325,048235325,210254000540,SESC,907,PS,6,4,0,0,0,0,0,0,0,0,0,0,1,1,0,0,0,0,0,0,4,5,9,10
20192020,048,HARLAN,235,Harlan County,325,Green Hills Elementary School,235325,048235325,210254000540,SESC,907,KG,6,7,0,0,0,0,0,0,0,0,0,0,0,0,0,0,0,0,0,0,7,6,13,13
20192020,048,HARLAN,235,Harlan County,325,Green Hills Elementary School,235325,048235325,210254000540,SESC,907,01,9,10,0,0,0,0,0,0,0,0,0,0,0,0,0,0,0,0,0,0,10,9,19,19
20192020,048,HARLAN,235,Harlan County,325,Green Hills Elementary School,235325,048235325,210254000540,SESC,907,02,4,10,0,0,0,0,0,0,0,0,0,0,0,0,0,0,0,1,0,1,9,4,13,14
20192020,048,HARLAN,235,Harlan County,325,Green Hills Elementary School,235325,048235325,210254000540,SESC,907,03,5,7,0,0,0,0,0,0,0,0,0,0,0,0,0,0,0,0,0,0,7,5,12,12
20192020,048,HARLAN,235,Harlan County,325,Green Hills Elementary School,235325,048235325,210254000540,SESC,907,04,3,4,0,0,0,0,0,0,0,0,0,0,0,0,0,0,0,0,0,0,4,3,7,7
20192020,048,HARLAN,235,Harlan County,325,Green Hills Elementary School,235325,048235325,210254000540,SESC,907,05,9,8,0,0,0,0,0,0,0,0,0,0,0,0,0,0,0,1,0,1,7,9,16,17
20192020,048,HARLAN,235,Harlan County,325,Green Hills Elementary School,235325,048235325,210254000540,SESC,907,06,7,11,0,0,0,0,0,0,0,0,0,0,0,0,0,0,0,0,0,0,11,7,18,18
20192020,048,HARLAN,235,Harlan County,325,Green Hills Elementary School,235325,048235325,210254000540,SESC,907,07,4,7,0,0,0,0,0,0,0,0,0,0,0,0,0,0,0,0,0,0,7,4,11,11
20192020,048,HARLAN,235,Harlan County,340,James A. Cawood Elementary,235340,048235340,210254000541,SESC,907,03,19,19,1,1,2,0,0,0,0,0,0,1,0,1,0,0,0,0,0,0,17,18,35,38
20192020,048,HARLAN,235,Harlan County,340,James A. Cawood Elementary,235340,048235340,210254000541,SESC,907,All Students,163,193,3,3,6,0,0,0,0,0,0,7,5,12,0,0,0,1,0,1,182,155,337,356
20192020,048,HARLAN,235,Harlan County,340,James A. Cawood Elementary,235340,048235340,210254000541,SESC,907,PS,18,8,0,1,1,0,0,0,0,0,0,0,0,0,0,0,0,0,0,0,8,17,25,26
20192020,048,HARLAN,235,Harlan County,340,James A. Cawood Elementary,235340,048235340,210254000541,SESC,907,KG,14,19,1,0,1,0,0,0,0,0,0,2,0,2,0,0,0,0,0,0,16,14,30,33
20192020,048,HARLAN,235,Harlan County,340,James A. Cawood Elementary,235340,048235340,210254000541,SESC,907,01,15,22,0,0,0,0,0,0,0,0,0,0,0,0,0,0,0,0,0,0,22,15,37,37
20192020,048,HARLAN,235,Harlan County,340,James A. Cawood Elementary,235340,048235340,210254000541,SESC,907,02,17,17,0,1,1,0,0,0,0,0,0,0,0,0,0,0,0,0,0,0,17,16,33,34
20192020,048,HARLAN,235,Harlan County,340,James A. Cawood Elementary,235340,048235340,210254000541,SESC,907,04,26,24,0,0,0,0,0,0,0,0,0,2,4,6,0,0,0,0,0,0,22,22,44,50
20192020,048,HARLAN,235,Harlan County,340,James A. Cawood Elementary,235340,048235340,210254000541,SESC,907,05,18,27,0,0,0,0,0,0,0,0,0,1,1,2,0,0,0,0,0,0,26,17,43,45
20192020,048,HARLAN,235,Harlan County,340,James A. Cawood Elementary,235340,048235340,210254000541,SESC,907,06,20,21,0,0,0,0,0,0,0,0,0,0,0,0,0,0,0,0,0,0,21,20,41,41
20192020,048,HARLAN,235,Harlan County,340,James A. Cawood Elementary,235340,048235340,210254000541,SESC,907,07,20,26,0,0,0,0,0,0,0,0,0,1,0,1,0,0,0,0,0,0,25,20,45,46
20192020,048,HARLAN,235,Harlan County,340,James A. Cawood Elementary,235340,048235340,210254000541,SESC,907,08,14,18,1,1,2,0,0,0,0,0,0,0,0,0,0,0,0,1,0,1,16,13,29,32
20192020,048,HARLAN,235,Harlan County,540,Rosspoint Elementary School,235540,048235540,210254000545,SESC,907,08,21,25,0,0,0,0,0,0,0,0,0,0,0,0,0,0,0,0,1,1,25,20,45,46
20192020,048,HARLAN,235,Harlan County,540,Rosspoint Elementary School,235540,048235540,210254000545,SESC,907,All Students,195,202,1,1,2,0,1,1,0,0,0,1,1,2,0,0,0,2,7,9,198,185,383,397
20192020,048,HARLAN,235,Harlan County,540,Rosspoint Elementary School,235540,048235540,210254000545,SESC,907,PS,1,2,0,0,0,0,0,0,0,0,0,0,0,0,0,0,0,0,0,0,2,1,3,3
20192020,048,HARLAN,235,Harlan County,540,Rosspoint Elementary School,235540,048235540,210254000545,SESC,907,KG,10,22,0,0,0,0,0,0,0,0,0,0,1,1,0,0,0,2,1,3,20,8,28,32
20192020,048,HARLAN,235,Harlan County,540,Rosspoint Elementary School,235540,048235540,210254000545,SESC,907,01,30,23,0,1,1,0,0,0,0,0,0,0,0,0,0,0,0,0,0,0,23,29,52,53
20192020,048,HARLAN,235,Harlan County,540,Rosspoint Elementary School,235540,048235540,210254000545,SESC,907,02,17,19,0,0,0,0,0,0,0,0,0,1,0,1,0,0,0,0,0,0,18,17,35,36
20192020,048,HARLAN,235,Harlan County,540,Rosspoint Elementary School,235540,048235540,210254000545,SESC,907,03,21,25,0,0,0,0,0,0,0,0,0,0,0,0,0,0,0,0,1,1,25,20,45,46
20192020,048,HARLAN,235,Harlan County,540,Rosspoint Elementary School,235540,048235540,210254000545,SESC,907,04,24,20,0,0,0,0,0,0,0,0,0,0,0,0,0,0,0,0,0,0,20,24,44,44
20192020,048,HARLAN,235,Harlan County,540,Rosspoint Elementary School,235540,048235540,210254000545,SESC,907,05,23,20,0,0,0,0,0,0,0,0,0,0,0,0,0,0,0,0,3,3,20,20,40,43
20192020,048,HARLAN,235,Harlan County,540,Rosspoint Elementary School,235540,048235540,210254000545,SESC,907,06,18,23,1,0,1,0,0,0,0,0,0,0,0,0,0,0,0,0,1,1,22,17,39,41
20192020,048,HARLAN,235,Harlan County,540,Rosspoint Elementary School,235540,048235540,210254000545,SESC,907,07,31,25,0,0,0,0,1,1,0,0,0,0,0,0,0,0,0,0,0,0,25,30,55,56
20192020,048,HARLAN,235,Harlan County,640,Wallins Elementary School,235640,048235640,210254000549,SESC,907,05,26,22,0,0,0,0,0,0,0,0,0,1,1,2,0,0,0,0,0,0,21,25,46,48
20192020,048,HARLAN,235,Harlan County,640,Wallins Elementary School,235640,048235640,210254000549,SESC,907,All Students,222,196,0,0,0,0,0,0,0,0,0,3,2,5,0,0,0,0,0,0,193,220,413,418
20192020,048,HARLAN,235,Harlan County,640,Wallins Elementary School,235640,048235640,210254000549,SESC,907,PS,10,14,0,0,0,0,0,0,0,0,0,0,0,0,0,0,0,0,0,0,14,10,24,24
20192020,048,HARLAN,235,Harlan County,640,Wallins Elementary School,235640,048235640,210254000549,SESC,907,KG,23,18,0,0,0,0,0,0,0,0,0,0,0,0,0,0,0,0,0,0,18,23,41,41
20192020,048,HARLAN,235,Harlan County,640,Wallins Elementary School,235640,048235640,210254000549,SESC,907,01,29,29,0,0,0,0,0,0,0,0,0,1,0,1,0,0,0,0,0,0,28,29,57,58
20192020,048,HARLAN,235,Harlan County,640,Wallins Elementary School,235640,048235640,210254000549,SESC,907,02,24,19,0,0,0,0,0,0,0,0,0,0,0,0,0,0,0,0,0,0,19,24,43,43
20192020,048,HARLAN,235,Harlan County,640,Wallins Elementary School,235640,048235640,210254000549,SESC,907,06,22,15,0,0,0,0,0,0,0,0,0,0,0,0,0,0,0,0,0,0,15,22,37,37
20192020,048,HARLAN,235,Harlan County,640,Wallins Elementary School,235640,048235640,210254000549,SESC,907,03,30,24,0,0,0,0,0,0,0,0,0,0,0,0,0,0,0,0,0,0,24,30,54,54
20192020,048,HARLAN,235,Harlan County,640,Wallins Elementary School,235640,048235640,210254000549,SESC,907,04,25,17,0,0,0,0,0,0,0,0,0,0,1,1,0,0,0,0,0,0,17,24,41,42
20192020,048,HARLAN,235,Harlan County,640,Wallins Elementary School,235640,048235640,210254000549,SESC,907,07,19,30,0,0,0,0,0,0,0,0,0,1,0,1,0,0,0,0,0,0,29,19,48,49
20192020,048,HARLAN,235,Harlan County,640,Wallins Elementary School,235640,048235640,210254000549,SESC,907,08,24,22,0,0,0,0,0,0,0,0,0,0,0,0,0,0,0,0,0,0,22,24,46,46
20192020,048,HARLAN,236,Harlan Independent,"",---District Total---,236,"","",SESC,907,All Students,305,296,18,11,29,0,0,0,0,6,6,10,4,14,0,0,0,16,18,34,252,266,518,601
20192020,048,HARLAN,236,Harlan Independent,"",---District Total---,236,"","",SESC,907,PS,56,47,0,1,1,0,0,0,1,0,1,2,1,3,0,0,0,6,6,12,38,48,86,103
20192020,048,HARLAN,236,Harlan Independent,"",---District Total---,236,"","",SESC,907,KG,22,34,1,2,3,0,0,0,0,0,0,2,1,3,0,0,0,4,1,5,27,18,45,56
20192020,048,HARLAN,236,Harlan Independent,"",---District Total---,236,"","",SESC,907,01,35,35,1,1,2,0,0,0,0,0,0,1,0,1,0,0,0,0,2,2,33,32,65,70
20192020,048,HARLAN,236,Harlan Independent,"",---District Total---,236,"","",SESC,907,02,26,19,0,1,1,0,0,0,0,0,0,1,0,1,0,0,0,1,1,2,17,24,41,45
20192020,048,HARLAN,236,Harlan Independent,"",---District Total---,236,"","",SESC,907,03,25,16,0,0,0,0,0,0,0,0,0,0,0,0,0,0,0,3,5,8,13,20,33,41
20192020,048,HARLAN,236,Harlan Independent,"",---District Total---,236,"","",SESC,907,04,21,22,1,0,1,0,0,0,0,0,0,0,0,0,0,0,0,2,0,2,19,21,40,43
20192020,048,HARLAN,236,Harlan Independent,"",---District Total---,236,"","",SESC,907,05,20,17,0,2,2,0,0,0,0,1,1,1,0,1,0,0,0,1,3,4,15,14,29,37
20192020,048,HARLAN,236,Harlan Independent,"",---District Total---,236,"","",SESC,907,06,27,20,2,0,2,0,0,0,0,0,0,0,1,1,0,0,0,1,2,3,17,24,41,47
20192020,048,HARLAN,236,Harlan Independent,"",---District Total---,236,"","",SESC,907,07,30,28,3,1,4,0,0,0,0,0,0,0,2,2,0,0,0,1,0,1,24,27,51,58
20192020,048,HARLAN,236,Harlan Independent,"",---District Total---,236,"","",SESC,907,08,15,27,2,0,2,0,0,0,0,1,1,2,0,2,0,0,0,1,3,4,22,11,33,42
20192020,048,HARLAN,236,Harlan Independent,"",---District Total---,236,"","",SESC,907,09,25,17,4,2,6,0,0,0,0,1,1,3,0,3,0,0,0,0,0,0,10,22,32,42
20192020,048,HARLAN,236,Harlan Independent,"",---District Total---,236,"","",SESC,907,10,13,21,3,1,4,0,0,0,0,0,0,0,0,0,0,0,0,1,0,1,17,12,29,34
20192020,048,HARLAN,236,Harlan Independent,"",---District Total---,236,"","",SESC,907,11,18,25,1,1,2,0,0,0,0,2,2,0,0,0,0,0,0,0,1,1,24,14,38,43
20192020,048,HARLAN,236,Harlan Independent,"",---District Total---,236,"","",SESC,907,12,27,15,0,0,0,0,0,0,0,1,1,0,0,0,0,0,0,1,0,1,14,26,40,42
20192020,048,HARLAN,236,Harlan Independent,"",---District Total---,236,"","",SESC,907,14,1,0,0,0,0,0,0,0,0,0,0,0,0,0,0,0,0,0,0,0,0,1,1,1
20192020,048,HARLAN,236,Harlan Independent,020,Harlan Elementary School,236020,048236020,210252000551,SESC,907,All Students,129,126,3,4,7,0,0,0,0,0,0,4,1,5,0,0,0,10,9,19,109,115,224,255
20192020,048,HARLAN,236,Harlan Independent,020,Harlan Elementary School,236020,048236020,210252000551,SESC,907,01,35,35,1,1,2,0,0,0,0,0,0,1,0,1,0,0,0,0,2,2,33,32,65,70
20192020,048,HARLAN,236,Harlan Independent,020,Harlan Elementary School,236020,048236020,210252000551,SESC,907,02,26,19,0,1,1,0,0,0,0,0,0,1,0,1,0,0,0,1,1,2,17,24,41,45
20192020,048,HARLAN,236,Harlan Independent,020,Harlan Elementary School,236020,048236020,210252000551,SESC,907,03,25,16,0,0,0,0,0,0,0,0,0,0,0,0,0,0,0,3,5,8,13,20,33,41
20192020,048,HARLAN,236,Harlan Independent,020,Harlan Elementary School,236020,048236020,210252000551,SESC,907,04,21,22,1,0,1,0,0,0,0,0,0,0,0,0,0,0,0,2,0,2,19,21,40,43
20192020,048,HARLAN,236,Harlan Independent,020,Harlan Elementary School,236020,048236020,210252000551,SESC,907,KG,22,34,1,2,3,0,0,0,0,0,0,2,1,3,0,0,0,4,1,5,27,18,45,56
20192020,048,HARLAN,236,Harlan Independent,021,Sunshine School,236021,048236021,210252002046,SESC,907,PS,56,47,0,1,1,0,0,0,1,0,1,2,1,3,0,0,0,6,6,12,38,48,86,103
20192020,048,HARLAN,236,Harlan Independent,021,Sunshine School,236021,048236021,210252002046,SESC,907,All Students,0,0,0,0,0,0,0,0,0,0,0,0,0,0,0,0,0,0,0,0,0,0,0,0
20192020,048,HARLAN,236,Harlan Independent,030,Harlan High School,236030,048236030,210252000552,SESC,907,11,18,25,1,1,2,0,0,0,0,2,2,0,0,0,0,0,0,0,1,1,24,14,38,43
20192020,048,HARLAN,236,Harlan Independent,030,Harlan High School,236030,048236030,210252000552,SESC,907,14,1,0,0,0,0,0,0,0,0,0,0,0,0,0,0,0,0,0,0,0,0,1,1,1
20192020,048,HARLAN,236,Harlan Independent,030,Harlan High School,236030,048236030,210252000552,SESC,907,12,27,15,0,0,0,0,0,0,0,1,1,0,0,0,0,0,0,1,0,1,14,26,40,42
20192020,048,HARLAN,236,Harlan Independent,030,Harlan High School,236030,048236030,210252000552,SESC,907,All Students,176,170,15,7,22,0,0,0,0,6,6,6,3,9,0,0,0,6,9,15,143,151,294,346
20192020,048,HARLAN,236,Harlan Independent,030,Harlan High School,236030,048236030,210252000552,SESC,907,05,20,17,0,2,2,0,0,0,0,1,1,1,0,1,0,0,0,1,3,4,15,14,29,37
20192020,048,HARLAN,236,Harlan Independent,030,Harlan High School,236030,048236030,210252000552,SESC,907,06,27,20,2,0,2,0,0,0,0,0,0,0,1,1,0,0,0,1,2,3,17,24,41,47
20192020,048,HARLAN,236,Harlan Independent,030,Harlan High School,236030,048236030,210252000552,SESC,907,07,30,28,3,1,4,0,0,0,0,0,0,0,2,2,0,0,0,1,0,1,24,27,51,58
20192020,048,HARLAN,236,Harlan Independent,030,Harlan High School,236030,048236030,210252000552,SESC,907,08,15,27,2,0,2,0,0,0,0,1,1,2,0,2,0,0,0,1,3,4,22,11,33,42
20192020,048,HARLAN,236,Harlan Independent,030,Harlan High School,236030,048236030,210252000552,SESC,907,09,25,17,4,2,6,0,0,0,0,1,1,3,0,3,0,0,0,0,0,0,10,22,32,42
20192020,048,HARLAN,236,Harlan Independent,030,Harlan High School,236030,048236030,210252000552,SESC,907,10,13,21,3,1,4,0,0,0,0,0,0,0,0,0,0,0,0,1,0,1,17,12,29,34
20192020,049,HARRISON,241,Harrison County,"",---District Total---,241,"","",CKEC,901,11,105,101,4,0,4,0,0,0,1,1,2,3,1,4,0,0,0,1,1,2,92,102,194,206
20192020,049,HARRISON,241,Harrison County,"",---District Total---,241,"","",CKEC,901,All Students,1358,1453,21,15,36,2,2,4,5,5,10,47,57,104,1,0,1,41,30,71,1336,1249,2585,2811
20192020,049,HARRISON,241,Harrison County,"",---District Total---,241,"","",CKEC,901,PS,65,80,2,1,3,0,0,0,1,0,1,3,3,6,0,0,0,8,9,17,66,52,118,145
20192020,049,HARRISON,241,Harrison County,"",---District Total---,241,"","",CKEC,901,KG,119,124,2,0,2,0,0,0,0,0,0,3,5,8,0,0,0,4,1,5,115,113,228,243
20192020,049,HARRISON,241,Harrison County,"",---District Total---,241,"","",CKEC,901,01,110,121,0,1,1,0,0,0,1,1,2,6,7,13,0,0,0,7,2,9,107,99,206,231
20192020,049,HARRISON,241,Harrison County,"",---District Total---,241,"","",CKEC,901,02,86,100,3,2,5,0,0,0,0,0,0,1,4,5,0,0,0,4,5,9,92,75,167,186
20192020,049,HARRISON,241,Harrison County,"",---District Total---,241,"","",CKEC,901,03,93,100,1,3,4,0,0,0,1,1,2,6,7,13,0,0,0,5,4,9,87,78,165,193
20192020,049,HARRISON,241,Harrison County,"",---District Total---,241,"","",CKEC,901,04,102,105,2,3,5,0,0,0,1,2,3,1,8,9,0,0,0,3,0,3,98,89,187,207
20192020,049,HARRISON,241,Harrison County,"",---District Total---,241,"","",CKEC,901,05,112,88,0,1,1,0,0,0,0,0,0,1,2,3,0,0,0,5,4,9,82,105,187,200
20192020,049,HARRISON,241,Harrison County,"",---District Total---,241,"","",CKEC,901,06,124,117,2,0,2,1,0,1,0,0,0,8,6,14,0,0,0,2,7,9,104,111,215,241
20192020,049,HARRISON,241,Harrison County,"",---District Total---,241,"","",CKEC,901,07,115,118,1,0,1,0,0,0,0,0,0,6,4,10,0,0,0,3,2,5,108,109,217,233
20192020,049,HARRISON,241,Harrison County,"",---District Total---,241,"","",CKEC,901,08,83,122,2,0,2,1,0,1,0,0,0,6,2,8,0,0,0,3,1,4,110,80,190,205
20192020,049,HARRISON,241,Harrison County,"",---District Total---,241,"","",CKEC,901,09,115,123,2,1,3,0,1,1,0,0,0,1,5,6,0,0,0,3,2,5,117,106,223,238
20192020,049,HARRISON,241,Harrison County,"",---District Total---,241,"","",CKEC,901,10,109,108,1,2,3,0,0,0,1,0,1,1,2,3,0,0,0,1,0,1,104,105,209,217
20192020,049,HARRISON,241,Harrison County,"",---District Total---,241,"","",CKEC,901,12,85,126,1,2,3,0,1,1,0,0,0,4,4,8,1,0,1,0,1,1,120,77,197,211
20192020,049,HARRISON,241,Harrison County,035,Eastside Elementary School,241035,049241035,210258000553,CKEC,901,04,28,42,1,1,2,0,0,0,1,0,1,1,1,2,0,0,0,1,0,1,38,26,64,70
20192020,049,HARRISON,241,Harrison County,035,Eastside Elementary School,241035,049241035,210258000553,CKEC,901,All Students,159,182,1,2,3,0,0,0,1,1,2,3,5,8,0,0,0,7,4,11,170,147,317,341
20192020,049,HARRISON,241,Harrison County,035,Eastside Elementary School,241035,049241035,210258000553,CKEC,901,PS,17,23,1,0,1,0,0,0,0,0,0,0,0,0,0,0,0,2,1,3,20,16,36,40
20192020,049,HARRISON,241,Harrison County,035,Eastside Elementary School,241035,049241035,210258000553,CKEC,901,KG,33,27,0,0,0,0,0,0,0,0,0,0,0,0,0,0,0,1,0,1,26,33,59,60
20192020,049,HARRISON,241,Harrison County,035,Eastside Elementary School,241035,049241035,210258000553,CKEC,901,01,26,25,0,0,0,0,0,0,0,0,0,1,2,3,0,0,0,0,1,1,24,23,47,51
20192020,049,HARRISON,241,Harrison County,035,Eastside Elementary School,241035,049241035,210258000553,CKEC,901,02,23,34,0,0,0,0,0,0,0,0,0,0,0,0,0,0,0,3,3,6,31,20,51,57
20192020,049,HARRISON,241,Harrison County,035,Eastside Elementary School,241035,049241035,210258000553,CKEC,901,03,22,29,0,0,0,0,0,0,0,1,1,1,1,2,0,0,0,0,0,0,28,20,48,51
20192020,049,HARRISON,241,Harrison County,035,Eastside Elementary School,241035,049241035,210258000553,CKEC,901,05,27,25,0,1,1,0,0,0,0,0,0,0,1,1,0,0,0,2,0,2,23,25,48,52
20192020,049,HARRISON,241,Harrison County,037,Harrison County Learning Center,241037,049241037,210258001995,CKEC,901,All Students,23,27,0,0,0,0,1,1,0,0,0,1,2,3,1,0,1,0,0,0,25,20,45,50
20192020,049,HARRISON,241,Harrison County,037,Harrison County Learning Center,241037,049241037,210258001995,CKEC,901,07,1,0,0,0,0,0,0,0,0,0,0,0,0,0,0,0,0,0,0,0,0,1,1,1
20192020,049,HARRISON,241,Harrison County,037,Harrison County Learning Center,241037,049241037,210258001995,CKEC,901,08,1,3,0,0,0,0,0,0,0,0,0,0,0,0,0,0,0,0,0,0,3,1,4,4
20192020,049,HARRISON,241,Harrison County,037,Harrison County Learning Center,241037,049241037,210258001995,CKEC,901,09,0,1,0,0,0,0,0,0,0,0,0,0,0,0,0,0,0,0,0,0,1,0,1,1
20192020,049,HARRISON,241,Harrison County,037,Harrison County Learning Center,241037,049241037,210258001995,CKEC,901,10,2,3,0,0,0,0,0,0,0,0,0,0,0,0,0,0,0,0,0,0,3,2,5,5
20192020,049,HARRISON,241,Harrison County,037,Harrison County Learning Center,241037,049241037,210258001995,CKEC,901,11,6,2,0,0,0,0,0,0,0,0,0,0,0,0,0,0,0,0,0,0,2,6,8,8
20192020,049,HARRISON,241,Harrison County,037,Harrison County Learning Center,241037,049241037,210258001995,CKEC,901,12,13,18,0,0,0,0,1,1,0,0,0,1,2,3,1,0,1,0,0,0,16,10,26,31
20192020,049,HARRISON,241,Harrison County,038,Southside Elementary School,241038,049241038,210258000554,CKEC,901,05,32,12,0,0,0,0,0,0,0,0,0,0,0,0,0,0,0,0,2,2,12,30,42,44
20192020,049,HARRISON,241,Harrison County,038,Southside Elementary School,241038,049241038,210258000554,CKEC,901,04,28,19,1,0,1,0,0,0,0,2,2,0,3,3,0,0,0,2,0,2,16,23,39,47
20192020,049,HARRISON,241,Harrison County,038,Southside Elementary School,241038,049241038,210258000554,CKEC,901,All Students,153,147,1,2,3,0,0,0,0,3,3,6,10,16,0,0,0,9,5,14,131,133,264,300
20192020,049,HARRISON,241,Harrison County,038,Southside Elementary School,241038,049241038,210258000554,CKEC,901,PS,14,20,0,1,1,0,0,0,1,0,1,2,0,2,0,0,0,3,4,7,14,9,23,34
20192020,049,HARRISON,241,Harrison County,038,Southside Elementary School,241038,049241038,210258000554,CKEC,901,KG,27,35,0,0,0,0,0,0,0,0,0,1,2,3,0,0,0,1,0,1,33,25,58,62
20192020,049,HARRISON,241,Harrison County,038,Southside Elementary School,241038,049241038,210258000554,CKEC,901,01,26,32,0,1,1,0,0,0,0,1,1,2,0,2,0,0,0,5,1,6,25,23,48,58
20192020,049,HARRISON,241,Harrison County,038,Southside Elementary School,241038,049241038,210258000554,CKEC,901,02,20,24,0,0,0,0,0,0,0,0,0,0,2,2,0,0,0,0,1,1,24,17,41,44
20192020,049,HARRISON,241,Harrison County,038,Southside Elementary School,241038,049241038,210258000554,CKEC,901,03,20,25,0,1,1,0,0,0,0,0,0,3,3,6,0,0,0,1,1,2,21,15,36,45
20192020,049,HARRISON,241,Harrison County,040,Harrison County High School,241040,049241040,210258000555,CKEC,901,11,99,99,4,0,4,0,0,0,1,1,2,3,1,4,0,0,0,1,1,2,90,96,186,198
20192020,049,HARRISON,241,Harrison County,040,Harrison County High School,241040,049241040,210258000555,CKEC,901,All Students,393,434,8,5,13,0,1,1,2,1,3,8,10,18,0,0,0,5,4,9,411,372,783,827
20192020,049,HARRISON,241,Harrison County,040,Harrison County High School,241040,049241040,210258000555,CKEC,901,09,115,122,2,1,3,0,1,1,0,0,0,1,5,6,0,0,0,3,2,5,116,106,222,237
20192020,049,HARRISON,241,Harrison County,040,Harrison County High School,241040,049241040,210258000555,CKEC,901,10,107,105,1,2,3,0,0,0,1,0,1,1,2,3,0,0,0,1,0,1,101,103,204,212
20192020,049,HARRISON,241,Harrison County,040,Harrison County High School,241040,049241040,210258000555,CKEC,901,12,72,108,1,2,3,0,0,0,0,0,0,3,2,5,0,0,0,0,1,1,104,67,171,180
20192020,049,HARRISON,241,Harrison County,043,Harrison County Middle School,241043,049241043,210258000556,CKEC,901,07,114,118,1,0,1,0,0,0,0,0,0,6,4,10,0,0,0,3,2,5,108,108,216,232
20192020,049,HARRISON,241,Harrison County,043,Harrison County Middle School,241043,049241043,210258000556,CKEC,901,All Students,320,354,5,0,5,2,0,2,0,0,0,20,12,32,0,0,0,8,10,18,319,298,617,674
20192020,049,HARRISON,241,Harrison County,043,Harrison County Middle School,241043,049241043,210258000556,CKEC,901,06,124,117,2,0,2,1,0,1,0,0,0,8,6,14,0,0,0,2,7,9,104,111,215,241
20192020,049,HARRISON,241,Harrison County,043,Harrison County Middle School,241043,049241043,210258000556,CKEC,901,08,82,119,2,0,2,1,0,1,0,0,0,6,2,8,0,0,0,3,1,4,107,79,186,201
20192020,049,HARRISON,241,Harrison County,045,Northside Elementary School,241045,049241045,210258000557,CKEC,901,04,20,17,0,0,0,0,0,0,0,0,0,0,3,3,0,0,0,0,0,0,17,17,34,37
20192020,049,HARRISON,241,Harrison County,045,Northside Elementary School,241045,049241045,210258000557,CKEC,901,All Students,152,147,3,2,5,0,0,0,0,0,0,6,10,16,0,0,0,8,4,12,130,136,266,299
20192020,049,HARRISON,241,Harrison County,045,Northside Elementary School,241045,049241045,210258000557,CKEC,901,PS,13,18,1,0,1,0,0,0,0,0,0,0,2,2,0,0,0,0,1,1,17,10,27,31
20192020,049,HARRISON,241,Harrison County,045,Northside Elementary School,241045,049241045,210258000557,CKEC,901,KG,31,27,0,0,0,0,0,0,0,0,0,2,1,3,0,0,0,0,0,0,25,30,55,58
20192020,049,HARRISON,241,Harrison County,045,Northside Elementary School,241045,049241045,210258000557,CKEC,901,01,30,28,0,0,0,0,0,0,0,0,0,1,4,5,0,0,0,1,0,1,26,26,52,58
20192020,049,HARRISON,241,Harrison County,045,Northside Elementary School,241045,049241045,210258000557,CKEC,901,02,22,21,2,1,3,0,0,0,0,0,0,1,2,3,0,0,0,0,0,0,18,19,37,43
20192020,049,HARRISON,241,Harrison County,045,Northside Elementary School,241045,049241045,210258000557,CKEC,901,03,22,26,1,1,2,0,0,0,0,0,0,1,0,1,0,0,0,4,2,6,20,19,39,48
20192020,049,HARRISON,241,Harrison County,045,Northside Elementary School,241045,049241045,210258000557,CKEC,901,05,27,28,0,0,0,0,0,0,0,0,0,1,0,1,0,0,0,3,2,5,24,25,49,55
20192020,049,HARRISON,241,Harrison County,075,Westside Elementary School,241075,049241075,210258000558,CKEC,901,05,26,23,0,0,0,0,0,0,0,0,0,0,1,1,0,0,0,0,0,0,23,25,48,49
20192020,049,HARRISON,241,Harrison County,075,Westside Elementary School,241075,049241075,210258000558,CKEC,901,All Students,158,162,3,4,7,0,0,0,2,0,2,3,8,11,0,0,0,4,3,7,150,143,293,320
20192020,049,HARRISON,241,Harrison County,075,Westside Elementary School,241075,049241075,210258000558,CKEC,901,PS,21,19,0,0,0,0,0,0,0,0,0,1,1,2,0,0,0,3,3,6,15,17,32,40
20192020,049,HARRISON,241,Harrison County,075,Westside Elementary School,241075,049241075,210258000558,CKEC,901,KG,28,35,2,0,2,0,0,0,0,0,0,0,2,2,0,0,0,2,1,3,31,25,56,63
20192020,049,HARRISON,241,Harrison County,075,Westside Elementary School,241075,049241075,210258000558,CKEC,901,01,28,36,0,0,0,0,0,0,1,0,1,2,1,3,0,0,0,1,0,1,32,27,59,64
20192020,049,HARRISON,241,Harrison County,075,Westside Elementary School,241075,049241075,210258000558,CKEC,901,02,21,21,1,1,2,0,0,0,0,0,0,0,0,0,0,0,0,1,1,2,19,19,38,42
20192020,049,HARRISON,241,Harrison County,075,Westside Elementary School,241075,049241075,210258000558,CKEC,901,03,29,20,0,1,1,0,0,0,1,0,1,1,3,4,0,0,0,0,1,1,18,24,42,49
20192020,049,HARRISON,241,Harrison County,075,Westside Elementary School,241075,049241075,210258000558,CKEC,901,04,26,27,0,2,2,0,0,0,0,0,0,0,1,1,0,0,0,0,0,0,27,23,50,53
20192020,050,HART,245,Hart County,"",---District Total---,245,"","",GRREC,902,04,91,75,1,3,4,0,0,0,0,0,0,2,3,5,0,0,0,3,1,4,69,84,153,166
20192020,050,HART,245,Hart County,"",---District Total---,245,"","",GRREC,902,All Students,1142,1108,22,22,44,3,1,4,0,0,0,24,44,68,0,1,1,18,20,38,1041,1054,2095,2250
20192020,050,HART,245,Hart County,"",---District Total---,245,"","",GRREC,902,PS,80,98,4,5,9,0,0,0,1,0,1,1,0,1,0,0,0,1,0,1,91,75,166,178
20192020,050,HART,245,Hart County,"",---District Total---,245,"","",GRREC,902,KG,98,101,1,1,2,1,0,1,0,0,0,4,5,9,0,0,0,3,0,3,92,92,184,199
20192020,050,HART,245,Hart County,"",---District Total---,245,"","",GRREC,902,01,91,75,1,1,2,0,0,0,0,0,0,3,5,8,0,1,1,2,0,2,69,84,153,166
20192020,050,HART,245,Hart County,"",---District Total---,245,"","",GRREC,902,02,68,75,1,0,1,0,0,0,0,0,0,1,3,4,0,0,0,0,2,2,73,63,136,143
20192020,050,HART,245,Hart County,"",---District Total---,245,"","",GRREC,902,03,74,91,1,1,2,0,0,0,0,0,0,2,1,3,0,0,0,1,0,1,87,72,159,165
20192020,050,HART,245,Hart County,"",---District Total---,245,"","",GRREC,902,05,102,81,2,4,6,0,0,0,0,0,0,4,3,7,0,0,0,0,1,1,75,94,169,183
20192020,050,HART,245,Hart County,"",---District Total---,245,"","",GRREC,902,06,92,81,5,1,6,0,0,0,0,0,0,2,6,8,0,0,0,3,1,4,71,84,155,173
20192020,050,HART,245,Hart County,"",---District Total---,245,"","",GRREC,902,07,95,90,1,0,1,1,1,2,0,0,0,0,4,4,0,0,0,2,4,6,86,86,172,185
20192020,050,HART,245,Hart County,"",---District Total---,245,"","",GRREC,902,08,86,105,2,2,4,0,0,0,0,0,0,1,5,6,0,0,0,0,4,4,102,75,177,191
20192020,050,HART,245,Hart County,"",---District Total---,245,"","",GRREC,902,09,85,99,1,3,4,1,0,1,0,0,0,1,3,4,0,0,0,3,4,7,93,75,168,184
20192020,050,HART,245,Hart County,"",---District Total---,245,"","",GRREC,902,10,105,70,0,1,1,0,0,0,0,0,0,1,4,5,0,0,0,0,1,1,69,99,168,175
20192020,050,HART,245,Hart County,"",---District Total---,245,"","",GRREC,902,11,68,79,5,2,7,0,0,0,0,0,0,2,0,2,0,0,0,0,0,0,72,66,138,147
20192020,050,HART,245,Hart County,"",---District Total---,245,"","",GRREC,902,12,87,86,1,3,4,0,0,0,0,0,0,1,2,3,0,0,0,1,2,3,83,80,163,173
20192020,050,HART,245,Hart County,010,Bonnieville Elementary School,245010,050245010,210264000562,GRREC,902,08,13,12,0,0,0,0,0,0,0,0,0,0,1,1,0,0,0,0,0,0,12,12,24,25
20192020,050,HART,245,Hart County,010,Bonnieville Elementary School,245010,050245010,210264000562,GRREC,902,All Students,126,150,2,0,2,0,1,1,0,0,0,2,5,7,0,0,0,1,0,1,145,120,265,276
20192020,050,HART,245,Hart County,010,Bonnieville Elementary School,245010,050245010,210264000562,GRREC,902,PS,12,19,0,0,0,0,0,0,0,0,0,0,0,0,0,0,0,0,0,0,19,12,31,31
20192020,050,HART,245,Hart County,010,Bonnieville Elementary School,245010,050245010,210264000562,GRREC,902,KG,20,19,0,0,0,0,0,0,0,0,0,0,2,2,0,0,0,1,0,1,18,18,36,39
20192020,050,HART,245,Hart County,010,Bonnieville Elementary School,245010,050245010,210264000562,GRREC,902,01,15,17,0,0,0,0,0,0,0,0,0,1,0,1,0,0,0,0,0,0,16,15,31,32
20192020,050,HART,245,Hart County,010,Bonnieville Elementary School,245010,050245010,210264000562,GRREC,902,02,10,19,1,0,1,0,0,0,0,0,0,0,0,0,0,0,0,0,0,0,18,10,28,29
20192020,050,HART,245,Hart County,010,Bonnieville Elementary School,245010,050245010,210264000562,GRREC,902,03,9,19,0,0,0,0,0,0,0,0,0,1,0,1,0,0,0,0,0,0,18,9,27,28
20192020,050,HART,245,Hart County,010,Bonnieville Elementary School,245010,050245010,210264000562,GRREC,902,04,12,16,0,0,0,0,0,0,0,0,0,0,0,0,0,0,0,0,0,0,16,12,28,28
20192020,050,HART,245,Hart County,010,Bonnieville Elementary School,245010,050245010,210264000562,GRREC,902,05,16,16,0,0,0,0,0,0,0,0,0,0,2,2,0,0,0,0,0,0,16,14,30,32
20192020,050,HART,245,Hart County,010,Bonnieville Elementary School,245010,050245010,210264000562,GRREC,902,06,14,13,1,0,1,0,0,0,0,0,0,0,0,0,0,0,0,0,0,0,12,14,26,27
20192020,050,HART,245,Hart County,010,Bonnieville Elementary School,245010,050245010,210264000562,GRREC,902,07,17,19,0,0,0,0,1,1,0,0,0,0,0,0,0,0,0,0,0,0,19,16,35,36
20192020,050,HART,245,Hart County,030,Cub Run Elementary School,245030,050245030,210264000563,GRREC,902,07,13,12,0,0,0,0,0,0,0,0,0,0,1,1,0,0,0,0,0,0,12,12,24,25
20192020,050,HART,245,Hart County,030,Cub Run Elementary School,245030,050245030,210264000563,GRREC,902,All Students,105,107,0,0,0,0,0,0,0,0,0,3,2,5,0,0,0,0,4,4,104,99,203,212
20192020,050,HART,245,Hart County,030,Cub Run Elementary School,245030,050245030,210264000563,GRREC,902,PS,7,7,0,0,0,0,0,0,0,0,0,0,0,0,0,0,0,0,0,0,7,7,14,14
20192020,050,HART,245,Hart County,030,Cub Run Elementary School,245030,050245030,210264000563,GRREC,902,KG,10,14,0,0,0,0,0,0,0,0,0,0,1,1,0,0,0,0,0,0,14,9,23,24
20192020,050,HART,245,Hart County,030,Cub Run Elementary School,245030,050245030,210264000563,GRREC,902,01,8,6,0,0,0,0,0,0,0,0,0,1,0,1,0,0,0,0,0,0,5,8,13,14
20192020,050,HART,245,Hart County,030,Cub Run Elementary School,245030,050245030,210264000563,GRREC,902,02,8,8,0,0,0,0,0,0,0,0,0,0,0,0,0,0,0,0,1,1,8,7,15,16
20192020,050,HART,245,Hart County,030,Cub Run Elementary School,245030,050245030,210264000563,GRREC,902,03,7,12,0,0,0,0,0,0,0,0,0,0,0,0,0,0,0,0,0,0,12,7,19,19
20192020,050,HART,245,Hart County,030,Cub Run Elementary School,245030,050245030,210264000563,GRREC,902,04,9,12,0,0,0,0,0,0,0,0,0,1,0,1,0,0,0,0,1,1,11,8,19,21
20192020,050,HART,245,Hart County,030,Cub Run Elementary School,245030,050245030,210264000563,GRREC,902,05,18,14,0,0,0,0,0,0,0,0,0,1,0,1,0,0,0,0,0,0,13,18,31,32
20192020,050,HART,245,Hart County,030,Cub Run Elementary School,245030,050245030,210264000563,GRREC,902,06,16,12,0,0,0,0,0,0,0,0,0,0,0,0,0,0,0,0,0,0,12,16,28,28
20192020,050,HART,245,Hart County,030,Cub Run Elementary School,245030,050245030,210264000563,GRREC,902,08,16,17,0,0,0,0,0,0,0,0,0,0,0,0,0,0,0,0,2,2,17,14,31,33
20192020,050,HART,245,Hart County,045,Hart County High School,245045,050245045,210264000564,GRREC,902,11,68,79,5,2,7,0,0,0,0,0,0,2,0,2,0,0,0,0,0,0,72,66,138,147
20192020,050,HART,245,Hart County,045,Hart County High School,245045,050245045,210264000564,GRREC,902,All Students,345,334,7,9,16,1,0,1,0,0,0,5,9,14,0,0,0,4,7,11,317,320,637,679
20192020,050,HART,245,Hart County,045,Hart County High School,245045,050245045,210264000564,GRREC,902,09,85,99,1,3,4,1,0,1,0,0,0,1,3,4,0,0,0,3,4,7,93,75,168,184
20192020,050,HART,245,Hart County,045,Hart County High School,245045,050245045,210264000564,GRREC,902,10,105,70,0,1,1,0,0,0,0,0,0,1,4,5,0,0,0,0,1,1,69,99,168,175
20192020,050,HART,245,Hart County,045,Hart County High School,245045,050245045,210264000564,GRREC,902,12,87,86,1,3,4,0,0,0,0,0,0,1,2,3,0,0,0,1,2,3,83,80,163,173
20192020,050,HART,245,Hart County,050,Legrande Elementary School,245050,050245050,210264000565,GRREC,902,07,16,10,0,0,0,0,0,0,0,0,0,0,0,0,0,0,0,0,1,1,10,15,25,26
20192020,050,HART,245,Hart County,050,Legrande Elementary School,245050,050245050,210264000565,GRREC,902,All Students,165,142,3,1,4,0,0,0,0,0,0,2,4,6,0,0,0,2,3,5,135,157,292,307
20192020,050,HART,245,Hart County,050,Legrande Elementary School,245050,050245050,210264000565,GRREC,902,PS,19,22,2,2,4,0,0,0,0,0,0,0,0,0,0,0,0,0,0,0,20,17,37,41
20192020,050,HART,245,Hart County,050,Legrande Elementary School,245050,050245050,210264000565,GRREC,902,KG,23,23,0,0,0,0,0,0,0,0,0,1,0,1,0,0,0,0,0,0,22,23,45,46
20192020,050,HART,245,Hart County,050,Legrande Elementary School,245050,050245050,210264000565,GRREC,902,01,25,18,1,0,1,0,0,0,0,0,0,1,2,3,0,0,0,1,0,1,15,23,38,43
20192020,050,HART,245,Hart County,050,Legrande Elementary School,245050,050245050,210264000565,GRREC,902,02,13,13,0,0,0,0,0,0,0,0,0,0,0,0,0,0,0,0,1,1,13,12,25,26
20192020,050,HART,245,Hart County,050,Legrande Elementary School,245050,050245050,210264000565,GRREC,902,03,17,14,0,0,0,0,0,0,0,0,0,0,0,0,0,0,0,0,0,0,14,17,31,31
20192020,050,HART,245,Hart County,050,Legrande Elementary School,245050,050245050,210264000565,GRREC,902,04,16,13,0,0,0,0,0,0,0,0,0,0,0,0,0,0,0,1,0,1,12,16,28,29
20192020,050,HART,245,Hart County,050,Legrande Elementary School,245050,050245050,210264000565,GRREC,902,05,19,10,1,0,1,0,0,0,0,0,0,0,0,0,0,0,0,0,1,1,9,18,27,29
20192020,050,HART,245,Hart County,050,Legrande Elementary School,245050,050245050,210264000565,GRREC,902,06,23,15,1,1,2,0,0,0,0,0,0,0,2,2,0,0,0,0,0,0,14,20,34,38
20192020,050,HART,245,Hart County,050,Legrande Elementary School,245050,050245050,210264000565,GRREC,902,08,13,26,0,0,0,0,0,0,0,0,0,0,0,0,0,0,0,0,0,0,26,13,39,39
20192020,050,HART,245,Hart County,070,Memorial Elementary School,245070,050245070,210264000566,GRREC,902,PS,17,19,0,0,0,0,0,0,0,0,0,0,0,0,0,0,0,1,0,1,18,17,35,36
20192020,050,HART,245,Hart County,070,Memorial Elementary School,245070,050245070,210264000566,GRREC,902,All Students,168,150,1,1,2,0,0,0,0,0,0,1,9,10,0,1,1,3,1,4,145,156,301,318
20192020,050,HART,245,Hart County,070,Memorial Elementary School,245070,050245070,210264000566,GRREC,902,KG,21,16,1,0,1,0,0,0,0,0,0,0,1,1,0,0,0,0,0,0,15,20,35,37
20192020,050,HART,245,Hart County,070,Memorial Elementary School,245070,050245070,210264000566,GRREC,902,01,18,16,0,0,0,0,0,0,0,0,0,0,0,0,0,1,1,0,0,0,16,17,33,34
20192020,050,HART,245,Hart County,070,Memorial Elementary School,245070,050245070,210264000566,GRREC,902,02,11,18,0,0,0,0,0,0,0,0,0,0,0,0,0,0,0,0,0,0,18,11,29,29
20192020,050,HART,245,Hart County,070,Memorial Elementary School,245070,050245070,210264000566,GRREC,902,03,19,22,0,0,0,0,0,0,0,0,0,0,0,0,0,0,0,1,0,1,21,19,40,41
20192020,050,HART,245,Hart County,070,Memorial Elementary School,245070,050245070,210264000566,GRREC,902,04,23,16,0,1,1,0,0,0,0,0,0,1,0,1,0,0,0,1,0,1,14,22,36,39
20192020,050,HART,245,Hart County,070,Memorial Elementary School,245070,050245070,210264000566,GRREC,902,05,18,17,0,0,0,0,0,0,0,0,0,0,1,1,0,0,0,0,0,0,17,17,34,35
20192020,050,HART,245,Hart County,070,Memorial Elementary School,245070,050245070,210264000566,GRREC,902,06,19,7,0,0,0,0,0,0,0,0,0,0,3,3,0,0,0,1,0,1,6,16,22,26
20192020,050,HART,245,Hart County,070,Memorial Elementary School,245070,050245070,210264000566,GRREC,902,07,23,19,0,0,0,0,0,0,0,0,0,0,2,2,0,0,0,0,1,1,19,20,39,42
20192020,050,HART,245,Hart County,070,Memorial Elementary School,245070,050245070,210264000566,GRREC,902,08,16,19,0,0,0,0,0,0,0,0,0,0,2,2,0,0,0,0,0,0,19,14,33,35
20192020,050,HART,245,Hart County,090,Munfordville Elementary School,245090,050245090,210264000567,GRREC,902,02,26,17,0,0,0,0,0,0,0,0,0,1,3,4,0,0,0,0,0,0,16,23,39,43
20192020,050,HART,245,Hart County,090,Munfordville Elementary School,245090,050245090,210264000567,GRREC,902,03,22,24,1,1,2,0,0,0,0,0,0,1,1,2,0,0,0,0,0,0,22,20,42,46
20192020,050,HART,245,Hart County,090,Munfordville Elementary School,245090,050245090,210264000567,GRREC,902,04,31,18,1,2,3,0,0,0,0,0,0,0,3,3,0,0,0,1,0,1,16,26,42,49
20192020,050,HART,245,Hart County,090,Munfordville Elementary School,245090,050245090,210264000567,GRREC,902,05,31,24,1,4,5,0,0,0,0,0,0,3,0,3,0,0,0,0,0,0,20,27,47,55
20192020,050,HART,245,Hart County,090,Munfordville Elementary School,245090,050245090,210264000567,GRREC,902,06,20,34,3,0,3,0,0,0,0,0,0,2,1,3,0,0,0,2,1,3,27,18,45,54
20192020,050,HART,245,Hart County,090,Munfordville Elementary School,245090,050245090,210264000567,GRREC,902,07,26,30,1,0,1,1,0,1,0,0,0,0,1,1,0,0,0,2,2,4,26,23,49,56
20192020,050,HART,245,Hart County,090,Munfordville Elementary School,245090,050245090,210264000567,GRREC,902,08,28,31,2,2,4,0,0,0,0,0,0,1,2,3,0,0,0,0,2,2,28,22,50,59
20192020,050,HART,245,Hart County,090,Munfordville Elementary School,245090,050245090,210264000567,GRREC,902,PS,25,31,2,3,5,0,0,0,1,0,1,1,0,1,0,0,0,0,0,0,27,22,49,56
20192020,050,HART,245,Hart County,090,Munfordville Elementary School,245090,050245090,210264000567,GRREC,902,KG,24,29,0,1,1,1,0,1,0,0,0,3,1,4,0,0,0,2,0,2,23,22,45,53
20192020,050,HART,245,Hart County,090,Munfordville Elementary School,245090,050245090,210264000567,GRREC,902,All Students,233,225,9,11,20,2,0,2,0,0,0,11,15,26,0,0,0,8,5,13,195,202,397,458
20192020,050,HART,245,Hart County,090,Munfordville Elementary School,245090,050245090,210264000567,GRREC,902,01,25,18,0,1,1,0,0,0,0,0,0,0,3,3,0,0,0,1,0,1,17,21,38,43
20192020,097,PERRY,246,Hazard Independent,"",---District Total---,246,"","",KVEC,904,05,24,38,1,2,3,0,0,0,0,0,0,0,0,0,0,0,0,0,0,0,37,22,59,62
20192020,097,PERRY,246,Hazard Independent,"",---District Total---,246,"","",KVEC,904,06,46,39,2,3,5,0,1,1,0,1,1,0,0,0,0,0,0,1,2,3,36,39,75,85
20192020,097,PERRY,246,Hazard Independent,"",---District Total---,246,"","",KVEC,904,07,26,36,2,1,3,0,0,0,0,0,0,0,0,0,0,0,0,5,2,7,29,23,52,62
20192020,097,PERRY,246,Hazard Independent,"",---District Total---,246,"","",KVEC,904,09,28,36,1,2,3,0,0,0,1,0,1,0,1,1,0,1,1,2,1,3,32,23,55,64
20192020,097,PERRY,246,Hazard Independent,"",---District Total---,246,"","",KVEC,904,08,28,28,1,3,4,1,1,2,0,1,1,1,2,3,0,0,0,2,0,2,23,21,44,56
20192020,097,PERRY,246,Hazard Independent,"",---District Total---,246,"","",KVEC,904,10,32,35,2,1,3,0,0,0,0,0,0,0,0,0,0,0,0,2,2,4,31,29,60,67
20192020,097,PERRY,246,Hazard Independent,"",---District Total---,246,"","",KVEC,904,11,42,39,3,2,5,0,0,0,1,1,2,0,1,1,0,0,0,0,3,3,35,35,70,81
20192020,097,PERRY,246,Hazard Independent,"",---District Total---,246,"","",KVEC,904,12,45,48,4,1,5,0,0,0,4,1,5,0,0,0,0,0,0,1,5,6,39,38,77,93
20192020,097,PERRY,246,Hazard Independent,"",---District Total---,246,"","",KVEC,904,All Students,448,477,25,22,47,1,2,3,6,9,15,3,8,11,0,1,1,26,22,48,416,384,800,925
20192020,097,PERRY,246,Hazard Independent,"",---District Total---,246,"","",KVEC,904,PS,24,26,3,2,5,0,0,0,0,0,0,0,1,1,0,0,0,0,0,0,23,21,44,50
20192020,097,PERRY,246,Hazard Independent,"",---District Total---,246,"","",KVEC,904,KG,30,32,2,1,3,0,0,0,0,0,0,1,0,1,0,0,0,1,1,2,28,28,56,62
20192020,097,PERRY,246,Hazard Independent,"",---District Total---,246,"","",KVEC,904,01,44,40,0,2,2,0,0,0,0,2,2,0,0,0,0,0,0,2,3,5,38,37,75,84
20192020,097,PERRY,246,Hazard Independent,"",---District Total---,246,"","",KVEC,904,02,36,32,2,1,3,0,0,0,0,0,0,1,2,3,0,0,0,1,0,1,28,33,61,68
20192020,097,PERRY,246,Hazard Independent,"",---District Total---,246,"","",KVEC,904,03,30,36,1,2,3,0,0,0,0,1,1,0,0,0,0,0,0,6,3,9,29,24,53,66
20192020,097,PERRY,246,Hazard Independent,"",---District Total---,246,"","",KVEC,904,04,37,38,4,1,5,0,0,0,0,2,2,0,2,2,0,0,0,3,0,3,31,32,63,75
20192020,097,PERRY,246,Hazard Independent,010,Hazard High School,246010,097246010,210267000568,KVEC,904,All Students,147,158,10,6,16,0,0,0,6,2,8,0,2,2,0,1,1,5,11,16,137,125,262,305
20192020,097,PERRY,246,Hazard Independent,010,Hazard High School,246010,097246010,210267000568,KVEC,904,12,45,48,4,1,5,0,0,0,4,1,5,0,0,0,0,0,0,1,5,6,39,38,77,93
20192020,097,PERRY,246,Hazard Independent,010,Hazard High School,246010,097246010,210267000568,KVEC,904,10,32,35,2,1,3,0,0,0,0,0,0,0,0,0,0,0,0,2,2,4,31,29,60,67
20192020,097,PERRY,246,Hazard Independent,010,Hazard High School,246010,097246010,210267000568,KVEC,904,11,42,39,3,2,5,0,0,0,1,1,2,0,1,1,0,0,0,0,3,3,35,35,70,81
20192020,097,PERRY,246,Hazard Independent,010,Hazard High School,246010,097246010,210267000568,KVEC,904,09,28,36,1,2,3,0,0,0,1,0,1,0,1,1,0,1,1,2,1,3,32,23,55,64
20192020,097,PERRY,246,Hazard Independent,045,Hazard Middle School,246045,097246045,210267000569,KVEC,904,06,46,39,2,3,5,0,1,1,0,1,1,0,0,0,0,0,0,1,2,3,36,39,75,85
20192020,097,PERRY,246,Hazard Independent,045,Hazard Middle School,246045,097246045,210267000569,KVEC,904,All Students,124,141,6,9,15,1,2,3,0,2,2,1,2,3,0,0,0,8,4,12,125,105,230,265
20192020,097,PERRY,246,Hazard Independent,045,Hazard Middle School,246045,097246045,210267000569,KVEC,904,05,24,38,1,2,3,0,0,0,0,0,0,0,0,0,0,0,0,0,0,0,37,22,59,62
20192020,097,PERRY,246,Hazard Independent,045,Hazard Middle School,246045,097246045,210267000569,KVEC,904,07,26,36,2,1,3,0,0,0,0,0,0,0,0,0,0,0,0,5,2,7,29,23,52,62
20192020,097,PERRY,246,Hazard Independent,045,Hazard Middle School,246045,097246045,210267000569,KVEC,904,08,28,28,1,3,4,1,1,2,0,1,1,1,2,3,0,0,0,2,0,2,23,21,44,56
20192020,097,PERRY,246,Hazard Independent,060,Roy G. Eversole Elementary School,246060,097246060,210267000570,KVEC,904,All Students,177,178,9,7,16,0,0,0,0,5,5,2,4,6,0,0,0,13,7,20,154,154,308,355
20192020,097,PERRY,246,Hazard Independent,060,Roy G. Eversole Elementary School,246060,097246060,210267000570,KVEC,904,PS,24,26,3,2,5,0,0,0,0,0,0,0,1,1,0,0,0,0,0,0,23,21,44,50
20192020,097,PERRY,246,Hazard Independent,060,Roy G. Eversole Elementary School,246060,097246060,210267000570,KVEC,904,KG,30,32,2,1,3,0,0,0,0,0,0,1,0,1,0,0,0,1,1,2,28,28,56,62
20192020,097,PERRY,246,Hazard Independent,060,Roy G. Eversole Elementary School,246060,097246060,210267000570,KVEC,904,01,44,40,0,2,2,0,0,0,0,2,2,0,0,0,0,0,0,2,3,5,38,37,75,84
20192020,097,PERRY,246,Hazard Independent,060,Roy G. Eversole Elementary School,246060,097246060,210267000570,KVEC,904,02,36,32,2,1,3,0,0,0,0,0,0,1,2,3,0,0,0,1,0,1,28,33,61,68
20192020,097,PERRY,246,Hazard Independent,060,Roy G. Eversole Elementary School,246060,097246060,210267000570,KVEC,904,03,30,36,1,2,3,0,0,0,0,1,1,0,0,0,0,0,0,6,3,9,29,24,53,66
20192020,097,PERRY,246,Hazard Independent,060,Roy G. Eversole Elementary School,246060,097246060,210267000570,KVEC,904,04,37,38,4,1,5,0,0,0,0,2,2,0,2,2,0,0,0,3,0,3,31,32,63,75
20192020,051,HENDERSON,251,Henderson County,"",---District Total---,251,"","",WKEC,908,03,236,252,19,18,37,0,0,0,3,1,4,23,10,33,1,0,1,24,29,53,182,178,360,488
20192020,051,HENDERSON,251,Henderson County,"",---District Total---,251,"","",WKEC,908,04,242,254,25,23,48,0,0,0,0,2,2,14,16,30,2,2,4,32,19,51,181,180,361,496
20192020,051,HENDERSON,251,Henderson County,"",---District Total---,251,"","",WKEC,908,05,294,274,30,13,43,0,0,0,1,3,4,13,14,27,0,1,1,31,21,52,199,242,441,568
20192020,051,HENDERSON,251,Henderson County,"",---District Total---,251,"","",WKEC,908,06,275,272,29,26,55,0,0,0,1,0,1,17,14,31,2,1,3,24,23,47,199,211,410,547
20192020,051,HENDERSON,251,Henderson County,"",---District Total---,251,"","",WKEC,908,07,277,296,31,19,50,0,0,0,1,1,2,16,18,34,6,0,6,27,19,46,215,220,435,573
20192020,051,HENDERSON,251,Henderson County,"",---District Total---,251,"","",WKEC,908,08,271,236,17,26,43,0,2,2,0,0,0,9,14,23,0,1,1,13,19,32,197,209,406,507
20192020,051,HENDERSON,251,Henderson County,"",---District Total---,251,"","",WKEC,908,09,265,287,24,23,47,1,0,1,2,1,3,17,14,31,1,1,2,25,17,42,217,209,426,552
20192020,051,HENDERSON,251,Henderson County,"",---District Total---,251,"","",WKEC,908,10,300,269,20,30,50,0,0,0,0,2,2,14,11,25,3,2,5,19,23,42,213,232,445,569
20192020,051,HENDERSON,251,Henderson County,"",---District Total---,251,"","",WKEC,908,12,295,238,19,30,49,0,0,0,1,1,2,12,9,21,0,2,2,14,12,26,192,241,433,533
20192020,051,HENDERSON,251,Henderson County,"",---District Total---,251,"","",WKEC,908,11,245,251,24,21,45,0,0,0,1,2,3,11,12,23,1,0,1,13,16,29,201,194,395,496
20192020,051,HENDERSON,251,Henderson County,"",---District Total---,251,"","",WKEC,908,14,0,8,1,0,1,0,0,0,0,0,0,0,0,0,0,0,0,0,0,0,7,0,7,8
20192020,051,HENDERSON,251,Henderson County,"",---District Total---,251,"","",WKEC,908,All Students,3410,3447,304,292,596,2,2,4,14,18,32,188,172,360,18,14,32,309,259,568,2612,2653,5265,6857
20192020,051,HENDERSON,251,Henderson County,"",---District Total---,251,"","",WKEC,908,PS,203,208,25,22,47,0,0,0,1,0,1,11,15,26,0,0,0,30,24,54,141,142,283,411
20192020,051,HENDERSON,251,Henderson County,"",---District Total---,251,"","",WKEC,908,KG,241,266,25,30,55,0,0,0,1,3,4,13,10,23,1,0,1,29,18,47,197,180,377,507
20192020,051,HENDERSON,251,Henderson County,"",---District Total---,251,"","",WKEC,908,01,262,303,24,23,47,1,0,1,2,2,4,16,16,32,0,4,4,39,22,61,221,195,416,565
20192020,051,HENDERSON,251,Henderson County,"",---District Total---,251,"","",WKEC,908,02,207,241,16,10,26,0,0,0,1,0,1,13,14,27,1,0,1,19,21,40,191,162,353,448
20192020,051,HENDERSON,251,Henderson County,010,Bend Gate Elementary School,251010,051251010,210271000571,WKEC,908,03,36,32,3,2,5,0,0,0,1,1,2,3,2,5,0,0,0,4,3,7,21,28,49,68
20192020,051,HENDERSON,251,Henderson County,010,Bend Gate Elementary School,251010,051251010,210271000571,WKEC,908,05,34,41,4,2,6,0,0,0,0,2,2,6,1,7,0,0,0,10,3,13,21,26,47,75
20192020,051,HENDERSON,251,Henderson County,010,Bend Gate Elementary School,251010,051251010,210271000571,WKEC,908,All Students,207,221,30,22,52,0,0,0,2,5,7,16,11,27,0,0,0,43,21,64,130,148,278,428
20192020,051,HENDERSON,251,Henderson County,010,Bend Gate Elementary School,251010,051251010,210271000571,WKEC,908,KG,32,29,5,5,10,0,0,0,1,1,2,1,2,3,0,0,0,4,5,9,18,19,37,61
20192020,051,HENDERSON,251,Henderson County,010,Bend Gate Elementary School,251010,051251010,210271000571,WKEC,908,01,39,47,7,6,13,0,0,0,0,0,0,2,2,4,0,0,0,9,4,13,29,27,56,86
20192020,051,HENDERSON,251,Henderson County,010,Bend Gate Elementary School,251010,051251010,210271000571,WKEC,908,02,28,33,3,2,5,0,0,0,0,0,0,3,2,5,0,0,0,7,4,11,20,20,40,61
20192020,051,HENDERSON,251,Henderson County,010,Bend Gate Elementary School,251010,051251010,210271000571,WKEC,908,04,38,39,8,5,13,0,0,0,0,1,1,1,2,3,0,0,0,9,2,11,21,28,49,77
20192020,051,HENDERSON,251,Henderson County,015,The Central Academy,251015,051251015,210271002457,WKEC,908,10,19,25,6,3,9,0,0,0,0,0,0,1,0,1,0,0,0,3,4,7,15,12,27,44
20192020,051,HENDERSON,251,Henderson County,015,The Central Academy,251015,051251015,210271002457,WKEC,908,All Students,92,127,16,19,35,0,0,0,0,0,0,2,2,4,0,0,0,18,10,28,91,61,152,219
20192020,051,HENDERSON,251,Henderson County,015,The Central Academy,251015,051251015,210271002457,WKEC,908,02,0,1,0,0,0,0,0,0,0,0,0,0,0,0,0,0,0,0,0,0,1,0,1,1
20192020,051,HENDERSON,251,Henderson County,015,The Central Academy,251015,051251015,210271002457,WKEC,908,03,0,2,0,0,0,0,0,0,0,0,0,0,0,0,0,0,0,1,0,1,1,0,1,2
20192020,051,HENDERSON,251,Henderson County,015,The Central Academy,251015,051251015,210271002457,WKEC,908,04,0,1,0,0,0,0,0,0,0,0,0,0,0,0,0,0,0,0,0,0,1,0,1,1
20192020,051,HENDERSON,251,Henderson County,015,The Central Academy,251015,051251015,210271002457,WKEC,908,05,0,1,0,0,0,0,0,0,0,0,0,0,0,0,0,0,0,0,0,0,1,0,1,1
20192020,051,HENDERSON,251,Henderson County,015,The Central Academy,251015,051251015,210271002457,WKEC,908,06,3,7,1,0,1,0,0,0,0,0,0,0,0,0,0,0,0,1,1,2,5,2,7,10
20192020,051,HENDERSON,251,Henderson County,015,The Central Academy,251015,051251015,210271002457,WKEC,908,07,1,6,0,1,1,0,0,0,0,0,0,0,0,0,0,0,0,0,0,0,6,0,6,7
20192020,051,HENDERSON,251,Henderson County,015,The Central Academy,251015,051251015,210271002457,WKEC,908,08,3,8,2,2,4,0,0,0,0,0,0,0,0,0,0,0,0,3,0,3,3,1,4,11
20192020,051,HENDERSON,251,Henderson County,015,The Central Academy,251015,051251015,210271002457,WKEC,908,09,9,14,2,1,3,0,0,0,0,0,0,1,0,1,0,0,0,1,2,3,10,6,16,23
20192020,051,HENDERSON,251,Henderson County,015,The Central Academy,251015,051251015,210271002457,WKEC,908,11,15,27,3,4,7,0,0,0,0,0,0,0,0,0,0,0,0,3,0,3,21,11,32,42
20192020,051,HENDERSON,251,Henderson County,015,The Central Academy,251015,051251015,210271002457,WKEC,908,12,42,35,2,8,10,0,0,0,0,0,0,0,2,2,0,0,0,6,3,9,27,29,56,77
20192020,051,HENDERSON,251,Henderson County,020,Cairo Elementary School,251020,051251020,210271000572,WKEC,908,04,28,20,1,1,2,0,0,0,0,1,1,1,0,1,0,0,0,5,2,7,13,24,37,48
20192020,051,HENDERSON,251,Henderson County,020,Cairo Elementary School,251020,051251020,210271000572,WKEC,908,05,29,21,1,1,2,0,0,0,0,0,0,0,2,2,0,0,0,1,3,4,19,23,42,50
20192020,051,HENDERSON,251,Henderson County,020,Cairo Elementary School,251020,051251020,210271000572,WKEC,908,All Students,148,136,3,5,8,0,0,0,1,1,2,4,4,8,0,0,0,16,12,28,112,126,238,284
20192020,051,HENDERSON,251,Henderson County,020,Cairo Elementary School,251020,051251020,210271000572,WKEC,908,KG,23,24,0,1,1,0,0,0,0,0,0,1,0,1,0,0,0,4,0,4,19,22,41,47
20192020,051,HENDERSON,251,Henderson County,020,Cairo Elementary School,251020,051251020,210271000572,WKEC,908,01,29,25,1,2,3,0,0,0,0,0,0,0,1,1,0,0,0,3,0,3,21,26,47,54
20192020,051,HENDERSON,251,Henderson County,020,Cairo Elementary School,251020,051251020,210271000572,WKEC,908,02,19,23,0,0,0,0,0,0,1,0,1,0,1,1,0,0,0,1,4,5,21,14,35,42
20192020,051,HENDERSON,251,Henderson County,020,Cairo Elementary School,251020,051251020,210271000572,WKEC,908,03,20,23,0,0,0,0,0,0,0,0,0,2,0,2,0,0,0,2,3,5,19,17,36,43
20192020,051,HENDERSON,251,Henderson County,030,A B Chandler Elementary School,251030,051251030,210271000573,WKEC,908,03,19,27,1,1,2,0,0,0,1,0,1,1,1,2,0,0,0,1,1,2,23,16,39,46
20192020,051,HENDERSON,251,Henderson County,030,A B Chandler Elementary School,251030,051251030,210271000573,WKEC,908,05,24,34,5,0,5,0,0,0,0,1,1,1,3,4,0,0,0,2,2,4,26,18,44,58
20192020,051,HENDERSON,251,Henderson County,030,A B Chandler Elementary School,251030,051251030,210271000573,WKEC,908,All Students,127,168,9,5,14,0,0,0,1,1,2,6,7,13,0,0,0,10,7,17,142,107,249,295
20192020,051,HENDERSON,251,Henderson County,030,A B Chandler Elementary School,251030,051251030,210271000573,WKEC,908,KG,18,27,1,1,2,0,0,0,0,0,0,1,1,2,0,0,0,2,1,3,23,15,38,45
20192020,051,HENDERSON,251,Henderson County,030,A B Chandler Elementary School,251030,051251030,210271000573,WKEC,908,01,24,30,1,1,2,0,0,0,0,0,0,1,1,2,0,0,0,2,0,2,26,22,48,54
20192020,051,HENDERSON,251,Henderson County,030,A B Chandler Elementary School,251030,051251030,210271000573,WKEC,908,02,19,24,1,1,2,0,0,0,0,0,0,0,0,0,0,0,0,3,1,4,20,17,37,43
20192020,051,HENDERSON,251,Henderson County,030,A B Chandler Elementary School,251030,051251030,210271000573,WKEC,908,04,23,26,0,1,1,0,0,0,0,0,0,2,1,3,0,0,0,0,2,2,24,19,43,49
20192020,051,HENDERSON,251,Henderson County,033,East Heights Elementary School,251033,051251033,210271000574,WKEC,908,03,35,33,3,1,4,0,0,0,0,0,0,4,1,5,0,0,0,5,7,12,21,26,47,68
20192020,051,HENDERSON,251,Henderson County,033,East Heights Elementary School,251033,051251033,210271000574,WKEC,908,05,49,38,4,3,7,0,0,0,1,0,1,1,0,1,0,0,0,4,3,7,28,43,71,87
20192020,051,HENDERSON,251,Henderson County,033,East Heights Elementary School,251033,051251033,210271000574,WKEC,908,All Students,216,223,25,18,43,0,0,0,3,2,5,14,10,24,2,2,4,23,27,50,156,157,313,439
20192020,051,HENDERSON,251,Henderson County,033,East Heights Elementary School,251033,051251033,210271000574,WKEC,908,KG,37,39,8,4,12,0,0,0,0,2,2,3,1,4,1,0,1,2,4,6,25,26,51,76
20192020,051,HENDERSON,251,Henderson County,033,East Heights Elementary School,251033,051251033,210271000574,WKEC,908,01,33,34,2,3,5,0,0,0,2,0,2,1,1,2,0,1,1,6,7,13,23,21,44,67
20192020,051,HENDERSON,251,Henderson County,033,East Heights Elementary School,251033,051251033,210271000574,WKEC,908,02,37,36,2,3,5,0,0,0,0,0,0,3,5,8,1,0,1,0,3,3,30,26,56,73
20192020,051,HENDERSON,251,Henderson County,033,East Heights Elementary School,251033,051251033,210271000574,WKEC,908,04,25,43,6,4,10,0,0,0,0,0,0,2,2,4,0,1,1,6,3,9,29,15,44,68
20192020,051,HENDERSON,251,Henderson County,060,Henderson County High School,251060,051251060,210271000577,WKEC,908,11,230,224,21,17,38,0,0,0,1,2,3,11,12,23,1,0,1,10,16,26,180,183,363,454
20192020,051,HENDERSON,251,Henderson County,060,Henderson County High School,251060,051251060,210271000577,WKEC,908,14,0,8,1,0,1,0,0,0,0,0,0,0,0,0,0,0,0,0,0,0,7,0,7,8
20192020,051,HENDERSON,251,Henderson County,060,Henderson County High School,251060,051251060,210271000577,WKEC,908,All Students,1020,952,75,88,163,1,0,1,4,6,10,52,44,96,5,5,10,58,59,117,757,818,1575,1972
20192020,051,HENDERSON,251,Henderson County,060,Henderson County High School,251060,051251060,210271000577,WKEC,908,09,256,273,22,22,44,1,0,1,2,1,3,16,14,30,1,1,2,24,15,39,207,203,410,529
20192020,051,HENDERSON,251,Henderson County,060,Henderson County High School,251060,051251060,210271000577,WKEC,908,10,281,244,14,27,41,0,0,0,0,2,2,13,11,24,3,2,5,16,19,35,198,220,418,525
20192020,051,HENDERSON,251,Henderson County,060,Henderson County High School,251060,051251060,210271000577,WKEC,908,12,253,203,17,22,39,0,0,0,1,1,2,12,7,19,0,2,2,8,9,17,165,212,377,456
20192020,051,HENDERSON,251,Henderson County,065,Henderson County North Middle School,251065,051251065,210271000578,WKEC,908,All Students,451,393,30,38,68,0,1,1,0,0,0,19,16,35,6,0,6,28,30,58,310,366,676,844
20192020,051,HENDERSON,251,Henderson County,065,Henderson County North Middle School,251065,051251065,210271000578,WKEC,908,07,148,146,14,8,22,0,0,0,0,0,0,8,5,13,4,0,4,17,8,25,103,127,230,294
20192020,051,HENDERSON,251,Henderson County,065,Henderson County North Middle School,251065,051251065,210271000578,WKEC,908,08,148,107,7,13,20,0,1,1,0,0,0,7,6,13,0,0,0,3,10,13,90,118,208,255
20192020,051,HENDERSON,251,Henderson County,065,Henderson County North Middle School,251065,051251065,210271000578,WKEC,908,06,155,140,9,17,26,0,0,0,0,0,0,4,5,9,2,0,2,8,12,20,117,121,238,295
20192020,051,HENDERSON,251,Henderson County,070,Niagara Elementary School,251070,051251070,210271000579,WKEC,908,04,23,17,0,0,0,0,0,0,0,0,0,1,0,1,1,0,1,1,1,2,14,22,36,40
20192020,051,HENDERSON,251,Henderson County,070,Niagara Elementary School,251070,051251070,210271000579,WKEC,908,05,37,19,0,0,0,0,0,0,0,0,0,0,0,0,0,0,0,1,1,2,18,36,54,56
20192020,051,HENDERSON,251,Henderson County,070,Niagara Elementary School,251070,051251070,210271000579,WKEC,908,02,21,20,0,0,0,0,0,0,0,0,0,0,0,0,0,0,0,0,0,0,20,21,41,41
20192020,051,HENDERSON,251,Henderson County,070,Niagara Elementary School,251070,051251070,210271000579,WKEC,908,03,26,28,0,1,1,0,0,0,0,0,0,1,0,1,0,0,0,2,2,4,25,23,48,54
20192020,051,HENDERSON,251,Henderson County,070,Niagara Elementary School,251070,051251070,210271000579,WKEC,908,All Students,153,125,0,2,2,0,0,0,0,0,0,2,0,2,1,0,1,7,4,11,115,147,262,278
20192020,051,HENDERSON,251,Henderson County,070,Niagara Elementary School,251070,051251070,210271000579,WKEC,908,KG,23,18,0,1,1,0,0,0,0,0,0,0,0,0,0,0,0,1,0,1,17,22,39,41
20192020,051,HENDERSON,251,Henderson County,070,Niagara Elementary School,251070,051251070,210271000579,WKEC,908,01,23,23,0,0,0,0,0,0,0,0,0,0,0,0,0,0,0,2,0,2,21,23,44,46
20192020,051,HENDERSON,251,Henderson County,080,Thelma B. Johnson Early Learning Center,251080,051251080,210271002306,WKEC,908,PS,203,208,25,22,47,0,0,0,1,0,1,11,15,26,0,0,0,30,24,54,141,142,283,411
20192020,051,HENDERSON,251,Henderson County,080,Thelma B. Johnson Early Learning Center,251080,051251080,210271002306,WKEC,908,All Students,0,0,0,0,0,0,0,0,0,0,0,0,0,0,0,0,0,0,0,0,0,0,0,0
20192020,051,HENDERSON,251,Henderson County,091,South Heights Elementary School,251091,051251091,210271000581,WKEC,908,05,25,46,10,3,13,0,0,0,0,0,0,4,3,7,0,1,1,8,3,11,24,15,39,71
20192020,051,HENDERSON,251,Henderson County,091,South Heights Elementary School,251091,051251091,210271000581,WKEC,908,All Students,190,235,40,32,72,0,0,0,0,0,0,25,21,46,1,2,3,33,27,60,136,108,244,425
20192020,051,HENDERSON,251,Henderson County,091,South Heights Elementary School,251091,051251091,210271000581,WKEC,908,KG,36,33,5,7,12,0,0,0,0,0,0,2,2,4,0,0,0,4,4,8,22,23,45,69
20192020,051,HENDERSON,251,Henderson County,091,South Heights Elementary School,251091,051251091,210271000581,WKEC,908,01,34,50,6,4,10,0,0,0,0,0,0,5,7,12,0,1,1,10,4,14,29,18,47,84
20192020,051,HENDERSON,251,Henderson County,091,South Heights Elementary School,251091,051251091,210271000581,WKEC,908,02,28,35,6,3,9,0,0,0,0,0,0,3,1,4,0,0,0,5,4,9,21,20,41,63
20192020,051,HENDERSON,251,Henderson County,091,South Heights Elementary School,251091,051251091,210271000581,WKEC,908,03,34,42,5,8,13,0,0,0,0,0,0,8,3,11,1,0,1,3,6,9,25,17,42,76
20192020,051,HENDERSON,251,Henderson County,091,South Heights Elementary School,251091,051251091,210271000581,WKEC,908,04,33,29,8,7,15,0,0,0,0,0,0,3,5,8,0,0,0,3,6,9,15,15,30,62
20192020,051,HENDERSON,251,Henderson County,110,Spottsville Elementary School,251110,051251110,210271000583,WKEC,908,04,42,47,1,1,2,0,0,0,0,0,0,1,0,1,0,1,1,1,0,1,44,40,84,89
20192020,051,HENDERSON,251,Henderson County,110,Spottsville Elementary School,251110,051251110,210271000583,WKEC,908,05,62,56,3,0,3,0,0,0,0,0,0,0,2,2,0,0,0,3,4,7,50,56,106,118
20192020,051,HENDERSON,251,Henderson County,110,Spottsville Elementary School,251110,051251110,210271000583,WKEC,908,All Students,282,301,14,12,26,1,0,1,0,0,0,7,9,16,0,1,1,9,12,21,270,248,518,583
20192020,051,HENDERSON,251,Henderson County,110,Spottsville Elementary School,251110,051251110,210271000583,WKEC,908,KG,42,54,3,2,5,0,0,0,0,0,0,2,1,3,0,0,0,2,2,4,47,37,84,96
20192020,051,HENDERSON,251,Henderson County,110,Spottsville Elementary School,251110,051251110,210271000583,WKEC,908,01,55,61,4,6,10,1,0,1,0,0,0,2,3,5,0,0,0,3,2,5,51,44,95,116
20192020,051,HENDERSON,251,Henderson County,110,Spottsville Elementary School,251110,051251110,210271000583,WKEC,908,02,38,47,1,1,2,0,0,0,0,0,0,2,2,4,0,0,0,0,2,2,44,33,77,85
20192020,051,HENDERSON,251,Henderson County,110,Spottsville Elementary School,251110,051251110,210271000583,WKEC,908,03,43,36,2,2,4,0,0,0,0,0,0,0,1,1,0,0,0,0,2,2,34,38,72,79
20192020,051,HENDERSON,251,Henderson County,150,Henderson County South Middle School,251150,051251150,210271000585,WKEC,908,06,117,125,19,9,28,0,0,0,1,0,1,13,9,22,0,1,1,15,10,25,77,88,165,242
20192020,051,HENDERSON,251,Henderson County,150,Henderson County South Middle School,251150,051251150,210271000585,WKEC,908,08,120,121,8,11,19,0,1,1,0,0,0,2,8,10,0,1,1,7,9,16,104,90,194,241
20192020,051,HENDERSON,251,Henderson County,150,Henderson County South Middle School,251150,051251150,210271000585,WKEC,908,All Students,365,390,44,30,74,0,1,1,2,1,3,23,30,53,2,2,4,32,30,62,287,271,558,755
20192020,051,HENDERSON,251,Henderson County,150,Henderson County South Middle School,251150,051251150,210271000585,WKEC,908,07,128,144,17,10,27,0,0,0,1,1,2,8,13,21,2,0,2,10,11,21,106,93,199,272
20192020,051,HENDERSON,251,Henderson County,160,Jefferson Elementary School,251160,051251160,210271000586,WKEC,908,03,23,29,5,3,8,0,0,0,1,0,1,4,2,6,0,0,0,6,5,11,13,13,26,52
20192020,051,HENDERSON,251,Henderson County,160,Jefferson Elementary School,251160,051251160,210271000586,WKEC,908,05,34,18,3,4,7,0,0,0,0,0,0,1,3,4,0,0,0,2,2,4,12,25,37,52
20192020,051,HENDERSON,251,Henderson County,160,Jefferson Elementary School,251160,051251160,210271000586,WKEC,908,All Students,159,176,18,21,39,0,0,0,1,2,3,18,18,36,1,2,3,32,20,52,106,96,202,335
20192020,051,HENDERSON,251,Henderson County,160,Jefferson Elementary School,251160,051251160,210271000586,WKEC,908,KG,30,42,3,9,12,0,0,0,0,0,0,3,3,6,0,0,0,10,2,12,26,16,42,72
20192020,051,HENDERSON,251,Henderson County,160,Jefferson Elementary School,251160,051251160,210271000586,WKEC,908,01,25,33,3,1,4,0,0,0,0,2,2,5,1,6,0,2,2,4,5,9,21,14,35,58
20192020,051,HENDERSON,251,Henderson County,160,Jefferson Elementary School,251160,051251160,210271000586,WKEC,908,02,17,22,3,0,3,0,0,0,0,0,0,2,3,5,0,0,0,3,3,6,14,11,25,39
20192020,051,HENDERSON,251,Henderson County,160,Jefferson Elementary School,251160,051251160,210271000586,WKEC,908,04,30,32,1,4,5,0,0,0,0,0,0,3,6,9,1,0,1,7,3,10,20,17,37,62
20192020,052,HENRY,255,Henry County,"",---District Total---,255,"","",OVEC,906,04,66,78,1,0,1,0,0,0,0,1,1,1,3,4,0,0,0,8,3,11,68,59,127,144
20192020,052,HENRY,255,Henry County,"",---District Total---,255,"","",OVEC,906,05,81,79,1,1,2,0,0,0,0,0,0,3,11,14,0,0,0,1,5,6,74,64,138,160
20192020,052,HENRY,255,Henry County,"",---District Total---,255,"","",OVEC,906,06,67,75,0,0,0,0,0,0,0,0,0,2,1,3,0,0,0,3,2,5,70,64,134,142
20192020,052,HENRY,255,Henry County,"",---District Total---,255,"","",OVEC,906,07,68,93,2,1,3,0,0,0,0,0,0,5,2,7,0,0,0,2,3,5,84,62,146,161
20192020,052,HENRY,255,Henry County,"",---District Total---,255,"","",OVEC,906,08,73,86,0,0,0,0,0,0,0,0,0,6,0,6,0,0,0,1,3,4,79,70,149,159
20192020,052,HENRY,255,Henry County,"",---District Total---,255,"","",OVEC,906,09,70,89,2,0,2,0,0,0,1,0,1,4,1,5,0,0,0,4,1,5,78,68,146,159
20192020,052,HENRY,255,Henry County,"",---District Total---,255,"","",OVEC,906,10,80,73,2,0,2,0,0,0,0,1,1,2,3,5,0,0,0,1,2,3,68,74,142,153
20192020,052,HENRY,255,Henry County,"",---District Total---,255,"","",OVEC,906,11,94,90,2,2,4,0,0,0,1,0,1,5,2,7,0,0,0,2,3,5,80,87,167,184
20192020,052,HENRY,255,Henry County,"",---District Total---,255,"","",OVEC,906,12,75,71,1,1,2,0,0,0,0,0,0,5,3,8,0,0,0,1,2,3,64,69,133,146
20192020,052,HENRY,255,Henry County,"",---District Total---,255,"","",OVEC,906,14,0,2,1,0,1,0,0,0,0,0,0,0,0,0,0,0,0,0,0,0,1,0,1,2
20192020,052,HENRY,255,Henry County,"",---District Total---,255,"","",OVEC,906,All Students,987,1016,12,7,19,0,1,1,2,2,4,44,46,90,0,0,0,36,38,74,922,893,1815,2003
20192020,052,HENRY,255,Henry County,"",---District Total---,255,"","",OVEC,906,PS,54,72,0,1,1,0,1,1,0,0,0,6,5,11,0,0,0,1,7,8,65,40,105,126
20192020,052,HENRY,255,Henry County,"",---District Total---,255,"","",OVEC,906,KG,81,67,0,0,0,0,0,0,0,0,0,2,4,6,0,0,0,4,4,8,61,73,134,148
20192020,052,HENRY,255,Henry County,"",---District Total---,255,"","",OVEC,906,01,79,72,0,0,0,0,0,0,0,0,0,4,3,7,0,0,0,3,5,8,65,71,136,151
20192020,052,HENRY,255,Henry County,"",---District Total---,255,"","",OVEC,906,02,71,70,0,2,2,0,1,1,0,0,0,2,7,9,0,0,0,1,2,3,67,59,126,141
20192020,052,HENRY,255,Henry County,"",---District Total---,255,"","",OVEC,906,03,82,71,0,0,0,0,0,0,0,0,0,3,6,9,0,0,0,5,3,8,63,73,136,153
20192020,052,HENRY,255,Henry County,005,Henry County Early Childhood,255005,052255005,210276002418,OVEC,906,PS,54,72,0,1,1,0,1,1,0,0,0,6,5,11,0,0,0,1,7,8,65,40,105,126
20192020,052,HENRY,255,Henry County,005,Henry County Early Childhood,255005,052255005,210276002418,OVEC,906,All Students,0,0,0,0,0,0,0,0,0,0,0,0,0,0,0,0,0,0,0,0,0,0,0,0
20192020,052,HENRY,255,Henry County,010,Campbellsburg Elementary School,255010,052255010,210276000588,OVEC,906,All Students,175,179,1,0,1,0,0,0,0,1,1,6,14,20,0,0,0,9,7,16,163,153,316,354
20192020,052,HENRY,255,Henry County,010,Campbellsburg Elementary School,255010,052255010,210276000588,OVEC,906,KG,30,27,0,0,0,0,0,0,0,0,0,0,2,2,0,0,0,2,2,4,25,26,51,57
20192020,052,HENRY,255,Henry County,010,Campbellsburg Elementary School,255010,052255010,210276000588,OVEC,906,01,34,33,0,0,0,0,0,0,0,0,0,2,1,3,0,0,0,2,2,4,29,31,60,67
20192020,052,HENRY,255,Henry County,010,Campbellsburg Elementary School,255010,052255010,210276000588,OVEC,906,04,28,29,0,0,0,0,0,0,0,1,1,0,1,1,0,0,0,2,2,4,27,24,51,57
20192020,052,HENRY,255,Henry County,010,Campbellsburg Elementary School,255010,052255010,210276000588,OVEC,906,05,25,36,1,0,1,0,0,0,0,0,0,1,4,5,0,0,0,1,0,1,33,21,54,61
20192020,052,HENRY,255,Henry County,010,Campbellsburg Elementary School,255010,052255010,210276000588,OVEC,906,02,25,22,0,0,0,0,0,0,0,0,0,2,3,5,0,0,0,0,0,0,20,22,42,47
20192020,052,HENRY,255,Henry County,010,Campbellsburg Elementary School,255010,052255010,210276000588,OVEC,906,03,33,32,0,0,0,0,0,0,0,0,0,1,3,4,0,0,0,2,1,3,29,29,58,65
20192020,052,HENRY,255,Henry County,020,Eastern Elementary School,255020,052255020,210276000589,OVEC,906,All Students,112,89,0,0,0,0,1,1,0,0,0,4,6,10,0,0,0,4,4,8,81,101,182,201
20192020,052,HENRY,255,Henry County,020,Eastern Elementary School,255020,052255020,210276000589,OVEC,906,KG,21,13,0,0,0,0,0,0,0,0,0,0,0,0,0,0,0,0,0,0,13,21,34,34
20192020,052,HENRY,255,Henry County,020,Eastern Elementary School,255020,052255020,210276000589,OVEC,906,01,16,17,0,0,0,0,0,0,0,0,0,1,1,2,0,0,0,1,0,1,15,15,30,33
20192020,052,HENRY,255,Henry County,020,Eastern Elementary School,255020,052255020,210276000589,OVEC,906,02,20,11,0,0,0,0,1,1,0,0,0,0,1,1,0,0,0,0,1,1,11,17,28,31
20192020,052,HENRY,255,Henry County,020,Eastern Elementary School,255020,052255020,210276000589,OVEC,906,03,14,17,0,0,0,0,0,0,0,0,0,1,0,1,0,0,0,2,0,2,14,14,28,31
20192020,052,HENRY,255,Henry County,020,Eastern Elementary School,255020,052255020,210276000589,OVEC,906,04,21,17,0,0,0,0,0,0,0,0,0,1,0,1,0,0,0,1,1,2,15,20,35,38
20192020,052,HENRY,255,Henry County,020,Eastern Elementary School,255020,052255020,210276000589,OVEC,906,05,20,14,0,0,0,0,0,0,0,0,0,1,4,5,0,0,0,0,2,2,13,14,27,34
20192020,052,HENRY,255,Henry County,035,Henry County High School,255035,052255035,210276000590,OVEC,906,12,75,71,1,1,2,0,0,0,0,0,0,5,3,8,0,0,0,1,2,3,64,69,133,146
20192020,052,HENRY,255,Henry County,035,Henry County High School,255035,052255035,210276000590,OVEC,906,14,0,2,1,0,1,0,0,0,0,0,0,0,0,0,0,0,0,0,0,0,1,0,1,2
20192020,052,HENRY,255,Henry County,035,Henry County High School,255035,052255035,210276000590,OVEC,906,All Students,319,325,8,3,11,0,0,0,2,1,3,16,9,25,0,0,0,8,8,16,291,298,589,644
20192020,052,HENRY,255,Henry County,035,Henry County High School,255035,052255035,210276000590,OVEC,906,09,70,89,2,0,2,0,0,0,1,0,1,4,1,5,0,0,0,4,1,5,78,68,146,159
20192020,052,HENRY,255,Henry County,035,Henry County High School,255035,052255035,210276000590,OVEC,906,10,80,73,2,0,2,0,0,0,0,1,1,2,3,5,0,0,0,1,2,3,68,74,142,153
20192020,052,HENRY,255,Henry County,035,Henry County High School,255035,052255035,210276000590,OVEC,906,11,94,90,2,2,4,0,0,0,1,0,1,5,2,7,0,0,0,2,3,5,80,87,167,184
20192020,052,HENRY,255,Henry County,038,Henry County Middle School,255038,052255038,210276000591,OVEC,906,06,67,75,0,0,0,0,0,0,0,0,0,2,1,3,0,0,0,3,2,5,70,64,134,142
20192020,052,HENRY,255,Henry County,038,Henry County Middle School,255038,052255038,210276000591,OVEC,906,08,73,86,0,0,0,0,0,0,0,0,0,6,0,6,0,0,0,1,3,4,79,70,149,159
20192020,052,HENRY,255,Henry County,038,Henry County Middle School,255038,052255038,210276000591,OVEC,906,All Students,208,254,2,1,3,0,0,0,0,0,0,13,3,16,0,0,0,6,8,14,233,196,429,462
20192020,052,HENRY,255,Henry County,038,Henry County Middle School,255038,052255038,210276000591,OVEC,906,07,68,93,2,1,3,0,0,0,0,0,0,5,2,7,0,0,0,2,3,5,84,62,146,161
20192020,052,HENRY,255,Henry County,040,New Castle Elementary School,255040,052255040,210276000592,OVEC,906,03,35,22,0,0,0,0,0,0,0,0,0,1,3,4,0,0,0,1,2,3,20,30,50,57
20192020,052,HENRY,255,Henry County,040,New Castle Elementary School,255040,052255040,210276000592,OVEC,906,05,36,29,0,1,1,0,0,0,0,0,0,1,3,4,0,0,0,0,3,3,28,29,57,65
20192020,052,HENRY,255,Henry County,040,New Castle Elementary School,255040,052255040,210276000592,OVEC,906,All Students,173,169,1,3,4,0,0,0,0,0,0,5,14,19,0,0,0,9,11,20,154,145,299,342
20192020,052,HENRY,255,Henry County,040,New Castle Elementary School,255040,052255040,210276000592,OVEC,906,KG,30,27,0,0,0,0,0,0,0,0,0,2,2,4,0,0,0,2,2,4,23,26,49,57
20192020,052,HENRY,255,Henry County,040,New Castle Elementary School,255040,052255040,210276000592,OVEC,906,01,29,22,0,0,0,0,0,0,0,0,0,1,1,2,0,0,0,0,3,3,21,25,46,51
20192020,052,HENRY,255,Henry County,040,New Castle Elementary School,255040,052255040,210276000592,OVEC,906,02,26,37,0,2,2,0,0,0,0,0,0,0,3,3,0,0,0,1,1,2,36,20,56,63
20192020,052,HENRY,255,Henry County,040,New Castle Elementary School,255040,052255040,210276000592,OVEC,906,04,17,32,1,0,1,0,0,0,0,0,0,0,2,2,0,0,0,5,0,5,26,15,41,49
20192020,053,HICKMAN,261,Hickman County,"",---District Total---,261,"","",WKEC,908,04,23,21,2,0,2,0,0,0,0,0,0,2,2,4,0,0,0,6,2,8,11,19,30,44
20192020,053,HICKMAN,261,Hickman County,"",---District Total---,261,"","",WKEC,908,03,34,31,2,3,5,0,0,0,0,0,0,0,1,1,0,0,0,3,3,6,26,27,53,65
20192020,053,HICKMAN,261,Hickman County,"",---District Total---,261,"","",WKEC,908,05,22,27,1,1,2,0,0,0,0,0,0,1,0,1,0,0,0,2,2,4,23,19,42,49
20192020,053,HICKMAN,261,Hickman County,"",---District Total---,261,"","",WKEC,908,06,30,26,5,1,6,0,0,0,0,1,1,1,0,1,0,0,0,2,1,3,18,27,45,56
20192020,053,HICKMAN,261,Hickman County,"",---District Total---,261,"","",WKEC,908,07,35,32,2,2,4,0,0,0,0,0,0,1,2,3,0,0,0,4,3,7,25,28,53,67
20192020,053,HICKMAN,261,Hickman County,"",---District Total---,261,"","",WKEC,908,08,24,31,3,3,6,0,0,0,0,0,0,1,2,3,0,0,0,1,2,3,26,17,43,55
20192020,053,HICKMAN,261,Hickman County,"",---District Total---,261,"","",WKEC,908,09,30,31,2,4,6,0,0,0,0,0,0,1,2,3,0,0,0,0,2,2,28,22,50,61
20192020,053,HICKMAN,261,Hickman County,"",---District Total---,261,"","",WKEC,908,10,37,17,1,3,4,0,0,0,0,0,0,1,2,3,0,0,0,1,3,4,14,29,43,54
20192020,053,HICKMAN,261,Hickman County,"",---District Total---,261,"","",WKEC,908,11,18,22,2,1,3,0,0,0,0,0,0,1,0,1,0,0,0,2,2,4,17,15,32,40
20192020,053,HICKMAN,261,Hickman County,"",---District Total---,261,"","",WKEC,908,12,25,20,2,3,5,0,0,0,0,0,0,0,0,0,0,0,0,1,1,2,17,21,38,45
20192020,053,HICKMAN,261,Hickman County,"",---District Total---,261,"","",WKEC,908,All Students,347,337,29,30,59,0,0,0,0,1,1,15,16,31,0,0,0,29,25,54,264,275,539,684
20192020,053,HICKMAN,261,Hickman County,"",---District Total---,261,"","",WKEC,908,PS,51,47,8,5,13,0,1,1,0,0,0,0,1,1,0,0,0,2,3,5,37,41,78,98
20192020,053,HICKMAN,261,Hickman County,"",---District Total---,261,"","",WKEC,908,KG,23,29,4,5,9,0,0,0,0,0,0,2,1,3,0,0,0,3,2,5,20,15,35,52
20192020,053,HICKMAN,261,Hickman County,"",---District Total---,261,"","",WKEC,908,01,23,25,1,2,3,0,0,0,0,0,0,2,2,4,0,0,0,0,0,0,22,19,41,48
20192020,053,HICKMAN,261,Hickman County,"",---District Total---,261,"","",WKEC,908,02,23,25,2,2,4,0,0,0,0,0,0,2,2,4,0,0,0,4,2,6,17,17,34,48
20192020,053,HICKMAN,261,Hickman County,020,Hickman County Elementary School,261020,053261020,210279000593,WKEC,908,01,23,25,1,2,3,0,0,0,0,0,0,2,2,4,0,0,0,0,0,0,22,19,41,48
20192020,053,HICKMAN,261,Hickman County,020,Hickman County Elementary School,261020,053261020,210279000593,WKEC,908,PS,51,47,8,5,13,0,1,1,0,0,0,0,1,1,0,0,0,2,3,5,37,41,78,98
20192020,053,HICKMAN,261,Hickman County,020,Hickman County Elementary School,261020,053261020,210279000593,WKEC,908,06,30,26,5,1,6,0,0,0,0,1,1,1,0,1,0,0,0,2,1,3,18,27,45,56
20192020,053,HICKMAN,261,Hickman County,020,Hickman County Elementary School,261020,053261020,210279000593,WKEC,908,02,23,25,2,2,4,0,0,0,0,0,0,2,2,4,0,0,0,4,2,6,17,17,34,48
20192020,053,HICKMAN,261,Hickman County,020,Hickman County Elementary School,261020,053261020,210279000593,WKEC,908,04,23,21,2,0,2,0,0,0,0,0,0,2,2,4,0,0,0,6,2,8,11,19,30,44
20192020,053,HICKMAN,261,Hickman County,020,Hickman County Elementary School,261020,053261020,210279000593,WKEC,908,03,34,31,2,3,5,0,0,0,0,0,0,0,1,1,0,0,0,3,3,6,26,27,53,65
20192020,053,HICKMAN,261,Hickman County,020,Hickman County Elementary School,261020,053261020,210279000593,WKEC,908,All Students,178,184,17,14,31,0,0,0,0,1,1,10,8,18,0,0,0,20,12,32,137,143,280,362
20192020,053,HICKMAN,261,Hickman County,020,Hickman County Elementary School,261020,053261020,210279000593,WKEC,908,KG,23,29,4,5,9,0,0,0,0,0,0,2,1,3,0,0,0,3,2,5,20,15,35,52
20192020,053,HICKMAN,261,Hickman County,020,Hickman County Elementary School,261020,053261020,210279000593,WKEC,908,05,22,27,1,1,2,0,0,0,0,0,0,1,0,1,0,0,0,2,2,4,23,19,42,49
20192020,053,HICKMAN,261,Hickman County,050,Hickman County High School,261050,053261050,210279000594,WKEC,908,10,37,17,1,3,4,0,0,0,0,0,0,1,2,3,0,0,0,1,3,4,14,29,43,54
20192020,053,HICKMAN,261,Hickman County,050,Hickman County High School,261050,053261050,210279000594,WKEC,908,All Students,169,153,12,16,28,0,0,0,0,0,0,5,8,13,0,0,0,9,13,22,127,132,259,322
20192020,053,HICKMAN,261,Hickman County,050,Hickman County High School,261050,053261050,210279000594,WKEC,908,07,35,32,2,2,4,0,0,0,0,0,0,1,2,3,0,0,0,4,3,7,25,28,53,67
20192020,053,HICKMAN,261,Hickman County,050,Hickman County High School,261050,053261050,210279000594,WKEC,908,08,24,31,3,3,6,0,0,0,0,0,0,1,2,3,0,0,0,1,2,3,26,17,43,55
20192020,053,HICKMAN,261,Hickman County,050,Hickman County High School,261050,053261050,210279000594,WKEC,908,09,30,31,2,4,6,0,0,0,0,0,0,1,2,3,0,0,0,0,2,2,28,22,50,61
20192020,053,HICKMAN,261,Hickman County,050,Hickman County High School,261050,053261050,210279000594,WKEC,908,11,18,22,2,1,3,0,0,0,0,0,0,1,0,1,0,0,0,2,2,4,17,15,32,40
20192020,053,HICKMAN,261,Hickman County,050,Hickman County High School,261050,053261050,210279000594,WKEC,908,12,25,20,2,3,5,0,0,0,0,0,0,0,0,0,0,0,0,1,1,2,17,21,38,45
20192020,054,HOPKINS,265,Hopkins County,"",---District Total---,265,"","",WKEC,908,12,205,245,25,24,49,2,1,3,0,4,4,12,8,20,0,0,0,9,6,15,197,162,359,450
20192020,054,HOPKINS,265,Hopkins County,"",---District Total---,265,"","",WKEC,908,14,0,4,0,0,0,0,0,0,0,0,0,0,0,0,0,0,0,0,0,0,4,0,4,4
20192020,054,HOPKINS,265,Hopkins County,"",---District Total---,265,"","",WKEC,908,All Students,3177,3290,310,274,584,7,5,12,9,27,36,151,139,290,5,8,13,209,226,435,2597,2498,5095,6467
20192020,054,HOPKINS,265,Hopkins County,"",---District Total---,265,"","",WKEC,908,PS,133,188,13,12,25,1,0,1,1,1,2,7,7,14,0,0,0,22,15,37,144,98,242,321
20192020,054,HOPKINS,265,Hopkins County,"",---District Total---,265,"","",WKEC,908,KG,239,237,16,21,37,0,0,0,2,1,3,10,2,12,0,0,0,20,20,40,189,195,384,476
20192020,054,HOPKINS,265,Hopkins County,"",---District Total---,265,"","",WKEC,908,01,224,243,23,13,36,0,0,0,1,2,3,14,14,28,0,1,1,14,21,35,191,173,364,467
20192020,054,HOPKINS,265,Hopkins County,"",---District Total---,265,"","",WKEC,908,02,209,216,15,16,31,0,0,0,0,2,2,5,15,20,0,0,0,20,17,37,174,159,333,425
20192020,054,HOPKINS,265,Hopkins County,"",---District Total---,265,"","",WKEC,908,03,236,236,32,20,52,0,0,0,0,4,4,11,5,16,0,1,1,20,19,39,173,187,360,472
20192020,054,HOPKINS,265,Hopkins County,"",---District Total---,265,"","",WKEC,908,04,273,276,28,27,55,0,1,1,0,1,1,15,11,26,0,1,1,16,22,38,217,210,427,549
20192020,054,HOPKINS,265,Hopkins County,"",---District Total---,265,"","",WKEC,908,05,262,259,19,19,38,2,1,3,0,4,4,8,14,22,1,2,3,20,21,41,209,201,410,521
20192020,054,HOPKINS,265,Hopkins County,"",---District Total---,265,"","",WKEC,908,06,281,287,29,21,50,2,2,4,0,1,1,13,17,30,0,0,0,25,17,42,218,223,441,568
20192020,054,HOPKINS,265,Hopkins County,"",---District Total---,265,"","",WKEC,908,07,300,262,24,25,49,0,0,0,1,3,4,12,12,24,1,0,1,14,19,33,210,241,451,562
20192020,054,HOPKINS,265,Hopkins County,"",---District Total---,265,"","",WKEC,908,08,256,285,34,23,57,0,0,0,1,1,2,10,16,26,0,1,1,18,21,39,222,194,416,541
20192020,054,HOPKINS,265,Hopkins County,"",---District Total---,265,"","",WKEC,908,09,264,265,24,22,46,1,0,1,1,2,3,12,12,24,0,1,1,17,15,32,210,212,422,529
20192020,054,HOPKINS,265,Hopkins County,"",---District Total---,265,"","",WKEC,908,10,222,251,23,21,44,0,0,0,0,1,1,13,6,19,1,0,1,6,18,24,208,176,384,473
20192020,054,HOPKINS,265,Hopkins County,"",---District Total---,265,"","",WKEC,908,11,206,224,18,22,40,0,0,0,3,1,4,16,7,23,2,1,3,10,10,20,175,165,340,430
20192020,054,HOPKINS,265,Hopkins County,004,Hopkins County Schools Academy,265004,054265004,210286002280,WKEC,908,11,3,6,1,1,2,0,0,0,0,0,0,0,0,0,0,0,0,1,0,1,4,2,6,9
20192020,054,HOPKINS,265,Hopkins County,004,Hopkins County Schools Academy,265004,054265004,210286002280,WKEC,908,All Students,38,39,7,7,14,0,1,1,0,0,0,4,0,4,0,0,0,4,0,4,24,30,54,77
20192020,054,HOPKINS,265,Hopkins County,004,Hopkins County Schools Academy,265004,054265004,210286002280,WKEC,908,09,2,2,1,1,2,0,0,0,0,0,0,0,0,0,0,0,0,0,0,0,1,1,2,4
20192020,054,HOPKINS,265,Hopkins County,004,Hopkins County Schools Academy,265004,054265004,210286002280,WKEC,908,10,2,2,1,1,2,0,0,0,0,0,0,0,0,0,0,0,0,0,0,0,1,1,2,4
20192020,054,HOPKINS,265,Hopkins County,004,Hopkins County Schools Academy,265004,054265004,210286002280,WKEC,908,12,31,29,4,4,8,0,1,1,0,0,0,4,0,4,0,0,0,3,0,3,18,26,44,60
20192020,054,HOPKINS,265,Hopkins County,005,Hopkins County Day Treatment,265005,054265005,210286001586,WKEC,908,10,4,0,0,0,0,0,0,0,0,0,0,0,1,1,0,0,0,0,0,0,0,3,3,4
20192020,054,HOPKINS,265,Hopkins County,005,Hopkins County Day Treatment,265005,054265005,210286001586,WKEC,908,All Students,8,11,1,2,3,0,0,0,0,0,0,0,2,2,0,0,0,1,1,2,9,3,12,19
20192020,054,HOPKINS,265,Hopkins County,005,Hopkins County Day Treatment,265005,054265005,210286001586,WKEC,908,06,0,2,0,0,0,0,0,0,0,0,0,0,0,0,0,0,0,0,0,0,2,0,2,2
20192020,054,HOPKINS,265,Hopkins County,005,Hopkins County Day Treatment,265005,054265005,210286001586,WKEC,908,07,1,2,0,0,0,0,0,0,0,0,0,0,1,1,0,0,0,0,0,0,2,0,2,3
20192020,054,HOPKINS,265,Hopkins County,005,Hopkins County Day Treatment,265005,054265005,210286001586,WKEC,908,08,2,2,0,1,1,0,0,0,0,0,0,0,0,0,0,0,0,0,1,1,2,0,2,4
20192020,054,HOPKINS,265,Hopkins County,005,Hopkins County Day Treatment,265005,054265005,210286001586,WKEC,908,09,1,1,0,1,1,0,0,0,0,0,0,0,0,0,0,0,0,1,0,1,0,0,0,2
20192020,054,HOPKINS,265,Hopkins County,005,Hopkins County Day Treatment,265005,054265005,210286001586,WKEC,908,11,0,4,1,0,1,0,0,0,0,0,0,0,0,0,0,0,0,0,0,0,3,0,3,4
20192020,054,HOPKINS,265,Hopkins County,006,West Hopkins School,265006,054265006,210286001472,WKEC,908,07,17,25,0,0,0,0,0,0,0,0,0,0,0,0,0,0,0,0,0,0,25,17,42,42
20192020,054,HOPKINS,265,Hopkins County,006,West Hopkins School,265006,054265006,210286001472,WKEC,908,All Students,175,216,0,1,1,0,1,1,0,0,0,6,8,14,0,0,0,3,7,10,207,158,365,391
20192020,054,HOPKINS,265,Hopkins County,006,West Hopkins School,265006,054265006,210286001472,WKEC,908,PS,8,11,0,0,0,1,0,1,0,0,0,0,0,0,0,0,0,0,0,0,10,8,18,19
20192020,054,HOPKINS,265,Hopkins County,006,West Hopkins School,265006,054265006,210286001472,WKEC,908,KG,17,26,0,1,1,0,0,0,0,0,0,1,0,1,0,0,0,0,1,1,25,15,40,43
20192020,054,HOPKINS,265,Hopkins County,006,West Hopkins School,265006,054265006,210286001472,WKEC,908,01,22,25,0,0,0,0,0,0,0,0,0,2,3,5,0,0,0,0,0,0,23,19,42,47
20192020,054,HOPKINS,265,Hopkins County,006,West Hopkins School,265006,054265006,210286001472,WKEC,908,02,17,19,0,0,0,0,0,0,0,0,0,0,2,2,0,0,0,0,0,0,19,15,34,36
20192020,054,HOPKINS,265,Hopkins County,006,West Hopkins School,265006,054265006,210286001472,WKEC,908,03,15,25,0,0,0,0,0,0,0,0,0,0,0,0,0,0,0,2,3,5,23,12,35,40
20192020,054,HOPKINS,265,Hopkins County,006,West Hopkins School,265006,054265006,210286001472,WKEC,908,04,31,18,0,0,0,0,0,0,0,0,0,0,1,1,0,0,0,0,1,1,18,29,47,49
20192020,054,HOPKINS,265,Hopkins County,006,West Hopkins School,265006,054265006,210286001472,WKEC,908,05,18,18,0,0,0,0,1,1,0,0,0,1,0,1,0,0,0,0,0,0,17,17,34,36
20192020,054,HOPKINS,265,Hopkins County,006,West Hopkins School,265006,054265006,210286001472,WKEC,908,06,24,28,0,0,0,0,0,0,0,0,0,1,2,3,0,0,0,0,1,1,27,21,48,52
20192020,054,HOPKINS,265,Hopkins County,006,West Hopkins School,265006,054265006,210286001472,WKEC,908,08,14,32,0,0,0,0,0,0,0,0,0,1,0,1,0,0,0,1,1,2,30,13,43,46
20192020,054,HOPKINS,265,Hopkins County,020,Jesse Stuart Elementary School,265020,054265020,210286000673,WKEC,908,All Students,186,144,29,31,60,0,0,0,0,5,5,5,5,10,0,0,0,12,13,25,98,132,230,330
20192020,054,HOPKINS,265,Hopkins County,020,Jesse Stuart Elementary School,265020,054265020,210286000673,WKEC,908,PS,20,41,3,0,3,0,0,0,0,1,1,1,0,1,0,0,0,4,5,9,33,14,47,61
20192020,054,HOPKINS,265,Hopkins County,020,Jesse Stuart Elementary School,265020,054265020,210286000673,WKEC,908,KG,20,22,5,4,9,0,0,0,0,0,0,1,0,1,0,0,0,1,1,2,15,15,30,42
20192020,054,HOPKINS,265,Hopkins County,020,Jesse Stuart Elementary School,265020,054265020,210286000673,WKEC,908,01,26,22,3,3,6,0,0,0,0,1,1,0,0,0,0,0,0,0,2,2,19,20,39,48
20192020,054,HOPKINS,265,Hopkins County,020,Jesse Stuart Elementary School,265020,054265020,210286000673,WKEC,908,02,32,18,5,4,9,0,0,0,0,1,1,0,2,2,0,0,0,2,2,4,11,23,34,50
20192020,054,HOPKINS,265,Hopkins County,020,Jesse Stuart Elementary School,265020,054265020,210286000673,WKEC,908,03,34,29,7,4,11,0,0,0,0,1,1,3,0,3,0,0,0,4,3,7,15,26,41,63
20192020,054,HOPKINS,265,Hopkins County,020,Jesse Stuart Elementary School,265020,054265020,210286000673,WKEC,908,04,41,25,5,10,15,0,0,0,0,0,0,1,2,3,0,0,0,0,2,2,19,27,46,66
20192020,054,HOPKINS,265,Hopkins County,020,Jesse Stuart Elementary School,265020,054265020,210286000673,WKEC,908,05,33,28,4,6,10,0,0,0,0,2,2,0,1,1,0,0,0,5,3,8,19,21,40,61
20192020,054,HOPKINS,265,Hopkins County,075,James Madison Middle School,265075,054265075,210286000681,WKEC,908,08,83,100,11,9,20,0,0,0,1,1,2,1,4,5,0,1,1,5,4,9,82,64,146,183
20192020,054,HOPKINS,265,Hopkins County,075,James Madison Middle School,265075,054265075,210286000681,WKEC,908,06,95,90,12,5,17,0,0,0,0,1,1,2,4,6,0,0,0,5,7,12,71,78,149,185
20192020,054,HOPKINS,265,Hopkins County,075,James Madison Middle School,265075,054265075,210286000681,WKEC,908,07,102,98,9,10,19,0,0,0,1,0,1,3,3,6,1,0,1,6,5,11,78,84,162,200
20192020,054,HOPKINS,265,Hopkins County,075,James Madison Middle School,265075,054265075,210286000681,WKEC,908,All Students,280,288,32,24,56,0,0,0,2,2,4,6,11,17,1,1,2,16,16,32,231,226,457,568
20192020,054,HOPKINS,265,Hopkins County,090,Grapevine Elementary School,265090,054265090,210286000598,WKEC,908,01,26,25,3,3,6,0,0,0,0,0,0,6,4,10,0,0,0,1,3,4,15,16,31,51
20192020,054,HOPKINS,265,Hopkins County,090,Grapevine Elementary School,265090,054265090,210286000598,WKEC,908,02,30,20,1,2,3,0,0,0,0,0,0,0,4,4,0,0,0,3,6,9,16,18,34,50
20192020,054,HOPKINS,265,Hopkins County,090,Grapevine Elementary School,265090,054265090,210286000598,WKEC,908,03,30,25,6,3,9,0,0,0,0,0,0,3,0,3,0,0,0,2,1,3,14,26,40,55
20192020,054,HOPKINS,265,Hopkins County,090,Grapevine Elementary School,265090,054265090,210286000598,WKEC,908,05,29,27,5,0,5,0,0,0,0,0,0,0,4,4,0,0,0,3,5,8,19,20,39,56
20192020,054,HOPKINS,265,Hopkins County,090,Grapevine Elementary School,265090,054265090,210286000598,WKEC,908,04,27,36,3,1,4,0,0,0,0,0,0,5,2,7,0,0,0,4,5,9,24,19,43,63
20192020,054,HOPKINS,265,Hopkins County,090,Grapevine Elementary School,265090,054265090,210286000598,WKEC,908,All Students,163,158,20,11,31,0,0,0,0,1,1,16,15,31,0,0,0,14,22,36,108,114,222,321
20192020,054,HOPKINS,265,Hopkins County,090,Grapevine Elementary School,265090,054265090,210286000598,WKEC,908,PS,35,42,5,6,11,0,0,0,0,0,0,4,4,8,0,0,0,10,3,13,23,22,45,77
20192020,054,HOPKINS,265,Hopkins County,090,Grapevine Elementary School,265090,054265090,210286000598,WKEC,908,KG,21,25,2,2,4,0,0,0,0,1,1,2,1,3,0,0,0,1,2,3,20,15,35,46
20192020,054,HOPKINS,265,Hopkins County,105,Hopkins Co Career & Technology Center,265105,054265105,210286002425,WKEC,908,11,0,0,0,0,0,0,0,0,0,0,0,0,0,0,0,0,0,0,0,0,0,0,0,0
20192020,054,HOPKINS,265,Hopkins County,105,Hopkins Co Career & Technology Center,265105,054265105,210286002425,WKEC,908,All Students,0,0,0,0,0,0,0,0,0,0,0,0,0,0,0,0,0,0,0,0,0,0,0,0
20192020,054,HOPKINS,265,Hopkins County,105,Hopkins Co Career & Technology Center,265105,054265105,210286002425,WKEC,908,09,0,0,0,0,0,0,0,0,0,0,0,0,0,0,0,0,0,0,0,0,0,0,0,0
20192020,054,HOPKINS,265,Hopkins County,105,Hopkins Co Career & Technology Center,265105,054265105,210286002425,WKEC,908,10,0,0,0,0,0,0,0,0,0,0,0,0,0,0,0,0,0,0,0,0,0,0,0,0
20192020,054,HOPKINS,265,Hopkins County,105,Hopkins Co Career & Technology Center,265105,054265105,210286002425,WKEC,908,12,0,0,0,0,0,0,0,0,0,0,0,0,0,0,0,0,0,0,0,0,0,0,0,0
20192020,054,HOPKINS,265,Hopkins County,110,Hanson Elementary School,265110,054265110,210286000600,WKEC,908,04,37,51,1,4,5,0,0,0,0,0,0,0,2,2,0,0,0,2,4,6,48,27,75,88
20192020,054,HOPKINS,265,Hopkins County,110,Hanson Elementary School,265110,054265110,210286000600,WKEC,908,All Students,244,260,12,9,21,0,0,0,2,4,6,4,3,7,0,0,0,12,14,26,230,214,444,504
20192020,054,HOPKINS,265,Hopkins County,110,Hanson Elementary School,265110,054265110,210286000600,WKEC,908,KG,41,32,1,2,3,0,0,0,1,0,1,1,0,1,0,0,0,2,3,5,27,36,63,73
20192020,054,HOPKINS,265,Hopkins County,110,Hanson Elementary School,265110,054265110,210286000600,WKEC,908,01,45,40,3,0,3,0,0,0,1,0,1,0,1,1,0,0,0,1,5,6,35,39,74,85
20192020,054,HOPKINS,265,Hopkins County,110,Hanson Elementary School,265110,054265110,210286000600,WKEC,908,02,34,43,3,0,3,0,0,0,0,0,0,1,0,1,0,0,0,3,1,4,36,33,69,77
20192020,054,HOPKINS,265,Hopkins County,110,Hanson Elementary School,265110,054265110,210286000600,WKEC,908,03,45,37,2,2,4,0,0,0,0,2,2,1,0,1,0,0,0,1,1,2,33,40,73,82
20192020,054,HOPKINS,265,Hopkins County,110,Hanson Elementary School,265110,054265110,210286000600,WKEC,908,05,42,57,2,1,3,0,0,0,0,2,2,1,0,1,0,0,0,3,0,3,51,39,90,99
20192020,054,HOPKINS,265,Hopkins County,130,Hopkins County Central High School,265130,054265130,210286001473,WKEC,908,11,100,91,2,7,9,0,0,0,1,0,1,7,3,10,1,1,2,4,2,6,76,87,163,191
20192020,054,HOPKINS,265,Hopkins County,130,Hopkins County Central High School,265130,054265130,210286001473,WKEC,908,14,0,2,0,0,0,0,0,0,0,0,0,0,0,0,0,0,0,0,0,0,2,0,2,2
20192020,054,HOPKINS,265,Hopkins County,130,Hopkins County Central High School,265130,054265130,210286001473,WKEC,908,All Students,358,425,22,25,47,3,0,3,1,0,1,24,10,34,2,1,3,17,17,34,356,305,661,783
20192020,054,HOPKINS,265,Hopkins County,130,Hopkins County Central High School,265130,054265130,210286001473,WKEC,908,09,104,118,6,9,15,1,0,1,0,0,0,3,3,6,0,0,0,6,5,11,102,87,189,222
20192020,054,HOPKINS,265,Hopkins County,130,Hopkins County Central High School,265130,054265130,210286001473,WKEC,908,10,88,109,7,5,12,0,0,0,0,0,0,9,1,10,1,0,1,2,10,12,90,72,162,197
20192020,054,HOPKINS,265,Hopkins County,130,Hopkins County Central High School,265130,054265130,210286001473,WKEC,908,12,66,105,7,4,11,2,0,2,0,0,0,5,3,8,0,0,0,5,0,5,86,59,145,171
20192020,054,HOPKINS,265,Hopkins County,140,Browning Springs Middle School,265140,054265140,210286000601,WKEC,908,06,81,101,12,11,23,1,1,2,0,0,0,9,8,17,0,0,0,16,7,23,63,54,117,182
20192020,054,HOPKINS,265,Hopkins County,140,Browning Springs Middle School,265140,054265140,210286000601,WKEC,908,08,80,84,16,10,26,0,0,0,0,0,0,6,6,12,0,0,0,9,9,18,53,55,108,164
20192020,054,HOPKINS,265,Hopkins County,140,Browning Springs Middle School,265140,054265140,210286000601,WKEC,908,All Students,265,260,37,35,72,1,1,2,0,2,2,21,21,42,0,0,0,30,27,57,171,179,350,525
20192020,054,HOPKINS,265,Hopkins County,140,Browning Springs Middle School,265140,054265140,210286000601,WKEC,908,07,104,75,9,14,23,0,0,0,0,2,2,6,7,13,0,0,0,5,11,16,55,70,125,179
20192020,054,HOPKINS,265,Hopkins County,145,Madisonville North Hopkins High School,265145,054265145,210286000602,WKEC,908,14,0,2,0,0,0,0,0,0,0,0,0,0,0,0,0,0,0,0,0,0,2,0,2,2
20192020,054,HOPKINS,265,Hopkins County,145,Madisonville North Hopkins High School,265145,054265145,210286000602,WKEC,908,All Students,496,520,60,56,116,0,0,0,3,8,11,25,22,47,1,1,2,20,32,52,411,377,788,1016
20192020,054,HOPKINS,265,Hopkins County,145,Madisonville North Hopkins High School,265145,054265145,210286000602,WKEC,908,09,157,144,17,11,28,0,0,0,1,2,3,9,9,18,0,1,1,10,10,20,107,124,231,301
20192020,054,HOPKINS,265,Hopkins County,145,Madisonville North Hopkins High School,265145,054265145,210286000602,WKEC,908,10,128,140,15,15,30,0,0,0,0,1,1,4,4,8,0,0,0,4,8,12,117,100,217,268
20192020,054,HOPKINS,265,Hopkins County,145,Madisonville North Hopkins High School,265145,054265145,210286000602,WKEC,908,11,103,123,14,14,28,0,0,0,2,1,3,9,4,13,1,0,1,5,8,13,92,76,168,226
20192020,054,HOPKINS,265,Hopkins County,145,Madisonville North Hopkins High School,265145,054265145,210286000602,WKEC,908,12,108,111,14,16,30,0,0,0,0,4,4,3,5,8,0,0,0,1,6,7,93,77,170,219
20192020,054,HOPKINS,265,Hopkins County,185,South Hopkins Middle School,265185,054265185,210286001499,WKEC,908,08,77,67,7,3,10,0,0,0,0,0,0,2,6,8,0,0,0,3,6,9,55,62,117,144
20192020,054,HOPKINS,265,Hopkins County,185,South Hopkins Middle School,265185,054265185,210286001499,WKEC,908,All Students,234,195,18,9,27,1,1,2,0,1,1,6,10,16,0,0,0,10,11,21,160,202,362,429
20192020,054,HOPKINS,265,Hopkins County,185,South Hopkins Middle School,265185,054265185,210286001499,WKEC,908,06,81,66,5,5,10,1,1,2,0,0,0,1,3,4,0,0,0,4,2,6,55,70,125,147
20192020,054,HOPKINS,265,Hopkins County,185,South Hopkins Middle School,265185,054265185,210286001499,WKEC,908,07,76,62,6,1,7,0,0,0,0,1,1,3,1,4,0,0,0,3,3,6,50,70,120,138
20192020,054,HOPKINS,265,Hopkins County,200,Pride Elementary School,265200,054265200,210286000606,WKEC,908,01,21,32,5,3,8,0,0,0,0,0,0,4,2,6,0,0,0,2,3,5,21,13,34,53
20192020,054,HOPKINS,265,Hopkins County,200,Pride Elementary School,265200,054265200,210286000606,WKEC,908,02,38,33,3,7,10,0,0,0,0,0,0,2,1,3,0,0,0,2,6,8,24,24,48,71
20192020,054,HOPKINS,265,Hopkins County,200,Pride Elementary School,265200,054265200,210286000606,WKEC,908,03,30,31,5,4,9,0,0,0,0,0,0,0,4,4,0,1,1,3,3,6,23,18,41,61
20192020,054,HOPKINS,265,Hopkins County,200,Pride Elementary School,265200,054265200,210286000606,WKEC,908,05,35,36,4,8,12,1,0,1,0,0,0,2,2,4,0,1,1,6,3,9,23,21,44,71
20192020,054,HOPKINS,265,Hopkins County,200,Pride Elementary School,265200,054265200,210286000606,WKEC,908,04,52,39,10,6,16,0,1,1,0,1,1,3,3,6,0,0,0,3,6,9,23,35,58,91
20192020,054,HOPKINS,265,Hopkins County,200,Pride Elementary School,265200,054265200,210286000606,WKEC,908,All Students,219,211,32,33,65,1,1,2,0,1,1,11,12,23,0,2,2,21,24,45,144,146,290,430
20192020,054,HOPKINS,265,Hopkins County,200,Pride Elementary School,265200,054265200,210286000606,WKEC,908,PS,30,40,2,5,7,0,0,0,1,0,1,1,1,2,0,0,0,3,4,7,33,20,53,70
20192020,054,HOPKINS,265,Hopkins County,200,Pride Elementary School,265200,054265200,210286000606,WKEC,908,KG,43,40,5,5,10,0,0,0,0,0,0,0,0,0,0,0,0,5,3,8,30,35,65,83
20192020,054,HOPKINS,265,Hopkins County,250,West Broadway Elementary School,265250,054265250,210286000611,WKEC,908,04,29,34,8,5,13,0,0,0,0,0,0,2,1,3,0,0,0,2,2,4,22,21,43,63
20192020,054,HOPKINS,265,Hopkins County,250,West Broadway Elementary School,265250,054265250,210286000611,WKEC,908,All Students,162,183,24,14,38,0,0,0,0,1,1,10,10,20,0,0,0,19,18,37,130,119,249,345
20192020,054,HOPKINS,265,Hopkins County,250,West Broadway Elementary School,265250,054265250,210286000611,WKEC,908,PS,18,18,1,1,2,0,0,0,0,0,0,0,2,2,0,0,0,2,1,3,15,14,29,36
20192020,054,HOPKINS,265,Hopkins County,250,West Broadway Elementary School,265250,054265250,210286000611,WKEC,908,KG,28,34,2,1,3,0,0,0,0,0,0,3,1,4,0,0,0,6,5,11,23,21,44,62
20192020,054,HOPKINS,265,Hopkins County,250,West Broadway Elementary School,265250,054265250,210286000611,WKEC,908,01,26,33,5,3,8,0,0,0,0,0,0,1,3,4,0,0,0,3,4,7,24,16,40,59
20192020,054,HOPKINS,265,Hopkins County,250,West Broadway Elementary School,265250,054265250,210286000611,WKEC,908,02,22,24,3,2,5,0,0,0,0,1,1,1,2,3,0,0,0,4,1,5,16,16,32,46
20192020,054,HOPKINS,265,Hopkins County,250,West Broadway Elementary School,265250,054265250,210286000611,WKEC,908,03,24,30,4,2,6,0,0,0,0,0,0,2,1,3,0,0,0,3,2,5,21,19,40,54
20192020,054,HOPKINS,265,Hopkins County,250,West Broadway Elementary School,265250,054265250,210286000611,WKEC,908,05,33,28,2,1,3,0,0,0,0,0,0,1,2,3,0,0,0,1,4,5,24,26,50,61
20192020,054,HOPKINS,265,Hopkins County,280,Southside Elementary School,265280,054265280,210286000474,WKEC,908,04,32,42,0,0,0,0,0,0,0,0,0,1,0,1,0,1,1,3,1,4,38,30,68,74
20192020,054,HOPKINS,265,Hopkins County,280,Southside Elementary School,265280,054265280,210286000474,WKEC,908,All Students,201,215,3,2,5,1,0,1,0,2,2,2,3,5,1,3,4,17,9,26,191,182,373,416
20192020,054,HOPKINS,265,Hopkins County,280,Southside Elementary School,265280,054265280,210286000474,WKEC,908,PS,14,26,1,0,1,0,0,0,0,0,0,0,0,0,0,0,0,2,1,3,23,13,36,40
20192020,054,HOPKINS,265,Hopkins County,280,Southside Elementary School,265280,054265280,210286000474,WKEC,908,KG,41,31,1,1,2,0,0,0,0,0,0,0,0,0,0,0,0,3,2,5,27,38,65,72
20192020,054,HOPKINS,265,Hopkins County,280,Southside Elementary School,265280,054265280,210286000474,WKEC,908,01,34,30,0,0,0,0,0,0,0,1,1,0,0,0,0,1,1,3,1,4,27,31,58,64
20192020,054,HOPKINS,265,Hopkins County,280,Southside Elementary School,265280,054265280,210286000474,WKEC,908,02,13,39,0,0,0,0,0,0,0,0,0,0,0,0,0,0,0,3,1,4,36,12,48,52
20192020,054,HOPKINS,265,Hopkins County,280,Southside Elementary School,265280,054265280,210286000474,WKEC,908,03,36,33,2,0,2,0,0,0,0,1,1,1,0,1,0,0,0,3,2,5,27,33,60,69
20192020,054,HOPKINS,265,Hopkins County,280,Southside Elementary School,265280,054265280,210286000474,WKEC,908,05,45,40,0,1,1,1,0,1,0,0,0,0,3,3,1,1,2,2,2,4,36,38,74,85
20192020,054,HOPKINS,265,Hopkins County,330,Earlington Elementary School,265330,054265330,210286000614,WKEC,908,04,24,31,1,1,2,0,0,0,0,0,0,3,0,3,0,0,0,2,1,3,25,22,47,55
20192020,054,HOPKINS,265,Hopkins County,330,Earlington Elementary School,265330,054265330,210286000614,WKEC,908,All Students,148,165,13,15,28,0,0,0,1,0,1,11,7,18,0,0,0,13,15,28,127,111,238,313
20192020,054,HOPKINS,265,Hopkins County,330,Earlington Elementary School,265330,054265330,210286000614,WKEC,908,PS,8,10,1,0,1,0,0,0,0,0,0,1,0,1,0,0,0,1,1,2,7,7,14,18
20192020,054,HOPKINS,265,Hopkins County,330,Earlington Elementary School,265330,054265330,210286000614,WKEC,908,KG,28,27,0,5,5,0,0,0,1,0,1,2,0,2,0,0,0,2,3,5,22,20,42,55
20192020,054,HOPKINS,265,Hopkins County,330,Earlington Elementary School,265330,054265330,210286000614,WKEC,908,01,24,36,4,1,5,0,0,0,0,0,0,1,1,2,0,0,0,4,3,7,27,19,46,60
20192020,054,HOPKINS,265,Hopkins County,330,Earlington Elementary School,265330,054265330,210286000614,WKEC,908,02,23,20,0,1,1,0,0,0,0,0,0,1,4,5,0,0,0,3,0,3,16,18,34,43
20192020,054,HOPKINS,265,Hopkins County,330,Earlington Elementary School,265330,054265330,210286000614,WKEC,908,03,22,26,6,5,11,0,0,0,0,0,0,1,0,1,0,0,0,2,4,6,17,13,30,48
20192020,054,HOPKINS,265,Hopkins County,330,Earlington Elementary School,265330,054265330,210286000614,WKEC,908,05,27,25,2,2,4,0,0,0,0,0,0,3,2,5,0,0,0,0,4,4,20,19,39,52
20192020,055,JACKSON,271,Jackson County,"",---District Total---,271,"","",SESC,907,04,70,85,1,0,1,0,0,0,0,0,0,3,2,5,0,0,0,1,1,2,80,67,147,155
20192020,055,JACKSON,271,Jackson County,"",---District Total---,271,"","",SESC,907,All Students,887,1012,1,2,3,0,0,0,0,2,2,11,11,22,0,0,0,10,9,19,990,863,1853,1899
20192020,055,JACKSON,271,Jackson County,"",---District Total---,271,"","",SESC,907,PS,93,108,1,0,1,0,0,0,1,0,1,2,1,3,0,0,0,0,1,1,104,91,195,201
20192020,055,JACKSON,271,Jackson County,"",---District Total---,271,"","",SESC,907,KG,95,101,0,0,0,0,0,0,0,0,0,0,0,0,0,0,0,1,3,4,100,92,192,196
20192020,055,JACKSON,271,Jackson County,"",---District Total---,271,"","",SESC,907,01,80,86,0,0,0,0,0,0,0,0,0,0,0,0,0,0,0,2,1,3,84,79,163,166
20192020,055,JACKSON,271,Jackson County,"",---District Total---,271,"","",SESC,907,02,65,67,0,0,0,0,0,0,0,0,0,0,4,4,0,0,0,4,1,5,63,60,123,132
20192020,055,JACKSON,271,Jackson County,"",---District Total---,271,"","",SESC,907,03,61,73,0,0,0,0,0,0,0,0,0,0,0,0,0,0,0,1,0,1,72,61,133,134
20192020,055,JACKSON,271,Jackson County,"",---District Total---,271,"","",SESC,907,05,77,66,0,0,0,0,0,0,0,0,0,2,2,4,0,0,0,0,1,1,64,74,138,143
20192020,055,JACKSON,271,Jackson County,"",---District Total---,271,"","",SESC,907,06,58,83,0,1,1,0,0,0,0,0,0,0,0,0,0,0,0,0,0,0,83,57,140,141
20192020,055,JACKSON,271,Jackson County,"",---District Total---,271,"","",SESC,907,07,78,75,0,0,0,0,0,0,0,1,1,2,1,3,0,0,0,0,0,0,73,76,149,153
20192020,055,JACKSON,271,Jackson County,"",---District Total---,271,"","",SESC,907,08,61,95,0,0,0,0,0,0,0,0,0,2,2,4,0,0,0,0,0,0,93,59,152,156
20192020,055,JACKSON,271,Jackson County,"",---District Total---,271,"","",SESC,907,09,70,76,0,0,0,0,0,0,0,0,0,0,0,0,0,0,0,0,1,1,76,69,145,146
20192020,055,JACKSON,271,Jackson County,"",---District Total---,271,"","",SESC,907,10,57,86,0,1,1,0,0,0,0,1,1,0,0,0,0,0,0,1,1,2,85,54,139,143
20192020,055,JACKSON,271,Jackson County,"",---District Total---,271,"","",SESC,907,11,69,55,0,0,0,0,0,0,0,0,0,1,0,1,0,0,0,0,0,0,54,69,123,124
20192020,055,JACKSON,271,Jackson County,"",---District Total---,271,"","",SESC,907,12,44,64,0,0,0,0,0,0,0,0,0,1,0,1,0,0,0,0,0,0,63,44,107,108
20192020,055,JACKSON,271,Jackson County,"",---District Total---,271,"","",SESC,907,14,2,0,0,0,0,0,0,0,0,0,0,0,0,0,0,0,0,0,0,0,0,2,2,2
20192020,055,JACKSON,271,Jackson County,020,Jackson County High School,271020,055271020,210294000615,SESC,907,14,2,0,0,0,0,0,0,0,0,0,0,0,0,0,0,0,0,0,0,0,0,2,2,2
20192020,055,JACKSON,271,Jackson County,020,Jackson County High School,271020,055271020,210294000615,SESC,907,All Students,239,270,0,0,0,0,0,0,0,1,1,2,0,2,0,0,0,1,2,3,267,236,503,509
20192020,055,JACKSON,271,Jackson County,020,Jackson County High School,271020,055271020,210294000615,SESC,907,09,70,75,0,0,0,0,0,0,0,0,0,0,0,0,0,0,0,0,1,1,75,69,144,145
20192020,055,JACKSON,271,Jackson County,020,Jackson County High School,271020,055271020,210294000615,SESC,907,10,55,78,0,0,0,0,0,0,0,1,1,0,0,0,0,0,0,1,1,2,77,53,130,133
20192020,055,JACKSON,271,Jackson County,020,Jackson County High School,271020,055271020,210294000615,SESC,907,11,68,53,0,0,0,0,0,0,0,0,0,1,0,1,0,0,0,0,0,0,52,68,120,121
20192020,055,JACKSON,271,Jackson County,020,Jackson County High School,271020,055271020,210294000615,SESC,907,12,44,64,0,0,0,0,0,0,0,0,0,1,0,1,0,0,0,0,0,0,63,44,107,108
20192020,055,JACKSON,271,Jackson County,025,Jackson County Middle School,271025,055271025,210294001674,SESC,907,07,78,75,0,0,0,0,0,0,0,1,1,2,1,3,0,0,0,0,0,0,73,76,149,153
20192020,055,JACKSON,271,Jackson County,025,Jackson County Middle School,271025,055271025,210294001674,SESC,907,All Students,197,251,0,1,1,0,0,0,0,1,1,4,3,7,0,0,0,0,0,0,247,192,439,448
20192020,055,JACKSON,271,Jackson County,025,Jackson County Middle School,271025,055271025,210294001674,SESC,907,06,58,83,0,1,1,0,0,0,0,0,0,0,0,0,0,0,0,0,0,0,83,57,140,141
20192020,055,JACKSON,271,Jackson County,025,Jackson County Middle School,271025,055271025,210294001674,SESC,907,08,61,93,0,0,0,0,0,0,0,0,0,2,2,4,0,0,0,0,0,0,91,59,150,154
20192020,055,JACKSON,271,Jackson County,027,Barnabus Home Middle School,271027,055271027,210294002375,SESC,907,All Students,0,2,0,0,0,0,0,0,0,0,0,0,0,0,0,0,0,0,0,0,2,0,2,2
20192020,055,JACKSON,271,Jackson County,027,Barnabus Home Middle School,271027,055271027,210294002375,SESC,907,08,0,2,0,0,0,0,0,0,0,0,0,0,0,0,0,0,0,0,0,0,2,0,2,2
20192020,055,JACKSON,271,Jackson County,029,Barnabus Home High School,271029,055271029,210294002390,SESC,907,All Students,0,6,0,0,0,0,0,0,0,0,0,0,0,0,0,0,0,0,0,0,6,0,6,6
20192020,055,JACKSON,271,Jackson County,029,Barnabus Home High School,271029,055271029,210294002390,SESC,907,09,0,1,0,0,0,0,0,0,0,0,0,0,0,0,0,0,0,0,0,0,1,0,1,1
20192020,055,JACKSON,271,Jackson County,029,Barnabus Home High School,271029,055271029,210294002390,SESC,907,10,0,4,0,0,0,0,0,0,0,0,0,0,0,0,0,0,0,0,0,0,4,0,4,4
20192020,055,JACKSON,271,Jackson County,029,Barnabus Home High School,271029,055271029,210294002390,SESC,907,11,0,1,0,0,0,0,0,0,0,0,0,0,0,0,0,0,0,0,0,0,1,0,1,1
20192020,055,JACKSON,271,Jackson County,031,Jackson Co Schools Learning Center,271031,055271031,210294002461,SESC,907,10,2,4,0,1,1,0,0,0,0,0,0,0,0,0,0,0,0,0,0,0,4,1,5,6
20192020,055,JACKSON,271,Jackson County,031,Jackson Co Schools Learning Center,271031,055271031,210294002461,SESC,907,11,1,1,0,0,0,0,0,0,0,0,0,0,0,0,0,0,0,0,0,0,1,1,2,2
20192020,055,JACKSON,271,Jackson County,031,Jackson Co Schools Learning Center,271031,055271031,210294002461,SESC,907,All Students,3,5,0,1,1,0,0,0,0,0,0,0,0,0,0,0,0,0,0,0,5,2,7,8
20192020,055,JACKSON,271,Jackson County,180,McKee Elementary School,271180,055271180,210294000617,SESC,907,KG,28,36,0,0,0,0,0,0,0,0,0,0,0,0,0,0,0,0,3,3,36,25,61,64
20192020,055,JACKSON,271,Jackson County,180,McKee Elementary School,271180,055271180,210294000617,SESC,907,01,22,30,0,0,0,0,0,0,0,0,0,0,0,0,0,0,0,1,1,2,29,21,50,52
20192020,055,JACKSON,271,Jackson County,180,McKee Elementary School,271180,055271180,210294000617,SESC,907,04,18,31,0,0,0,0,0,0,0,0,0,1,0,1,0,0,0,1,1,2,29,17,46,49
20192020,055,JACKSON,271,Jackson County,180,McKee Elementary School,271180,055271180,210294000617,SESC,907,02,29,18,0,0,0,0,0,0,0,0,0,0,2,2,0,0,0,3,0,3,15,27,42,47
20192020,055,JACKSON,271,Jackson County,180,McKee Elementary School,271180,055271180,210294000617,SESC,907,05,31,14,0,0,0,0,0,0,0,0,0,0,1,1,0,0,0,0,0,0,14,30,44,45
20192020,055,JACKSON,271,Jackson County,180,McKee Elementary School,271180,055271180,210294000617,SESC,907,03,23,29,0,0,0,0,0,0,0,0,0,0,0,0,0,0,0,1,0,1,28,23,51,52
20192020,055,JACKSON,271,Jackson County,180,McKee Elementary School,271180,055271180,210294000617,SESC,907,All Students,151,158,0,0,0,0,0,0,0,0,0,1,3,4,0,0,0,6,5,11,151,143,294,309
20192020,055,JACKSON,271,Jackson County,180,McKee Elementary School,271180,055271180,210294000617,SESC,907,PS,26,34,0,0,0,0,0,0,0,0,0,1,0,1,0,0,0,0,0,0,33,26,59,60
20192020,055,JACKSON,271,Jackson County,280,Sand Gap Elementary School,271280,055271280,210294000619,SESC,907,03,12,16,0,0,0,0,0,0,0,0,0,0,0,0,0,0,0,0,0,0,16,12,28,28
20192020,055,JACKSON,271,Jackson County,280,Sand Gap Elementary School,271280,055271280,210294000619,SESC,907,05,18,18,0,0,0,0,0,0,0,0,0,1,1,2,0,0,0,0,1,1,17,16,33,36
20192020,055,JACKSON,271,Jackson County,280,Sand Gap Elementary School,271280,055271280,210294000619,SESC,907,All Students,91,113,1,0,1,0,0,0,0,0,0,2,1,3,0,0,0,3,1,4,107,89,196,204
20192020,055,JACKSON,271,Jackson County,280,Sand Gap Elementary School,271280,055271280,210294000619,SESC,907,PS,27,35,1,0,1,0,0,0,0,0,0,0,1,1,0,0,0,0,0,0,34,26,60,62
20192020,055,JACKSON,271,Jackson County,280,Sand Gap Elementary School,271280,055271280,210294000619,SESC,907,KG,18,27,0,0,0,0,0,0,0,0,0,0,0,0,0,0,0,1,0,1,26,18,44,45
20192020,055,JACKSON,271,Jackson County,280,Sand Gap Elementary School,271280,055271280,210294000619,SESC,907,01,17,19,0,0,0,0,0,0,0,0,0,0,0,0,0,0,0,1,0,1,18,17,35,36
20192020,055,JACKSON,271,Jackson County,280,Sand Gap Elementary School,271280,055271280,210294000619,SESC,907,02,9,17,0,0,0,0,0,0,0,0,0,0,0,0,0,0,0,1,0,1,16,9,25,26
20192020,055,JACKSON,271,Jackson County,280,Sand Gap Elementary School,271280,055271280,210294000619,SESC,907,04,17,16,1,0,1,0,0,0,0,0,0,1,0,1,0,0,0,0,0,0,14,17,31,33
20192020,055,JACKSON,271,Jackson County,340,Tyner Elementary School,271340,055271340,210294000620,SESC,907,05,28,34,0,0,0,0,0,0,0,0,0,1,0,1,0,0,0,0,0,0,33,28,61,62
20192020,055,JACKSON,271,Jackson County,340,Tyner Elementary School,271340,055271340,210294000620,SESC,907,All Students,206,207,0,0,0,0,0,0,0,0,0,2,4,6,0,0,0,0,1,1,205,201,406,413
20192020,055,JACKSON,271,Jackson County,340,Tyner Elementary School,271340,055271340,210294000620,SESC,907,PS,40,39,0,0,0,0,0,0,1,0,1,1,0,1,0,0,0,0,1,1,37,39,76,79
20192020,055,JACKSON,271,Jackson County,340,Tyner Elementary School,271340,055271340,210294000620,SESC,907,KG,49,38,0,0,0,0,0,0,0,0,0,0,0,0,0,0,0,0,0,0,38,49,87,87
20192020,055,JACKSON,271,Jackson County,340,Tyner Elementary School,271340,055271340,210294000620,SESC,907,01,41,37,0,0,0,0,0,0,0,0,0,0,0,0,0,0,0,0,0,0,37,41,78,78
20192020,055,JACKSON,271,Jackson County,340,Tyner Elementary School,271340,055271340,210294000620,SESC,907,02,27,32,0,0,0,0,0,0,0,0,0,0,2,2,0,0,0,0,1,1,32,24,56,59
20192020,055,JACKSON,271,Jackson County,340,Tyner Elementary School,271340,055271340,210294000620,SESC,907,03,26,28,0,0,0,0,0,0,0,0,0,0,0,0,0,0,0,0,0,0,28,26,54,54
20192020,055,JACKSON,271,Jackson County,340,Tyner Elementary School,271340,055271340,210294000620,SESC,907,04,35,38,0,0,0,0,0,0,0,0,0,1,2,3,0,0,0,0,0,0,37,33,70,73
20192020,013,BREATHITT,272,Jackson Independent,"",---District Total---,272,"","",KVEC,904,12,8,12,1,0,1,0,0,0,0,0,0,0,0,0,0,0,0,0,0,0,11,8,19,20
20192020,013,BREATHITT,272,Jackson Independent,"",---District Total---,272,"","",KVEC,904,All Students,154,156,1,0,1,0,0,0,2,2,4,0,0,0,0,0,0,0,0,0,153,152,305,310
20192020,013,BREATHITT,272,Jackson Independent,"",---District Total---,272,"","",KVEC,904,PS,7,10,1,0,1,0,0,0,0,1,1,0,0,0,0,0,0,0,0,0,9,6,15,17
20192020,013,BREATHITT,272,Jackson Independent,"",---District Total---,272,"","",KVEC,904,KG,16,13,0,0,0,0,0,0,0,0,0,0,0,0,0,0,0,0,0,0,13,16,29,29
20192020,013,BREATHITT,272,Jackson Independent,"",---District Total---,272,"","",KVEC,904,01,12,15,0,0,0,0,0,0,0,0,0,0,0,0,0,0,0,0,0,0,15,12,27,27
20192020,013,BREATHITT,272,Jackson Independent,"",---District Total---,272,"","",KVEC,904,02,11,15,0,0,0,0,0,0,0,0,0,0,0,0,0,0,0,0,0,0,15,11,26,26
20192020,013,BREATHITT,272,Jackson Independent,"",---District Total---,272,"","",KVEC,904,03,11,14,0,0,0,0,0,0,0,1,1,0,0,0,0,0,0,0,0,0,14,10,24,25
20192020,013,BREATHITT,272,Jackson Independent,"",---District Total---,272,"","",KVEC,904,04,8,20,0,0,0,0,0,0,0,0,0,0,0,0,0,0,0,0,0,0,20,8,28,28
20192020,013,BREATHITT,272,Jackson Independent,"",---District Total---,272,"","",KVEC,904,05,7,14,0,0,0,0,0,0,0,0,0,0,0,0,0,0,0,0,0,0,14,7,21,21
20192020,013,BREATHITT,272,Jackson Independent,"",---District Total---,272,"","",KVEC,904,06,15,5,0,0,0,0,0,0,0,1,1,0,0,0,0,0,0,0,0,0,5,14,19,20
20192020,013,BREATHITT,272,Jackson Independent,"",---District Total---,272,"","",KVEC,904,07,16,8,0,0,0,0,0,0,0,0,0,0,0,0,0,0,0,0,0,0,8,16,24,24
20192020,013,BREATHITT,272,Jackson Independent,"",---District Total---,272,"","",KVEC,904,08,17,7,0,0,0,0,0,0,1,0,1,0,0,0,0,0,0,0,0,0,6,17,23,24
20192020,013,BREATHITT,272,Jackson Independent,"",---District Total---,272,"","",KVEC,904,09,10,11,0,0,0,0,0,0,1,0,1,0,0,0,0,0,0,0,0,0,10,10,20,21
20192020,013,BREATHITT,272,Jackson Independent,"",---District Total---,272,"","",KVEC,904,10,13,11,0,0,0,0,0,0,0,0,0,0,0,0,0,0,0,0,0,0,11,13,24,24
20192020,013,BREATHITT,272,Jackson Independent,"",---District Total---,272,"","",KVEC,904,11,10,11,0,0,0,0,0,0,0,0,0,0,0,0,0,0,0,0,0,0,11,10,21,21
20192020,013,BREATHITT,272,Jackson Independent,011,Jackson City School,272011,013272011,210291001719,KVEC,904,11,10,11,0,0,0,0,0,0,0,0,0,0,0,0,0,0,0,0,0,0,11,10,21,21
20192020,013,BREATHITT,272,Jackson Independent,011,Jackson City School,272011,013272011,210291001719,KVEC,904,All Students,154,156,1,0,1,0,0,0,2,2,4,0,0,0,0,0,0,0,0,0,153,152,305,310
20192020,013,BREATHITT,272,Jackson Independent,011,Jackson City School,272011,013272011,210291001719,KVEC,904,PS,7,10,1,0,1,0,0,0,0,1,1,0,0,0,0,0,0,0,0,0,9,6,15,17
20192020,013,BREATHITT,272,Jackson Independent,011,Jackson City School,272011,013272011,210291001719,KVEC,904,KG,16,13,0,0,0,0,0,0,0,0,0,0,0,0,0,0,0,0,0,0,13,16,29,29
20192020,013,BREATHITT,272,Jackson Independent,011,Jackson City School,272011,013272011,210291001719,KVEC,904,01,12,15,0,0,0,0,0,0,0,0,0,0,0,0,0,0,0,0,0,0,15,12,27,27
20192020,013,BREATHITT,272,Jackson Independent,011,Jackson City School,272011,013272011,210291001719,KVEC,904,02,11,15,0,0,0,0,0,0,0,0,0,0,0,0,0,0,0,0,0,0,15,11,26,26
20192020,013,BREATHITT,272,Jackson Independent,011,Jackson City School,272011,013272011,210291001719,KVEC,904,03,11,14,0,0,0,0,0,0,0,1,1,0,0,0,0,0,0,0,0,0,14,10,24,25
20192020,013,BREATHITT,272,Jackson Independent,011,Jackson City School,272011,013272011,210291001719,KVEC,904,04,8,20,0,0,0,0,0,0,0,0,0,0,0,0,0,0,0,0,0,0,20,8,28,28
20192020,013,BREATHITT,272,Jackson Independent,011,Jackson City School,272011,013272011,210291001719,KVEC,904,05,7,14,0,0,0,0,0,0,0,0,0,0,0,0,0,0,0,0,0,0,14,7,21,21
20192020,013,BREATHITT,272,Jackson Independent,011,Jackson City School,272011,013272011,210291001719,KVEC,904,06,15,5,0,0,0,0,0,0,0,1,1,0,0,0,0,0,0,0,0,0,5,14,19,20
20192020,013,BREATHITT,272,Jackson Independent,011,Jackson City School,272011,013272011,210291001719,KVEC,904,07,16,8,0,0,0,0,0,0,0,0,0,0,0,0,0,0,0,0,0,0,8,16,24,24
20192020,013,BREATHITT,272,Jackson Independent,011,Jackson City School,272011,013272011,210291001719,KVEC,904,08,17,7,0,0,0,0,0,0,1,0,1,0,0,0,0,0,0,0,0,0,6,17,23,24
20192020,013,BREATHITT,272,Jackson Independent,011,Jackson City School,272011,013272011,210291001719,KVEC,904,09,10,11,0,0,0,0,0,0,1,0,1,0,0,0,0,0,0,0,0,0,10,10,20,21
20192020,013,BREATHITT,272,Jackson Independent,011,Jackson City School,272011,013272011,210291001719,KVEC,904,10,13,11,0,0,0,0,0,0,0,0,0,0,0,0,0,0,0,0,0,0,11,13,24,24
20192020,013,BREATHITT,272,Jackson Independent,011,Jackson City School,272011,013272011,210291001719,KVEC,904,12,8,12,1,0,1,0,0,0,0,0,0,0,0,0,0,0,0,0,0,0,11,8,19,20
20192020,056,JEFFERSON,275,Jefferson County,"",---District Total---,275,"","","",909,KG,3669,3863,1316,1290,2606,8,9,17,170,178,348,495,444,939,3,5,8,265,246,511,1606,1497,3103,7532
20192020,056,JEFFERSON,275,Jefferson County,"",---District Total---,275,"","","",909,All Students,46579,48497,17543,17141,34684,49,66,115,2168,2048,4216,6073,5654,11727,57,82,139,2427,2455,4882,20180,19133,39313,95076
20192020,056,JEFFERSON,275,Jefferson County,"",---District Total---,275,"","","",909,PS,1503,1904,812,744,1556,2,0,2,110,106,216,269,213,482,2,0,2,136,86,222,573,354,927,3407
20192020,056,JEFFERSON,275,Jefferson County,"",---District Total---,275,"","","",909,01,3589,3797,1307,1230,2537,3,6,9,228,187,415,503,472,975,5,3,8,272,243,515,1479,1448,2927,7386
20192020,056,JEFFERSON,275,Jefferson County,"",---District Total---,275,"","","",909,02,3113,3291,1144,1052,2196,4,2,6,177,174,351,421,382,803,3,8,11,210,198,408,1332,1297,2629,6404
20192020,056,JEFFERSON,275,Jefferson County,"",---District Total---,275,"","","",909,03,3681,3808,1338,1328,2666,2,6,8,178,155,333,486,497,983,7,7,14,235,230,465,1562,1458,3020,7489
20192020,056,JEFFERSON,275,Jefferson County,"",---District Total---,275,"","","",909,04,3653,3818,1344,1353,2697,8,6,14,161,163,324,524,479,1003,4,9,13,220,255,475,1557,1388,2945,7471
20192020,056,JEFFERSON,275,Jefferson County,"",---District Total---,275,"","","",909,05,3704,3880,1469,1365,2834,0,4,4,152,176,328,503,436,939,2,4,6,228,225,453,1526,1494,3020,7584
20192020,056,JEFFERSON,275,Jefferson County,"",---District Total---,275,"","","",909,06,3587,3874,1438,1389,2827,2,5,7,158,131,289,528,484,1012,7,5,12,200,194,394,1541,1379,2920,7461
20192020,056,JEFFERSON,275,Jefferson County,"",---District Total---,275,"","","",909,07,3636,3868,1439,1421,2860,5,4,9,167,133,300,456,462,918,2,5,7,208,213,421,1591,1398,2989,7504
20192020,056,JEFFERSON,275,Jefferson County,"",---District Total---,275,"","","",909,08,3483,3750,1402,1321,2723,5,6,11,152,161,313,460,414,874,3,6,9,163,185,348,1565,1390,2955,7233
20192020,056,JEFFERSON,275,Jefferson County,"",---District Total---,275,"","","",909,09,3873,4103,1564,1516,3080,3,3,6,164,144,308,527,442,969,7,8,15,145,151,296,1693,1609,3302,7976
20192020,056,JEFFERSON,275,Jefferson County,"",---District Total---,275,"","","",909,10,3626,3671,1333,1339,2672,4,5,9,166,153,319,423,446,869,3,9,12,95,104,199,1647,1570,3217,7297
20192020,056,JEFFERSON,275,Jefferson County,"",---District Total---,275,"","","",909,11,3405,3226,1170,1249,2419,2,6,8,150,145,295,347,349,696,9,8,17,97,104,201,1451,1544,2995,6631
20192020,056,JEFFERSON,275,Jefferson County,"",---District Total---,275,"","","",909,12,3504,3410,1225,1264,2489,3,4,7,141,146,287,395,344,739,2,5,7,85,107,192,1559,1634,3193,6914
20192020,056,JEFFERSON,275,Jefferson County,"",---District Total---,275,"","","",909,14,56,138,54,24,78,0,0,0,4,2,6,5,3,8,0,0,0,4,0,4,71,27,98,194
20192020,056,JEFFERSON,275,Jefferson County,004,Camp Taylor Elementary,275004,056275004,210299000623,"",909,All Students,225,253,67,47,114,0,0,0,5,5,10,59,46,105,0,2,2,13,12,25,109,113,222,478
20192020,056,JEFFERSON,275,Jefferson County,004,Camp Taylor Elementary,275004,056275004,210299000623,"",909,KG,47,45,12,9,21,0,0,0,0,1,1,13,9,22,0,0,0,0,2,2,20,26,46,92
20192020,056,JEFFERSON,275,Jefferson County,004,Camp Taylor Elementary,275004,056275004,210299000623,"",909,01,44,42,10,9,19,0,0,0,0,0,0,13,6,19,0,1,1,2,2,4,17,26,43,86
20192020,056,JEFFERSON,275,Jefferson County,004,Camp Taylor Elementary,275004,056275004,210299000623,"",909,02,28,42,12,10,22,0,0,0,1,0,1,7,6,13,0,0,0,6,1,7,16,11,27,70
20192020,056,JEFFERSON,275,Jefferson County,004,Camp Taylor Elementary,275004,056275004,210299000623,"",909,03,43,35,9,9,18,0,0,0,3,0,3,7,10,17,0,1,1,1,4,5,15,19,34,78
20192020,056,JEFFERSON,275,Jefferson County,004,Camp Taylor Elementary,275004,056275004,210299000623,"",909,04,31,48,12,4,16,0,0,0,0,2,2,7,9,16,0,0,0,2,0,2,27,16,43,79
20192020,056,JEFFERSON,275,Jefferson County,004,Camp Taylor Elementary,275004,056275004,210299000623,"",909,05,32,41,12,6,18,0,0,0,1,2,3,12,6,18,0,0,0,2,3,5,14,15,29,73
20192020,056,JEFFERSON,275,Jefferson County,005,Cane Run Elementary,275005,056275005,210299000624,"",909,05,32,26,16,28,44,0,0,0,1,0,1,2,4,6,0,0,0,2,0,2,5,0,5,58
20192020,056,JEFFERSON,275,Jefferson County,005,Cane Run Elementary,275005,056275005,210299000624,"",909,04,31,29,24,26,50,0,0,0,0,0,0,1,0,1,0,0,0,2,3,5,2,2,4,60
20192020,056,JEFFERSON,275,Jefferson County,005,Cane Run Elementary,275005,056275005,210299000624,"",909,All Students,180,181,132,156,288,0,0,0,1,0,1,10,10,20,0,0,0,10,8,18,28,6,34,361
20192020,056,JEFFERSON,275,Jefferson County,005,Cane Run Elementary,275005,056275005,210299000624,"",909,PS,20,20,17,18,35,0,0,0,0,1,1,1,0,1,0,0,0,1,1,2,1,0,1,40
20192020,056,JEFFERSON,275,Jefferson County,005,Cane Run Elementary,275005,056275005,210299000624,"",909,KG,31,43,34,26,60,0,0,0,0,0,0,3,2,5,0,0,0,1,2,3,5,1,6,74
20192020,056,JEFFERSON,275,Jefferson County,005,Cane Run Elementary,275005,056275005,210299000624,"",909,01,34,31,22,28,50,0,0,0,0,0,0,3,3,6,0,0,0,1,2,3,5,1,6,65
20192020,056,JEFFERSON,275,Jefferson County,005,Cane Run Elementary,275005,056275005,210299000624,"",909,02,22,18,11,18,29,0,0,0,0,0,0,0,1,1,0,0,0,3,1,4,4,2,6,40
20192020,056,JEFFERSON,275,Jefferson County,005,Cane Run Elementary,275005,056275005,210299000624,"",909,03,30,34,25,30,55,0,0,0,0,0,0,1,0,1,0,0,0,1,0,1,7,0,7,64
20192020,056,JEFFERSON,275,Jefferson County,007,Eastern High,275007,056275007,210299000625,"",909,12,192,230,51,36,87,0,0,0,10,12,22,13,18,31,0,1,1,6,5,11,150,120,270,422
20192020,056,JEFFERSON,275,Jefferson County,007,Eastern High,275007,056275007,210299000625,"",909,All Students,932,1119,233,176,409,0,0,0,56,55,111,84,80,164,2,2,4,38,34,72,706,585,1291,2051
20192020,056,JEFFERSON,275,Jefferson County,007,Eastern High,275007,056275007,210299000625,"",909,09,275,329,71,62,133,0,0,0,12,20,32,36,19,55,1,0,1,12,13,25,197,161,358,604
20192020,056,JEFFERSON,275,Jefferson County,007,Eastern High,275007,056275007,210299000625,"",909,10,232,281,58,35,93,0,0,0,18,12,30,17,22,39,0,1,1,8,8,16,180,154,334,513
20192020,056,JEFFERSON,275,Jefferson County,007,Eastern High,275007,056275007,210299000625,"",909,11,233,277,53,43,96,0,0,0,16,11,27,18,21,39,1,0,1,11,8,19,178,150,328,510
20192020,056,JEFFERSON,275,Jefferson County,007,Eastern High,275007,056275007,210299000625,"",909,14,0,2,0,0,0,0,0,0,0,0,0,0,0,0,0,0,0,1,0,1,1,0,1,2
20192020,056,JEFFERSON,275,Jefferson County,010,Fairdale Elementary,275010,056275010,210299000626,"",909,All Students,276,342,58,39,97,1,1,2,11,14,25,99,86,185,0,1,1,18,18,36,155,117,272,618
20192020,056,JEFFERSON,275,Jefferson County,010,Fairdale Elementary,275010,056275010,210299000626,"",909,05,51,67,10,6,16,0,0,0,5,4,9,14,21,35,0,1,1,4,4,8,34,15,49,118
20192020,056,JEFFERSON,275,Jefferson County,010,Fairdale Elementary,275010,056275010,210299000626,"",909,KG,51,54,9,10,19,0,0,0,1,0,1,21,12,33,0,0,0,3,3,6,20,26,46,105
20192020,056,JEFFERSON,275,Jefferson County,010,Fairdale Elementary,275010,056275010,210299000626,"",909,01,58,48,8,7,15,1,0,1,1,5,6,12,18,30,0,0,0,2,2,4,24,26,50,106
20192020,056,JEFFERSON,275,Jefferson County,010,Fairdale Elementary,275010,056275010,210299000626,"",909,02,34,44,8,4,12,0,0,0,1,4,5,15,9,24,0,0,0,1,4,5,19,13,32,78
20192020,056,JEFFERSON,275,Jefferson County,010,Fairdale Elementary,275010,056275010,210299000626,"",909,03,39,61,11,6,17,0,0,0,1,1,2,15,7,22,0,0,0,4,0,4,30,25,55,100
20192020,056,JEFFERSON,275,Jefferson County,010,Fairdale Elementary,275010,056275010,210299000626,"",909,04,43,68,12,6,18,0,1,1,2,0,2,22,19,41,0,0,0,4,5,9,28,12,40,111
20192020,056,JEFFERSON,275,Jefferson County,011,Fern Creek Elementary,275011,056275011,210299000627,"",909,03,50,48,10,12,22,0,0,0,7,3,10,9,7,16,0,0,0,1,2,3,21,26,47,98
20192020,056,JEFFERSON,275,Jefferson County,011,Fern Creek Elementary,275011,056275011,210299000627,"",909,05,56,64,20,16,36,0,0,0,5,4,9,8,9,17,0,0,0,3,4,7,28,23,51,120
20192020,056,JEFFERSON,275,Jefferson County,011,Fern Creek Elementary,275011,056275011,210299000627,"",909,All Students,337,351,101,88,189,0,0,0,31,22,53,53,71,124,0,0,0,20,21,41,146,135,281,688
20192020,056,JEFFERSON,275,Jefferson County,011,Fern Creek Elementary,275011,056275011,210299000627,"",909,KG,64,66,20,18,38,0,0,0,6,3,9,8,20,28,0,0,0,4,4,8,28,19,47,130
20192020,056,JEFFERSON,275,Jefferson County,011,Fern Creek Elementary,275011,056275011,210299000627,"",909,01,67,60,14,16,30,0,0,0,8,6,14,13,10,23,0,0,0,4,3,7,21,32,53,127
20192020,056,JEFFERSON,275,Jefferson County,011,Fern Creek Elementary,275011,056275011,210299000627,"",909,02,43,55,20,14,34,0,0,0,4,3,7,7,8,15,0,0,0,5,5,10,19,13,32,98
20192020,056,JEFFERSON,275,Jefferson County,011,Fern Creek Elementary,275011,056275011,210299000627,"",909,04,57,58,17,12,29,0,0,0,1,3,4,8,17,25,0,0,0,3,3,6,29,22,51,115
20192020,056,JEFFERSON,275,Jefferson County,012,Fern Creek High,275012,056275012,210299000628,"",909,12,161,225,90,59,149,0,0,0,18,12,30,31,17,48,1,0,1,7,5,12,78,68,146,386
20192020,056,JEFFERSON,275,Jefferson County,012,Fern Creek High,275012,056275012,210299000628,"",909,14,1,3,2,1,3,0,0,0,1,0,1,0,0,0,0,0,0,0,0,0,0,0,0,4
20192020,056,JEFFERSON,275,Jefferson County,012,Fern Creek High,275012,056275012,210299000628,"",909,All Students,759,954,364,288,652,1,0,1,65,38,103,138,111,249,3,0,3,35,30,65,348,292,640,1713
20192020,056,JEFFERSON,275,Jefferson County,012,Fern Creek High,275012,056275012,210299000628,"",909,09,217,254,106,88,194,1,0,1,10,6,16,35,31,66,2,0,2,11,14,25,89,78,167,471
20192020,056,JEFFERSON,275,Jefferson County,012,Fern Creek High,275012,056275012,210299000628,"",909,10,188,250,86,72,158,0,0,0,16,11,27,31,35,66,0,0,0,13,4,17,104,66,170,438
20192020,056,JEFFERSON,275,Jefferson County,012,Fern Creek High,275012,056275012,210299000628,"",909,11,192,222,80,68,148,0,0,0,20,9,29,41,28,69,0,0,0,4,7,11,77,80,157,414
20192020,056,JEFFERSON,275,Jefferson County,013,Greathouse/Shryock Traditional,275013,056275013,210299000629,"",909,02,46,50,9,7,16,0,0,0,10,7,17,3,3,6,0,0,0,6,2,8,22,27,49,96
20192020,056,JEFFERSON,275,Jefferson County,013,Greathouse/Shryock Traditional,275013,056275013,210299000629,"",909,All Students,293,303,54,44,98,0,0,0,73,78,151,14,16,30,0,0,0,16,10,26,146,145,291,596
20192020,056,JEFFERSON,275,Jefferson County,013,Greathouse/Shryock Traditional,275013,056275013,210299000629,"",909,KG,44,48,12,3,15,0,0,0,12,16,28,4,4,8,0,0,0,1,2,3,19,19,38,92
20192020,056,JEFFERSON,275,Jefferson County,013,Greathouse/Shryock Traditional,275013,056275013,210299000629,"",909,01,38,54,13,5,18,0,0,0,16,16,32,2,0,2,0,0,0,0,0,0,23,17,40,92
20192020,056,JEFFERSON,275,Jefferson County,013,Greathouse/Shryock Traditional,275013,056275013,210299000629,"",909,03,53,41,7,9,16,0,0,0,9,13,22,0,3,3,0,0,0,3,1,4,22,27,49,94
20192020,056,JEFFERSON,275,Jefferson County,013,Greathouse/Shryock Traditional,275013,056275013,210299000629,"",909,04,53,53,6,7,13,0,0,0,17,14,31,3,1,4,0,0,0,2,3,5,25,28,53,106
20192020,056,JEFFERSON,275,Jefferson County,013,Greathouse/Shryock Traditional,275013,056275013,210299000629,"",909,05,59,57,7,13,20,0,0,0,9,12,21,2,5,7,0,0,0,4,2,6,35,27,62,116
20192020,056,JEFFERSON,275,Jefferson County,014,Greenwood Elementary,275014,056275014,210299000630,"",909,All Students,232,238,71,78,149,0,0,0,3,1,4,22,11,33,0,0,0,25,20,45,117,122,239,470
20192020,056,JEFFERSON,275,Jefferson County,014,Greenwood Elementary,275014,056275014,210299000630,"",909,KG,36,36,13,17,30,0,0,0,0,1,1,5,0,5,0,0,0,2,0,2,16,18,34,72
20192020,056,JEFFERSON,275,Jefferson County,014,Greenwood Elementary,275014,056275014,210299000630,"",909,01,37,45,12,12,24,0,0,0,1,0,1,4,2,6,0,0,0,3,2,5,25,21,46,82
20192020,056,JEFFERSON,275,Jefferson County,014,Greenwood Elementary,275014,056275014,210299000630,"",909,02,38,33,12,14,26,0,0,0,1,0,1,5,2,7,0,0,0,1,4,5,14,18,32,71
20192020,056,JEFFERSON,275,Jefferson County,014,Greenwood Elementary,275014,056275014,210299000630,"",909,03,28,45,8,9,17,0,0,0,1,0,1,3,1,4,0,0,0,8,2,10,25,16,41,73
20192020,056,JEFFERSON,275,Jefferson County,014,Greenwood Elementary,275014,056275014,210299000630,"",909,04,44,35,8,11,19,0,0,0,0,0,0,4,4,8,0,0,0,8,7,15,15,22,37,79
20192020,056,JEFFERSON,275,Jefferson County,014,Greenwood Elementary,275014,056275014,210299000630,"",909,05,49,44,18,15,33,0,0,0,0,0,0,1,2,3,0,0,0,3,5,8,22,27,49,93
20192020,056,JEFFERSON,275,Jefferson County,016,Tully Elementary,275016,056275016,210299000631,"",909,05,45,51,9,6,15,0,0,0,3,1,4,2,2,4,0,0,0,3,4,7,34,32,66,96
20192020,056,JEFFERSON,275,Jefferson County,016,Tully Elementary,275016,056275016,210299000631,"",909,04,56,56,6,8,14,0,0,0,1,3,4,4,5,9,0,0,0,4,4,8,41,36,77,112
20192020,056,JEFFERSON,275,Jefferson County,016,Tully Elementary,275016,056275016,210299000631,"",909,All Students,354,365,53,49,102,0,0,0,26,14,40,25,22,47,0,0,0,21,28,49,240,241,481,719
20192020,056,JEFFERSON,275,Jefferson County,016,Tully Elementary,275016,056275016,210299000631,"",909,PS,28,46,11,7,18,0,0,0,3,2,5,6,0,6,0,0,0,8,3,11,18,16,34,74
20192020,056,JEFFERSON,275,Jefferson County,016,Tully Elementary,275016,056275016,210299000631,"",909,KG,78,59,7,12,19,0,0,0,7,2,9,3,3,6,0,0,0,3,7,10,39,54,93,137
20192020,056,JEFFERSON,275,Jefferson County,016,Tully Elementary,275016,056275016,210299000631,"",909,01,54,67,12,7,19,0,0,0,5,1,6,3,5,8,0,0,0,7,5,12,40,36,76,121
20192020,056,JEFFERSON,275,Jefferson County,016,Tully Elementary,275016,056275016,210299000631,"",909,02,61,60,7,8,15,0,0,0,8,5,13,5,4,9,0,0,0,2,5,7,38,39,77,121
20192020,056,JEFFERSON,275,Jefferson County,016,Tully Elementary,275016,056275016,210299000631,"",909,03,60,72,12,8,20,0,0,0,2,2,4,8,3,11,0,0,0,2,3,5,48,44,92,132
20192020,056,JEFFERSON,275,Jefferson County,018,Atherton High,275018,056275018,210299000632,"",909,12,183,142,27,32,59,0,0,0,7,8,15,15,19,34,0,0,0,1,11,12,92,113,205,325
20192020,056,JEFFERSON,275,Jefferson County,018,Atherton High,275018,056275018,210299000632,"",909,All Students,764,621,109,150,259,0,0,0,23,26,49,40,68,108,2,1,3,21,26,47,426,493,919,1385
20192020,056,JEFFERSON,275,Jefferson County,018,Atherton High,275018,056275018,210299000632,"",909,09,190,161,28,49,77,0,0,0,5,6,11,6,12,18,1,0,1,6,6,12,115,117,232,351
20192020,056,JEFFERSON,275,Jefferson County,018,Atherton High,275018,056275018,210299000632,"",909,10,207,176,27,37,64,0,0,0,6,7,13,6,18,24,1,1,2,9,4,13,127,140,267,383
20192020,056,JEFFERSON,275,Jefferson County,018,Atherton High,275018,056275018,210299000632,"",909,11,183,139,27,32,59,0,0,0,5,5,10,13,19,32,0,0,0,5,5,10,89,122,211,322
20192020,056,JEFFERSON,275,Jefferson County,018,Atherton High,275018,056275018,210299000632,"",909,14,1,3,0,0,0,0,0,0,0,0,0,0,0,0,0,0,0,0,0,0,3,1,4,4
20192020,056,JEFFERSON,275,Jefferson County,019,The Brook-Dupont,275019,056275019,210299001629,"",909,05,2,1,1,0,1,0,0,0,0,0,0,0,0,0,0,0,0,0,0,0,0,2,2,3
20192020,056,JEFFERSON,275,Jefferson County,019,The Brook-Dupont,275019,056275019,210299001629,"",909,All Students,5,3,1,0,1,0,0,0,0,0,0,0,0,0,0,0,0,0,0,0,2,5,7,8
20192020,056,JEFFERSON,275,Jefferson County,019,The Brook-Dupont,275019,056275019,210299001629,"",909,01,1,0,0,0,0,0,0,0,0,0,0,0,0,0,0,0,0,0,0,0,0,1,1,1
20192020,056,JEFFERSON,275,Jefferson County,019,The Brook-Dupont,275019,056275019,210299001629,"",909,02,1,2,0,0,0,0,0,0,0,0,0,0,0,0,0,0,0,0,0,0,2,1,3,3
20192020,056,JEFFERSON,275,Jefferson County,019,The Brook-Dupont,275019,056275019,210299001629,"",909,06,1,0,0,0,0,0,0,0,0,0,0,0,0,0,0,0,0,0,0,0,0,1,1,1
20192020,056,JEFFERSON,275,Jefferson County,020,The Brook-KMI,275020,056275020,210299001474,"",909,10,6,1,0,1,1,0,0,0,0,0,0,0,1,1,0,0,0,0,0,0,1,4,5,7
20192020,056,JEFFERSON,275,Jefferson County,020,The Brook-KMI,275020,056275020,210299001474,"",909,All Students,12,11,2,2,4,0,0,0,0,0,0,0,3,3,0,0,0,0,0,0,9,7,16,23
20192020,056,JEFFERSON,275,Jefferson County,020,The Brook-KMI,275020,056275020,210299001474,"",909,07,2,1,0,0,0,0,0,0,0,0,0,0,0,0,0,0,0,0,0,0,1,2,3,3
20192020,056,JEFFERSON,275,Jefferson County,020,The Brook-KMI,275020,056275020,210299001474,"",909,08,1,3,0,0,0,0,0,0,0,0,0,0,0,0,0,0,0,0,0,0,3,1,4,4
20192020,056,JEFFERSON,275,Jefferson County,020,The Brook-KMI,275020,056275020,210299001474,"",909,09,2,3,1,1,2,0,0,0,0,0,0,0,1,1,0,0,0,0,0,0,2,0,2,5
20192020,056,JEFFERSON,275,Jefferson County,020,The Brook-KMI,275020,056275020,210299001474,"",909,11,1,3,1,0,1,0,0,0,0,0,0,0,1,1,0,0,0,0,0,0,2,0,2,4
20192020,056,JEFFERSON,275,Jefferson County,022,Medora Elementary,275022,056275022,210299000633,"",909,04,38,47,8,6,14,0,0,0,0,0,0,5,6,11,0,0,0,4,2,6,30,24,54,85
20192020,056,JEFFERSON,275,Jefferson County,022,Medora Elementary,275022,056275022,210299000633,"",909,All Students,239,228,32,18,50,0,0,0,0,0,0,18,24,42,1,0,1,18,18,36,159,179,338,467
20192020,056,JEFFERSON,275,Jefferson County,022,Medora Elementary,275022,056275022,210299000633,"",909,KG,39,38,5,4,9,0,0,0,0,0,0,1,4,5,0,0,0,5,3,8,27,28,55,77
20192020,056,JEFFERSON,275,Jefferson County,022,Medora Elementary,275022,056275022,210299000633,"",909,01,38,32,2,1,3,0,0,0,0,0,0,4,2,6,0,0,0,3,2,5,23,33,56,70
20192020,056,JEFFERSON,275,Jefferson County,022,Medora Elementary,275022,056275022,210299000633,"",909,02,36,39,4,2,6,0,0,0,0,0,0,2,2,4,0,0,0,2,5,7,31,27,58,75
20192020,056,JEFFERSON,275,Jefferson County,022,Medora Elementary,275022,056275022,210299000633,"",909,03,39,31,3,3,6,0,0,0,0,0,0,2,6,8,1,0,1,1,3,4,24,27,51,70
20192020,056,JEFFERSON,275,Jefferson County,022,Medora Elementary,275022,056275022,210299000633,"",909,05,49,41,10,2,12,0,0,0,0,0,0,4,4,8,0,0,0,3,3,6,24,40,64,90
20192020,056,JEFFERSON,275,Jefferson County,024,Middletown Elementary,275024,056275024,210299000634,"",909,03,52,53,10,15,25,0,0,0,4,4,8,4,1,5,0,0,0,7,5,12,28,27,55,105
20192020,056,JEFFERSON,275,Jefferson County,024,Middletown Elementary,275024,056275024,210299000634,"",909,All Students,269,278,50,61,111,0,0,0,13,17,30,20,22,42,0,0,0,24,22,46,171,147,318,547
20192020,056,JEFFERSON,275,Jefferson County,024,Middletown Elementary,275024,056275024,210299000634,"",909,KG,52,47,7,12,19,0,0,0,2,4,6,5,4,9,0,0,0,4,8,12,29,24,53,99
20192020,056,JEFFERSON,275,Jefferson County,024,Middletown Elementary,275024,056275024,210299000634,"",909,01,36,57,11,9,20,0,0,0,2,1,3,2,0,2,0,0,0,4,2,6,38,24,62,93
20192020,056,JEFFERSON,275,Jefferson County,024,Middletown Elementary,275024,056275024,210299000634,"",909,02,35,32,5,8,13,0,0,0,1,3,4,4,0,4,0,0,0,1,3,4,21,21,42,67
20192020,056,JEFFERSON,275,Jefferson County,024,Middletown Elementary,275024,056275024,210299000634,"",909,04,47,45,6,10,16,0,0,0,2,1,3,4,12,16,0,0,0,3,2,5,30,22,52,92
20192020,056,JEFFERSON,275,Jefferson County,024,Middletown Elementary,275024,056275024,210299000634,"",909,05,47,44,11,7,18,0,0,0,2,4,6,1,5,6,0,0,0,5,2,7,25,29,54,91
20192020,056,JEFFERSON,275,Jefferson County,027,Okolona Elementary,275027,056275027,210299000635,"",909,05,26,28,7,9,16,0,0,0,0,0,0,4,6,10,0,0,0,4,1,5,13,10,23,54
20192020,056,JEFFERSON,275,Jefferson County,027,Okolona Elementary,275027,056275027,210299000635,"",909,All Students,159,149,32,39,71,0,0,0,3,2,5,29,35,64,0,0,0,17,12,29,68,71,139,308
20192020,056,JEFFERSON,275,Jefferson County,027,Okolona Elementary,275027,056275027,210299000635,"",909,PS,25,30,2,7,9,0,0,0,3,2,5,11,8,19,0,0,0,5,1,6,9,7,16,55
20192020,056,JEFFERSON,275,Jefferson County,027,Okolona Elementary,275027,056275027,210299000635,"",909,KG,26,29,5,7,12,0,0,0,1,0,1,6,5,11,0,0,0,3,2,5,14,12,26,55
20192020,056,JEFFERSON,275,Jefferson County,027,Okolona Elementary,275027,056275027,210299000635,"",909,01,29,23,6,6,12,0,0,0,1,1,2,2,5,7,0,0,0,2,3,5,12,14,26,52
20192020,056,JEFFERSON,275,Jefferson County,027,Okolona Elementary,275027,056275027,210299000635,"",909,02,23,23,6,6,12,0,0,0,0,0,0,6,5,11,0,0,0,4,3,7,7,9,16,46
20192020,056,JEFFERSON,275,Jefferson County,027,Okolona Elementary,275027,056275027,210299000635,"",909,03,28,20,2,5,7,0,0,0,1,1,2,3,8,11,0,0,0,2,0,2,12,14,26,48
20192020,056,JEFFERSON,275,Jefferson County,027,Okolona Elementary,275027,056275027,210299000635,"",909,04,27,26,6,6,12,0,0,0,0,0,0,8,6,14,0,0,0,2,3,5,10,12,22,53
20192020,056,JEFFERSON,275,Jefferson County,028,Boys & Girls Haven,275028,056275028,210299001475,"",909,11,0,1,0,0,0,0,0,0,0,0,0,0,0,0,0,0,0,0,0,0,1,0,1,1
20192020,056,JEFFERSON,275,Jefferson County,028,Boys & Girls Haven,275028,056275028,210299001475,"",909,All Students,0,21,3,0,3,0,0,0,0,0,0,3,0,3,0,0,0,0,0,0,15,0,15,21
20192020,056,JEFFERSON,275,Jefferson County,028,Boys & Girls Haven,275028,056275028,210299001475,"",909,06,0,3,0,0,0,0,0,0,0,0,0,0,0,0,0,0,0,0,0,0,3,0,3,3
20192020,056,JEFFERSON,275,Jefferson County,028,Boys & Girls Haven,275028,056275028,210299001475,"",909,07,0,3,0,0,0,0,0,0,0,0,0,0,0,0,0,0,0,0,0,0,3,0,3,3
20192020,056,JEFFERSON,275,Jefferson County,028,Boys & Girls Haven,275028,056275028,210299001475,"",909,08,0,2,0,0,0,0,0,0,0,0,0,0,0,0,0,0,0,0,0,0,2,0,2,2
20192020,056,JEFFERSON,275,Jefferson County,028,Boys & Girls Haven,275028,056275028,210299001475,"",909,09,0,2,1,0,1,0,0,0,0,0,0,0,0,0,0,0,0,0,0,0,1,0,1,2
20192020,056,JEFFERSON,275,Jefferson County,028,Boys & Girls Haven,275028,056275028,210299001475,"",909,10,0,9,2,0,2,0,0,0,0,0,0,3,0,3,0,0,0,0,0,0,4,0,4,9
20192020,056,JEFFERSON,275,Jefferson County,028,Boys & Girls Haven,275028,056275028,210299001475,"",909,12,0,1,0,0,0,0,0,0,0,0,0,0,0,0,0,0,0,0,0,0,1,0,1,1
20192020,056,JEFFERSON,275,Jefferson County,029,St Joseph Children's Home,275029,056275029,210299001633,"",909,04,3,0,0,0,0,0,0,0,0,0,0,0,0,0,0,0,0,0,0,0,0,3,3,3
20192020,056,JEFFERSON,275,Jefferson County,029,St Joseph Children's Home,275029,056275029,210299001633,"",909,All Students,22,23,2,4,6,0,0,0,0,0,0,0,0,0,0,0,0,4,0,4,17,18,35,45
20192020,056,JEFFERSON,275,Jefferson County,029,St Joseph Children's Home,275029,056275029,210299001633,"",909,01,1,1,0,0,0,0,0,0,0,0,0,0,0,0,0,0,0,0,0,0,1,1,2,2
20192020,056,JEFFERSON,275,Jefferson County,029,St Joseph Children's Home,275029,056275029,210299001633,"",909,02,2,1,0,1,1,0,0,0,0,0,0,0,0,0,0,0,0,0,0,0,1,1,2,3
20192020,056,JEFFERSON,275,Jefferson County,029,St Joseph Children's Home,275029,056275029,210299001633,"",909,03,1,3,0,0,0,0,0,0,0,0,0,0,0,0,0,0,0,1,0,1,2,1,3,4
20192020,056,JEFFERSON,275,Jefferson County,029,St Joseph Children's Home,275029,056275029,210299001633,"",909,05,6,6,1,1,2,0,0,0,0,0,0,0,0,0,0,0,0,1,0,1,4,5,9,12
20192020,056,JEFFERSON,275,Jefferson County,029,St Joseph Children's Home,275029,056275029,210299001633,"",909,06,3,6,0,0,0,0,0,0,0,0,0,0,0,0,0,0,0,2,0,2,4,3,7,9
20192020,056,JEFFERSON,275,Jefferson County,029,St Joseph Children's Home,275029,056275029,210299001633,"",909,07,6,3,0,2,2,0,0,0,0,0,0,0,0,0,0,0,0,0,0,0,3,4,7,9
20192020,056,JEFFERSON,275,Jefferson County,029,St Joseph Children's Home,275029,056275029,210299001633,"",909,08,0,3,1,0,1,0,0,0,0,0,0,0,0,0,0,0,0,0,0,0,2,0,2,3
20192020,056,JEFFERSON,275,Jefferson County,030,Liberty High,275030,056275030,210299001634,"",909,12,32,25,16,26,42,0,1,1,0,0,0,1,0,1,0,0,0,0,1,1,8,4,12,57
20192020,056,JEFFERSON,275,Jefferson County,030,Liberty High,275030,056275030,210299001634,"",909,All Students,72,92,56,54,110,0,1,1,0,0,0,3,2,5,0,0,0,2,6,8,31,9,40,164
20192020,056,JEFFERSON,275,Jefferson County,030,Liberty High,275030,056275030,210299001634,"",909,08,6,12,5,3,8,0,0,0,0,0,0,0,0,0,0,0,0,0,2,2,7,1,8,18
20192020,056,JEFFERSON,275,Jefferson County,030,Liberty High,275030,056275030,210299001634,"",909,09,7,17,9,6,15,0,0,0,0,0,0,0,0,0,0,0,0,0,1,1,8,0,8,24
20192020,056,JEFFERSON,275,Jefferson County,030,Liberty High,275030,056275030,210299001634,"",909,10,14,16,12,8,20,0,0,0,0,0,0,0,1,1,0,0,0,1,1,2,3,4,7,30
20192020,056,JEFFERSON,275,Jefferson County,030,Liberty High,275030,056275030,210299001634,"",909,11,13,22,14,11,25,0,0,0,0,0,0,2,1,3,0,0,0,1,1,2,5,0,5,35
20192020,056,JEFFERSON,275,Jefferson County,031,Southern High,275031,056275031,210299000637,"",909,12,137,146,50,44,94,0,0,0,1,5,6,26,38,64,0,1,1,1,7,8,68,42,110,283
20192020,056,JEFFERSON,275,Jefferson County,031,Southern High,275031,056275031,210299000637,"",909,All Students,557,720,225,198,423,0,0,0,26,16,42,152,126,278,1,3,4,13,19,32,303,195,498,1277
20192020,056,JEFFERSON,275,Jefferson County,031,Southern High,275031,056275031,210299000637,"",909,09,150,178,52,58,110,0,0,0,5,4,9,44,30,74,0,1,1,5,7,12,72,50,122,328
20192020,056,JEFFERSON,275,Jefferson County,031,Southern High,275031,056275031,210299000637,"",909,10,132,210,65,46,111,0,0,0,11,5,16,49,27,76,1,0,1,3,3,6,81,51,132,342
20192020,056,JEFFERSON,275,Jefferson County,031,Southern High,275031,056275031,210299000637,"",909,11,138,185,57,50,107,0,0,0,9,2,11,33,31,64,0,1,1,4,2,6,82,52,134,323
20192020,056,JEFFERSON,275,Jefferson County,031,Southern High,275031,056275031,210299000637,"",909,14,0,1,1,0,1,0,0,0,0,0,0,0,0,0,0,0,0,0,0,0,0,0,0,1
20192020,056,JEFFERSON,275,Jefferson County,033,Valley High,275033,056275033,210299000639,"",909,12,100,96,36,35,71,0,0,0,0,1,1,3,4,7,0,0,0,1,6,7,56,54,110,196
20192020,056,JEFFERSON,275,Jefferson County,033,Valley High,275033,056275033,210299000639,"",909,All Students,416,401,153,159,312,0,2,2,5,2,7,18,20,38,0,2,2,8,15,23,217,216,433,817
20192020,056,JEFFERSON,275,Jefferson County,033,Valley High,275033,056275033,210299000639,"",909,11,106,97,39,44,83,0,1,1,2,0,2,6,7,13,0,1,1,3,2,5,47,51,98,203
20192020,056,JEFFERSON,275,Jefferson County,033,Valley High,275033,056275033,210299000639,"",909,09,101,108,37,50,87,0,1,1,3,1,4,3,2,5,0,0,0,3,4,7,62,43,105,209
20192020,056,JEFFERSON,275,Jefferson County,033,Valley High,275033,056275033,210299000639,"",909,14,2,6,1,1,2,0,0,0,0,0,0,0,0,0,0,0,0,0,0,0,5,1,6,8
20192020,056,JEFFERSON,275,Jefferson County,033,Valley High,275033,056275033,210299000639,"",909,10,107,94,40,29,69,0,0,0,0,0,0,6,7,13,0,1,1,1,3,4,47,67,114,201
20192020,056,JEFFERSON,275,Jefferson County,034,Waller-Williams Environmental,275034,056275034,210299001529,"",909,11,1,3,3,0,3,0,0,0,0,0,0,0,0,0,0,0,0,0,0,0,0,1,1,4
20192020,056,JEFFERSON,275,Jefferson County,034,Waller-Williams Environmental,275034,056275034,210299001529,"",909,All Students,18,120,74,13,87,0,0,0,0,0,0,7,0,7,0,0,0,10,0,10,29,5,34,138
20192020,056,JEFFERSON,275,Jefferson County,034,Waller-Williams Environmental,275034,056275034,210299001529,"",909,KG,0,1,1,0,1,0,0,0,0,0,0,0,0,0,0,0,0,0,0,0,0,0,0,1
20192020,056,JEFFERSON,275,Jefferson County,034,Waller-Williams Environmental,275034,056275034,210299001529,"",909,01,0,4,2,0,2,0,0,0,0,0,0,0,0,0,0,0,0,1,0,1,1,0,1,4
20192020,056,JEFFERSON,275,Jefferson County,034,Waller-Williams Environmental,275034,056275034,210299001529,"",909,02,0,6,5,0,5,0,0,0,0,0,0,0,0,0,0,0,0,1,0,1,0,0,0,6
20192020,056,JEFFERSON,275,Jefferson County,034,Waller-Williams Environmental,275034,056275034,210299001529,"",909,03,2,10,7,1,8,0,0,0,0,0,0,0,0,0,0,0,0,2,0,2,1,1,2,12
20192020,056,JEFFERSON,275,Jefferson County,034,Waller-Williams Environmental,275034,056275034,210299001529,"",909,04,2,8,4,1,5,0,0,0,0,0,0,0,0,0,0,0,0,0,0,0,4,1,5,10
20192020,056,JEFFERSON,275,Jefferson County,034,Waller-Williams Environmental,275034,056275034,210299001529,"",909,05,2,15,13,1,14,0,0,0,0,0,0,0,0,0,0,0,0,0,0,0,2,1,3,17
20192020,056,JEFFERSON,275,Jefferson County,034,Waller-Williams Environmental,275034,056275034,210299001529,"",909,06,3,25,15,2,17,0,0,0,0,0,0,2,0,2,0,0,0,4,0,4,4,1,5,28
20192020,056,JEFFERSON,275,Jefferson County,034,Waller-Williams Environmental,275034,056275034,210299001529,"",909,07,3,19,9,3,12,0,0,0,0,0,0,2,0,2,0,0,0,0,0,0,8,0,8,22
20192020,056,JEFFERSON,275,Jefferson County,034,Waller-Williams Environmental,275034,056275034,210299001529,"",909,08,2,8,5,2,7,0,0,0,0,0,0,2,0,2,0,0,0,0,0,0,1,0,1,10
20192020,056,JEFFERSON,275,Jefferson County,034,Waller-Williams Environmental,275034,056275034,210299001529,"",909,09,1,10,5,1,6,0,0,0,0,0,0,0,0,0,0,0,0,2,0,2,3,0,3,11
20192020,056,JEFFERSON,275,Jefferson County,034,Waller-Williams Environmental,275034,056275034,210299001529,"",909,10,1,7,3,1,4,0,0,0,0,0,0,1,0,1,0,0,0,0,0,0,3,0,3,8
20192020,056,JEFFERSON,275,Jefferson County,034,Waller-Williams Environmental,275034,056275034,210299001529,"",909,12,1,4,2,1,3,0,0,0,0,0,0,0,0,0,0,0,0,0,0,0,2,0,2,5
20192020,056,JEFFERSON,275,Jefferson County,037,Dawson Orman Education Center,275037,056275037,210299001774,"",909,All Students,0,0,0,0,0,0,0,0,0,0,0,0,0,0,0,0,0,0,0,0,0,0,0,0
20192020,056,JEFFERSON,275,Jefferson County,037,Dawson Orman Education Center,275037,056275037,210299001774,"",909,PS,137,156,91,99,190,1,0,1,3,3,6,6,7,13,0,0,0,16,11,27,39,17,56,293
20192020,056,JEFFERSON,275,Jefferson County,038,Breckinridge-Franklin Elementary,275038,056275038,210299001855,"",909,KG,41,35,22,26,48,0,0,0,0,1,1,3,3,6,0,1,1,3,0,3,7,10,17,76
20192020,056,JEFFERSON,275,Jefferson County,038,Breckinridge-Franklin Elementary,275038,056275038,210299001855,"",909,01,27,30,19,14,33,0,1,1,0,0,0,1,2,3,0,0,0,3,1,4,7,9,16,57
20192020,056,JEFFERSON,275,Jefferson County,038,Breckinridge-Franklin Elementary,275038,056275038,210299001855,"",909,02,15,26,13,10,23,0,0,0,0,0,0,2,1,3,1,0,1,5,1,6,5,3,8,41
20192020,056,JEFFERSON,275,Jefferson County,038,Breckinridge-Franklin Elementary,275038,056275038,210299001855,"",909,03,35,61,31,22,53,0,0,0,0,1,1,7,1,8,0,1,1,3,3,6,20,7,27,96
20192020,056,JEFFERSON,275,Jefferson County,038,Breckinridge-Franklin Elementary,275038,056275038,210299001855,"",909,05,35,42,27,21,48,0,1,1,0,1,1,0,1,1,0,0,0,2,3,5,13,8,21,77
20192020,056,JEFFERSON,275,Jefferson County,038,Breckinridge-Franklin Elementary,275038,056275038,210299001855,"",909,04,39,38,21,20,41,0,0,0,1,0,1,7,2,9,0,0,0,0,2,2,9,15,24,77
20192020,056,JEFFERSON,275,Jefferson County,038,Breckinridge-Franklin Elementary,275038,056275038,210299001855,"",909,All Students,192,232,133,113,246,0,2,2,1,3,4,20,10,30,1,2,3,16,10,26,61,52,113,424
20192020,056,JEFFERSON,275,Jefferson County,040,Barret Traditional Middle,275040,056275040,210299000641,"",909,07,111,99,22,32,54,0,0,0,4,6,10,4,10,14,0,0,0,3,6,9,66,57,123,210
20192020,056,JEFFERSON,275,Jefferson County,040,Barret Traditional Middle,275040,056275040,210299000641,"",909,All Students,331,300,75,95,170,0,0,0,11,20,31,19,21,40,0,1,1,8,15,23,187,179,366,631
20192020,056,JEFFERSON,275,Jefferson County,040,Barret Traditional Middle,275040,056275040,210299000641,"",909,06,114,104,29,38,67,0,0,0,6,8,14,8,5,13,0,1,1,3,6,9,58,56,114,218
20192020,056,JEFFERSON,275,Jefferson County,040,Barret Traditional Middle,275040,056275040,210299000641,"",909,08,106,97,24,25,49,0,0,0,1,6,7,7,6,13,0,0,0,2,3,5,63,66,129,203
20192020,056,JEFFERSON,275,Jefferson County,041,Newburg Middle,275041,056275041,210299000642,"",909,07,151,211,89,77,166,1,1,2,12,13,25,34,30,64,0,0,0,6,8,14,69,22,91,362
20192020,056,JEFFERSON,275,Jefferson County,041,Newburg Middle,275041,056275041,210299000642,"",909,All Students,491,632,275,243,518,1,2,3,46,40,86,103,90,193,0,0,0,19,20,39,188,96,284,1123
20192020,056,JEFFERSON,275,Jefferson County,041,Newburg Middle,275041,056275041,210299000642,"",909,06,173,211,89,84,173,0,0,0,17,15,32,36,36,72,0,0,0,6,3,9,63,35,98,384
20192020,056,JEFFERSON,275,Jefferson County,041,Newburg Middle,275041,056275041,210299000642,"",909,08,167,210,97,82,179,0,1,1,17,12,29,33,24,57,0,0,0,7,9,16,56,39,95,377
20192020,056,JEFFERSON,275,Jefferson County,044,Audubon Traditional Elementary,275044,056275044,210299000643,"",909,04,49,63,9,9,18,0,0,0,0,2,2,3,0,3,0,0,0,7,3,10,44,35,79,112
20192020,056,JEFFERSON,275,Jefferson County,044,Audubon Traditional Elementary,275044,056275044,210299000643,"",909,All Students,301,318,80,95,175,0,1,1,8,10,18,19,7,26,0,0,0,25,24,49,186,164,350,619
20192020,056,JEFFERSON,275,Jefferson County,044,Audubon Traditional Elementary,275044,056275044,210299000643,"",909,KG,44,56,14,20,34,0,0,0,3,3,6,5,4,9,0,0,0,5,1,6,29,16,45,100
20192020,056,JEFFERSON,275,Jefferson County,044,Audubon Traditional Elementary,275044,056275044,210299000643,"",909,01,53,43,14,18,32,0,0,0,1,2,3,1,0,1,0,0,0,3,6,9,24,27,51,96
20192020,056,JEFFERSON,275,Jefferson County,044,Audubon Traditional Elementary,275044,056275044,210299000643,"",909,02,57,41,13,14,27,0,0,0,1,2,3,2,0,2,0,0,0,4,3,7,21,38,59,98
20192020,056,JEFFERSON,275,Jefferson County,044,Audubon Traditional Elementary,275044,056275044,210299000643,"",909,03,46,51,13,15,28,0,1,1,1,0,1,6,3,9,0,0,0,4,6,10,27,21,48,97
20192020,056,JEFFERSON,275,Jefferson County,044,Audubon Traditional Elementary,275044,056275044,210299000643,"",909,05,52,64,17,19,36,0,0,0,2,1,3,2,0,2,0,0,0,2,5,7,41,27,68,116
20192020,056,JEFFERSON,275,Jefferson County,045,Butler Traditional High,275045,056275045,210299000644,"",909,12,167,163,67,72,139,0,0,0,3,3,6,11,12,23,0,0,0,5,3,8,77,77,154,330
20192020,056,JEFFERSON,275,Jefferson County,045,Butler Traditional High,275045,056275045,210299000644,"",909,All Students,820,765,390,411,801,0,0,0,16,19,35,47,53,100,0,1,1,22,22,44,290,314,604,1585
20192020,056,JEFFERSON,275,Jefferson County,045,Butler Traditional High,275045,056275045,210299000644,"",909,09,243,217,120,123,243,0,0,0,2,5,7,16,18,34,0,0,0,5,5,10,74,92,166,460
20192020,056,JEFFERSON,275,Jefferson County,045,Butler Traditional High,275045,056275045,210299000644,"",909,10,194,195,112,103,215,0,0,0,6,4,10,8,17,25,0,0,0,8,7,15,61,63,124,389
20192020,056,JEFFERSON,275,Jefferson County,045,Butler Traditional High,275045,056275045,210299000644,"",909,11,214,181,87,113,200,0,0,0,5,7,12,12,6,18,0,1,1,4,7,11,73,80,153,395
20192020,056,JEFFERSON,275,Jefferson County,045,Butler Traditional High,275045,056275045,210299000644,"",909,14,2,9,4,0,4,0,0,0,0,0,0,0,0,0,0,0,0,0,0,0,5,2,7,11
20192020,056,JEFFERSON,275,Jefferson County,046,Chenoweth Elementary,275046,056275046,210299000645,"",909,04,45,50,18,11,29,0,0,0,3,2,5,1,0,1,0,0,0,3,7,10,25,25,50,95
20192020,056,JEFFERSON,275,Jefferson County,046,Chenoweth Elementary,275046,056275046,210299000645,"",909,All Students,234,267,75,57,132,0,0,0,11,9,20,13,10,23,0,0,0,18,15,33,150,143,293,501
20192020,056,JEFFERSON,275,Jefferson County,046,Chenoweth Elementary,275046,056275046,210299000645,"",909,PS,12,28,10,5,15,0,0,0,2,0,2,3,4,7,0,0,0,4,1,5,9,2,11,40
20192020,056,JEFFERSON,275,Jefferson County,046,Chenoweth Elementary,275046,056275046,210299000645,"",909,KG,44,46,11,10,21,0,0,0,3,1,4,5,2,7,0,0,0,2,3,5,25,28,53,90
20192020,056,JEFFERSON,275,Jefferson County,046,Chenoweth Elementary,275046,056275046,210299000645,"",909,01,41,49,12,13,25,0,0,0,2,3,5,2,1,3,0,0,0,7,0,7,26,24,50,90
20192020,056,JEFFERSON,275,Jefferson County,046,Chenoweth Elementary,275046,056275046,210299000645,"",909,02,29,41,15,4,19,0,0,0,2,2,4,4,2,6,0,0,0,1,0,1,19,21,40,70
20192020,056,JEFFERSON,275,Jefferson County,046,Chenoweth Elementary,275046,056275046,210299000645,"",909,03,42,52,11,11,22,0,0,0,1,1,2,0,2,2,0,0,0,4,2,6,36,26,62,94
20192020,056,JEFFERSON,275,Jefferson County,046,Chenoweth Elementary,275046,056275046,210299000645,"",909,05,33,29,8,8,16,0,0,0,0,0,0,1,3,4,0,0,0,1,3,4,19,19,38,62
20192020,056,JEFFERSON,275,Jefferson County,047,Louisville Male High,275047,056275047,210299001705,"",909,14,0,3,0,0,0,0,0,0,0,0,0,0,0,0,0,0,0,0,0,0,3,0,3,3
20192020,056,JEFFERSON,275,Jefferson County,047,Louisville Male High,275047,056275047,210299001705,"",909,All Students,1055,934,321,360,681,1,0,1,24,34,58,32,65,97,1,1,2,23,33,56,532,562,1094,1989
20192020,056,JEFFERSON,275,Jefferson County,047,Louisville Male High,275047,056275047,210299001705,"",909,09,283,260,90,98,188,1,0,1,6,9,15,4,26,30,0,0,0,11,10,21,148,140,288,543
20192020,056,JEFFERSON,275,Jefferson County,047,Louisville Male High,275047,056275047,210299001705,"",909,10,277,228,69,85,154,0,0,0,8,10,18,9,18,27,1,0,1,3,8,11,138,156,294,505
20192020,056,JEFFERSON,275,Jefferson County,047,Louisville Male High,275047,056275047,210299001705,"",909,11,266,212,85,93,178,0,0,0,6,9,15,5,9,14,0,1,1,6,7,13,110,147,257,478
20192020,056,JEFFERSON,275,Jefferson County,047,Louisville Male High,275047,056275047,210299001705,"",909,12,229,231,77,84,161,0,0,0,4,6,10,14,12,26,0,0,0,3,8,11,133,119,252,460
20192020,056,JEFFERSON,275,Jefferson County,048,Hawthorne Elementary,275048,056275048,210299000647,"",909,05,31,24,4,1,5,0,0,0,1,2,3,4,11,15,0,0,0,2,1,3,13,16,29,55
20192020,056,JEFFERSON,275,Jefferson County,048,Hawthorne Elementary,275048,056275048,210299000647,"",909,All Students,200,191,28,34,62,0,0,0,5,3,8,49,54,103,0,0,0,8,15,23,101,94,195,391
20192020,056,JEFFERSON,275,Jefferson County,048,Hawthorne Elementary,275048,056275048,210299000647,"",909,PS,22,39,14,2,16,0,0,0,4,4,8,4,6,10,0,0,0,3,1,4,14,9,23,61
20192020,056,JEFFERSON,275,Jefferson County,048,Hawthorne Elementary,275048,056275048,210299000647,"",909,KG,41,39,8,11,19,0,0,0,0,0,0,12,8,20,0,0,0,0,6,6,19,16,35,80
20192020,056,JEFFERSON,275,Jefferson County,048,Hawthorne Elementary,275048,056275048,210299000647,"",909,01,34,35,3,9,12,0,0,0,0,0,0,8,8,16,0,0,0,1,4,5,23,13,36,69
20192020,056,JEFFERSON,275,Jefferson County,048,Hawthorne Elementary,275048,056275048,210299000647,"",909,02,44,23,3,7,10,0,0,0,2,0,2,7,9,16,0,0,0,2,2,4,9,26,35,67
20192020,056,JEFFERSON,275,Jefferson County,048,Hawthorne Elementary,275048,056275048,210299000647,"",909,03,29,35,4,2,6,0,0,0,0,0,0,5,12,17,0,0,0,3,2,5,23,13,36,64
20192020,056,JEFFERSON,275,Jefferson County,048,Hawthorne Elementary,275048,056275048,210299000647,"",909,04,21,35,6,4,10,0,0,0,2,1,3,13,6,19,0,0,0,0,0,0,14,10,24,56
20192020,056,JEFFERSON,275,Jefferson County,049,Farnsley Middle,275049,056275049,210299001530,"",909,07,155,218,67,63,130,0,0,0,6,3,9,15,12,27,0,0,0,18,9,27,112,68,180,373
20192020,056,JEFFERSON,275,Jefferson County,049,Farnsley Middle,275049,056275049,210299001530,"",909,All Students,481,648,224,179,403,0,1,1,23,16,39,49,49,98,0,0,0,37,30,67,315,206,521,1129
20192020,056,JEFFERSON,275,Jefferson County,049,Farnsley Middle,275049,056275049,210299001530,"",909,06,169,219,64,62,126,0,1,1,7,3,10,21,25,46,0,0,0,11,12,23,116,66,182,388
20192020,056,JEFFERSON,275,Jefferson County,049,Farnsley Middle,275049,056275049,210299001530,"",909,08,157,211,93,54,147,0,0,0,10,10,20,13,12,25,0,0,0,8,9,17,87,72,159,368
20192020,056,JEFFERSON,275,Jefferson County,050,Georgia Chaffee Teenage Parent Program,275050,056275050,210299001612,"",909,11,21,0,0,9,9,0,0,0,0,0,0,0,5,5,0,0,0,0,0,0,0,7,7,21
20192020,056,JEFFERSON,275,Jefferson County,050,Georgia Chaffee Teenage Parent Program,275050,056275050,210299001612,"",909,All Students,66,0,0,31,31,0,0,0,0,1,1,0,14,14,0,0,0,0,1,1,0,19,19,66
20192020,056,JEFFERSON,275,Jefferson County,050,Georgia Chaffee Teenage Parent Program,275050,056275050,210299001612,"",909,PS,3,3,1,2,3,0,0,0,0,0,0,1,0,1,0,0,0,0,0,0,1,1,2,6
20192020,056,JEFFERSON,275,Jefferson County,050,Georgia Chaffee Teenage Parent Program,275050,056275050,210299001612,"",909,08,2,0,0,1,1,0,0,0,0,0,0,0,1,1,0,0,0,0,0,0,0,0,0,2
20192020,056,JEFFERSON,275,Jefferson County,050,Georgia Chaffee Teenage Parent Program,275050,056275050,210299001612,"",909,09,3,0,0,2,2,0,0,0,0,0,0,0,0,0,0,0,0,0,0,0,0,1,1,3
20192020,056,JEFFERSON,275,Jefferson County,050,Georgia Chaffee Teenage Parent Program,275050,056275050,210299001612,"",909,10,14,0,0,6,6,0,0,0,0,0,0,0,4,4,0,0,0,0,0,0,0,4,4,14
20192020,056,JEFFERSON,275,Jefferson County,050,Georgia Chaffee Teenage Parent Program,275050,056275050,210299001612,"",909,12,26,0,0,13,13,0,0,0,0,1,1,0,4,4,0,0,0,0,1,1,0,7,7,26
20192020,056,JEFFERSON,275,Jefferson County,051,Waggener High,275051,056275051,210299000649,"",909,10,113,131,76,64,140,0,0,0,4,2,6,21,15,36,0,0,0,2,4,6,28,28,56,244
20192020,056,JEFFERSON,275,Jefferson County,051,Waggener High,275051,056275051,210299000649,"",909,All Students,423,462,239,230,469,0,0,0,5,6,11,81,63,144,0,0,0,10,8,18,127,116,243,885
20192020,056,JEFFERSON,275,Jefferson County,051,Waggener High,275051,056275051,210299000649,"",909,09,110,124,61,59,120,0,0,0,0,0,0,16,15,31,0,0,0,4,0,4,43,36,79,234
20192020,056,JEFFERSON,275,Jefferson County,051,Waggener High,275051,056275051,210299000649,"",909,11,90,90,44,44,88,0,0,0,1,4,5,14,19,33,0,0,0,2,1,3,29,22,51,180
20192020,056,JEFFERSON,275,Jefferson County,051,Waggener High,275051,056275051,210299000649,"",909,12,109,116,58,62,120,0,0,0,0,0,0,30,14,44,0,0,0,2,3,5,26,30,56,225
20192020,056,JEFFERSON,275,Jefferson County,051,Waggener High,275051,056275051,210299000649,"",909,14,1,1,0,1,1,0,0,0,0,0,0,0,0,0,0,0,0,0,0,0,1,0,1,2
20192020,056,JEFFERSON,275,Jefferson County,055,Bates Elementary,275055,056275055,210299000650,"",909,05,49,40,9,11,20,0,0,0,1,0,1,6,1,7,0,0,0,0,3,3,24,34,58,89
20192020,056,JEFFERSON,275,Jefferson County,055,Bates Elementary,275055,056275055,210299000650,"",909,All Students,296,274,60,51,111,1,1,2,7,10,17,27,24,51,0,0,0,18,20,38,161,190,351,570
20192020,056,JEFFERSON,275,Jefferson County,055,Bates Elementary,275055,056275055,210299000650,"",909,KG,51,50,6,7,13,0,1,1,1,1,2,4,5,9,0,0,0,3,3,6,36,34,70,101
20192020,056,JEFFERSON,275,Jefferson County,055,Bates Elementary,275055,056275055,210299000650,"",909,01,56,47,12,11,23,0,0,0,2,3,5,3,4,7,0,0,0,5,5,10,25,33,58,103
20192020,056,JEFFERSON,275,Jefferson County,055,Bates Elementary,275055,056275055,210299000650,"",909,02,52,43,9,9,18,0,0,0,2,1,3,6,2,8,0,0,0,4,5,9,22,35,57,95
20192020,056,JEFFERSON,275,Jefferson County,055,Bates Elementary,275055,056275055,210299000650,"",909,03,53,43,10,8,18,0,0,0,1,2,3,4,8,12,0,0,0,2,3,5,26,32,58,96
20192020,056,JEFFERSON,275,Jefferson County,055,Bates Elementary,275055,056275055,210299000650,"",909,04,35,51,14,5,19,1,0,1,0,3,3,4,4,8,0,0,0,4,1,5,28,22,50,86
20192020,056,JEFFERSON,275,Jefferson County,057,Fairdale High,275057,056275057,210299000651,"",909,12,161,155,37,34,71,0,0,0,0,1,1,26,34,60,0,1,1,2,2,4,90,89,179,316
20192020,056,JEFFERSON,275,Jefferson County,057,Fairdale High,275057,056275057,210299000651,"",909,All Students,663,667,150,128,278,0,1,1,20,11,31,138,154,292,0,3,3,15,11,26,344,355,699,1330
20192020,056,JEFFERSON,275,Jefferson County,057,Fairdale High,275057,056275057,210299000651,"",909,09,178,204,45,28,73,0,0,0,9,5,14,40,42,82,0,1,1,8,6,14,102,96,198,382
20192020,056,JEFFERSON,275,Jefferson County,057,Fairdale High,275057,056275057,210299000651,"",909,10,172,177,39,37,76,0,1,1,8,2,10,43,44,87,0,1,1,2,2,4,85,85,170,349
20192020,056,JEFFERSON,275,Jefferson County,057,Fairdale High,275057,056275057,210299000651,"",909,11,152,129,28,29,57,0,0,0,3,3,6,29,34,63,0,0,0,3,1,4,66,85,151,281
20192020,056,JEFFERSON,275,Jefferson County,057,Fairdale High,275057,056275057,210299000651,"",909,14,0,2,1,0,1,0,0,0,0,0,0,0,0,0,0,0,0,0,0,0,1,0,1,2
20192020,056,JEFFERSON,275,Jefferson County,059,Kenwood Elementary,275059,056275059,210299000653,"",909,03,47,53,16,9,25,0,1,1,6,4,10,12,11,23,1,0,1,3,2,5,15,20,35,100
20192020,056,JEFFERSON,275,Jefferson County,059,Kenwood Elementary,275059,056275059,210299000653,"",909,All Students,297,293,74,79,153,0,2,2,30,27,57,62,51,113,1,2,3,12,21,33,114,115,229,590
20192020,056,JEFFERSON,275,Jefferson County,059,Kenwood Elementary,275059,056275059,210299000653,"",909,KG,56,54,11,11,22,0,0,0,3,5,8,10,12,22,0,0,0,1,6,7,29,22,51,110
20192020,056,JEFFERSON,275,Jefferson County,059,Kenwood Elementary,275059,056275059,210299000653,"",909,01,46,52,14,18,32,0,0,0,9,4,13,9,7,16,0,0,0,3,3,6,17,14,31,98
20192020,056,JEFFERSON,275,Jefferson County,059,Kenwood Elementary,275059,056275059,210299000653,"",909,05,47,45,12,13,25,0,0,0,3,4,7,11,8,19,0,1,1,1,3,4,18,18,36,92
20192020,056,JEFFERSON,275,Jefferson County,059,Kenwood Elementary,275059,056275059,210299000653,"",909,02,51,45,13,15,28,0,0,0,6,7,13,9,7,16,0,1,1,2,1,3,15,20,35,96
20192020,056,JEFFERSON,275,Jefferson County,059,Kenwood Elementary,275059,056275059,210299000653,"",909,04,50,44,8,13,21,0,1,1,3,3,6,11,6,17,0,0,0,2,6,8,20,21,41,94
20192020,056,JEFFERSON,275,Jefferson County,060,Coral Ridge Elementary,275060,056275060,210299000654,"",909,01,47,44,3,3,6,0,0,0,0,0,0,11,8,19,0,0,0,3,1,4,27,35,62,91
20192020,056,JEFFERSON,275,Jefferson County,060,Coral Ridge Elementary,275060,056275060,210299000654,"",909,All Students,277,274,24,23,47,0,0,0,3,1,4,62,63,125,0,1,1,15,13,28,170,176,346,551
20192020,056,JEFFERSON,275,Jefferson County,060,Coral Ridge Elementary,275060,056275060,210299000654,"",909,PS,8,11,0,1,1,0,0,0,0,0,0,5,6,11,0,0,0,1,0,1,5,1,6,19
20192020,056,JEFFERSON,275,Jefferson County,060,Coral Ridge Elementary,275060,056275060,210299000654,"",909,KG,42,50,4,4,8,0,0,0,1,0,1,11,10,21,0,0,0,4,2,6,30,26,56,92
20192020,056,JEFFERSON,275,Jefferson County,060,Coral Ridge Elementary,275060,056275060,210299000654,"",909,02,40,47,6,1,7,0,0,0,0,0,0,8,10,18,0,1,1,4,2,6,29,26,55,87
20192020,056,JEFFERSON,275,Jefferson County,060,Coral Ridge Elementary,275060,056275060,210299000654,"",909,03,50,40,5,2,7,0,0,0,1,0,1,6,8,14,0,0,0,0,3,3,28,37,65,90
20192020,056,JEFFERSON,275,Jefferson County,060,Coral Ridge Elementary,275060,056275060,210299000654,"",909,04,40,53,3,3,6,0,0,0,1,0,1,14,12,26,0,0,0,3,4,7,32,21,53,93
20192020,056,JEFFERSON,275,Jefferson County,060,Coral Ridge Elementary,275060,056275060,210299000654,"",909,05,58,40,3,10,13,0,0,0,0,1,1,12,15,27,0,0,0,1,1,2,24,31,55,98
20192020,056,JEFFERSON,275,Jefferson County,061,Goldsmith Elementary,275061,056275061,210299000655,"",909,05,42,68,21,13,34,0,0,0,3,6,9,19,12,31,0,0,0,3,1,4,22,10,32,110
20192020,056,JEFFERSON,275,Jefferson County,061,Goldsmith Elementary,275061,056275061,210299000655,"",909,All Students,283,330,102,98,200,0,0,0,38,35,73,76,70,146,0,0,0,14,18,32,100,62,162,613
20192020,056,JEFFERSON,275,Jefferson County,061,Goldsmith Elementary,275061,056275061,210299000655,"",909,KG,47,54,18,17,35,0,0,0,3,7,10,7,7,14,0,0,0,3,2,5,23,14,37,101
20192020,056,JEFFERSON,275,Jefferson County,061,Goldsmith Elementary,275061,056275061,210299000655,"",909,01,51,56,16,13,29,0,0,0,9,6,15,13,17,30,0,0,0,3,5,8,15,10,25,107
20192020,056,JEFFERSON,275,Jefferson County,061,Goldsmith Elementary,275061,056275061,210299000655,"",909,02,46,41,14,14,28,0,0,0,8,7,15,7,11,18,0,0,0,1,5,6,11,9,20,87
20192020,056,JEFFERSON,275,Jefferson County,061,Goldsmith Elementary,275061,056275061,210299000655,"",909,03,42,66,21,22,43,0,0,0,9,2,11,16,9,25,0,0,0,4,2,6,16,7,23,108
20192020,056,JEFFERSON,275,Jefferson County,061,Goldsmith Elementary,275061,056275061,210299000655,"",909,04,55,45,12,19,31,0,0,0,6,7,13,14,14,28,0,0,0,0,3,3,13,12,25,100
20192020,056,JEFFERSON,275,Jefferson County,063,Schaffner Traditional Elementary,275063,056275063,210299001587,"",909,04,57,54,18,20,38,0,0,0,1,0,1,4,6,10,0,0,0,0,2,2,31,29,60,111
20192020,056,JEFFERSON,275,Jefferson County,063,Schaffner Traditional Elementary,275063,056275063,210299001587,"",909,All Students,299,284,117,125,242,0,0,0,5,5,10,16,22,38,1,0,1,15,17,32,130,130,260,583
20192020,056,JEFFERSON,275,Jefferson County,063,Schaffner Traditional Elementary,275063,056275063,210299001587,"",909,KG,29,38,17,12,29,0,0,0,1,1,2,1,3,4,0,0,0,3,1,4,16,12,28,67
20192020,056,JEFFERSON,275,Jefferson County,063,Schaffner Traditional Elementary,275063,056275063,210299001587,"",909,01,51,44,26,25,51,0,0,0,2,0,2,3,3,6,0,0,0,2,5,7,11,18,29,95
20192020,056,JEFFERSON,275,Jefferson County,063,Schaffner Traditional Elementary,275063,056275063,210299001587,"",909,02,40,52,14,15,29,0,0,0,0,2,2,3,1,4,0,0,0,5,3,8,30,19,49,92
20192020,056,JEFFERSON,275,Jefferson County,063,Schaffner Traditional Elementary,275063,056275063,210299001587,"",909,03,53,55,24,24,48,0,0,0,0,2,2,1,6,7,0,0,0,3,2,5,27,19,46,108
20192020,056,JEFFERSON,275,Jefferson County,063,Schaffner Traditional Elementary,275063,056275063,210299001587,"",909,05,69,41,18,29,47,0,0,0,1,0,1,4,3,7,1,0,1,2,4,6,15,33,48,110
20192020,056,JEFFERSON,275,Jefferson County,064,St Matthews Elementary,275064,056275064,210299000658,"",909,KG,56,43,13,8,21,1,0,1,4,0,4,1,5,6,0,0,0,1,4,5,23,39,62,99
20192020,056,JEFFERSON,275,Jefferson County,064,St Matthews Elementary,275064,056275064,210299000658,"",909,All Students,278,274,70,53,123,1,1,2,15,10,25,8,23,31,0,0,0,16,20,36,164,171,335,552
20192020,056,JEFFERSON,275,Jefferson County,064,St Matthews Elementary,275064,056275064,210299000658,"",909,01,47,48,8,8,16,0,0,0,2,0,2,3,5,8,0,0,0,2,2,4,33,32,65,95
20192020,056,JEFFERSON,275,Jefferson County,064,St Matthews Elementary,275064,056275064,210299000658,"",909,02,38,51,17,5,22,0,0,0,4,1,5,1,2,3,0,0,0,3,4,7,26,26,52,89
20192020,056,JEFFERSON,275,Jefferson County,064,St Matthews Elementary,275064,056275064,210299000658,"",909,03,53,45,11,9,20,0,1,1,2,2,4,1,7,8,0,0,0,2,3,5,29,31,60,98
20192020,056,JEFFERSON,275,Jefferson County,064,St Matthews Elementary,275064,056275064,210299000658,"",909,04,39,45,8,13,21,0,0,0,2,3,5,2,2,4,0,0,0,6,3,9,27,18,45,84
20192020,056,JEFFERSON,275,Jefferson County,064,St Matthews Elementary,275064,056275064,210299000658,"",909,05,45,42,13,10,23,0,0,0,1,4,5,0,2,2,0,0,0,2,4,6,26,25,51,87
20192020,056,JEFFERSON,275,Jefferson County,065,Jeffersontown High,275065,056275065,210299000659,"",909,09,109,148,73,39,112,0,0,0,3,2,5,18,20,38,0,0,0,8,4,12,46,44,90,257
20192020,056,JEFFERSON,275,Jefferson County,065,Jeffersontown High,275065,056275065,210299000659,"",909,10,95,107,36,31,67,0,0,0,3,5,8,12,12,24,0,1,1,2,4,6,54,42,96,202
20192020,056,JEFFERSON,275,Jefferson County,065,Jeffersontown High,275065,056275065,210299000659,"",909,11,100,123,44,40,84,0,0,0,4,0,4,14,14,28,0,0,0,5,5,10,56,41,97,223
20192020,056,JEFFERSON,275,Jefferson County,065,Jeffersontown High,275065,056275065,210299000659,"",909,12,80,123,44,28,72,1,0,1,3,3,6,16,10,26,0,0,0,7,0,7,52,39,91,203
20192020,056,JEFFERSON,275,Jefferson County,065,Jeffersontown High,275065,056275065,210299000659,"",909,14,1,0,0,0,0,0,0,0,0,0,0,0,0,0,0,0,0,0,0,0,0,1,1,1
20192020,056,JEFFERSON,275,Jefferson County,065,Jeffersontown High,275065,056275065,210299000659,"",909,All Students,385,501,197,138,335,1,0,1,13,10,23,60,56,116,0,1,1,22,13,35,208,167,375,886
20192020,056,JEFFERSON,275,Jefferson County,066,Wilkerson Elementary School,275066,056275066,210299000660,"",909,03,42,32,6,9,15,0,0,0,1,0,1,9,10,19,0,0,0,3,3,6,13,20,33,74
20192020,056,JEFFERSON,275,Jefferson County,066,Wilkerson Elementary School,275066,056275066,210299000660,"",909,05,38,43,13,11,24,0,0,0,2,1,3,2,8,10,0,0,0,2,2,4,24,16,40,81
20192020,056,JEFFERSON,275,Jefferson County,066,Wilkerson Elementary School,275066,056275066,210299000660,"",909,04,39,37,11,19,30,0,0,0,0,0,0,4,3,7,0,0,0,3,4,7,19,13,32,76
20192020,056,JEFFERSON,275,Jefferson County,066,Wilkerson Elementary School,275066,056275066,210299000660,"",909,All Students,217,237,57,69,126,0,0,0,4,1,5,31,40,71,0,0,0,24,18,42,121,89,210,454
20192020,056,JEFFERSON,275,Jefferson County,066,Wilkerson Elementary School,275066,056275066,210299000660,"",909,PS,19,21,6,4,10,0,0,0,0,0,0,2,0,2,0,0,0,3,1,4,10,14,24,40
20192020,056,JEFFERSON,275,Jefferson County,066,Wilkerson Elementary School,275066,056275066,210299000660,"",909,KG,30,46,9,9,18,0,0,0,0,0,0,7,6,13,0,0,0,7,4,11,23,11,34,76
20192020,056,JEFFERSON,275,Jefferson County,066,Wilkerson Elementary School,275066,056275066,210299000660,"",909,01,34,41,8,8,16,0,0,0,1,0,1,5,7,12,0,0,0,5,3,8,22,16,38,75
20192020,056,JEFFERSON,275,Jefferson County,066,Wilkerson Elementary School,275066,056275066,210299000660,"",909,02,34,38,10,13,23,0,0,0,0,0,0,4,6,10,0,0,0,4,2,6,20,13,33,72
20192020,056,JEFFERSON,275,Jefferson County,067,Wilder Elementary,275067,056275067,210299000661,"",909,03,48,47,10,13,23,0,0,0,2,1,3,10,2,12,0,1,1,4,1,5,21,30,51,95
20192020,056,JEFFERSON,275,Jefferson County,067,Wilder Elementary,275067,056275067,210299000661,"",909,All Students,272,264,62,77,139,1,0,1,16,20,36,29,15,44,0,1,1,14,20,34,142,139,281,536
20192020,056,JEFFERSON,275,Jefferson County,067,Wilder Elementary,275067,056275067,210299000661,"",909,05,42,46,16,15,31,0,0,0,2,3,5,3,1,4,0,0,0,3,3,6,22,20,42,88
20192020,056,JEFFERSON,275,Jefferson County,067,Wilder Elementary,275067,056275067,210299000661,"",909,KG,48,49,8,19,27,1,0,1,4,2,6,4,3,7,0,0,0,2,1,3,30,23,53,97
20192020,056,JEFFERSON,275,Jefferson County,067,Wilder Elementary,275067,056275067,210299000661,"",909,01,39,46,9,11,20,0,0,0,5,3,8,3,5,8,0,0,0,3,5,8,26,15,41,85
20192020,056,JEFFERSON,275,Jefferson County,067,Wilder Elementary,275067,056275067,210299000661,"",909,02,45,41,14,9,23,0,0,0,2,6,8,8,1,9,0,0,0,1,5,6,16,24,40,86
20192020,056,JEFFERSON,275,Jefferson County,067,Wilder Elementary,275067,056275067,210299000661,"",909,04,50,35,5,10,15,0,0,0,1,5,6,1,3,4,0,0,0,1,5,6,27,27,54,85
20192020,056,JEFFERSON,275,Jefferson County,069,Watson Lane Elementary,275069,056275069,210299000663,"",909,KG,25,25,0,3,3,0,0,0,0,0,0,2,5,7,0,0,0,3,2,5,20,15,35,50
20192020,056,JEFFERSON,275,Jefferson County,069,Watson Lane Elementary,275069,056275069,210299000663,"",909,All Students,126,138,13,22,35,1,0,1,0,1,1,10,9,19,0,0,0,11,9,20,103,85,188,264
20192020,056,JEFFERSON,275,Jefferson County,069,Watson Lane Elementary,275069,056275069,210299000663,"",909,PS,24,36,6,5,11,0,0,0,0,0,0,4,7,11,0,0,0,7,1,8,19,11,30,60
20192020,056,JEFFERSON,275,Jefferson County,069,Watson Lane Elementary,275069,056275069,210299000663,"",909,01,19,21,5,3,8,0,0,0,0,1,1,1,1,2,0,0,0,2,4,6,13,10,23,40
20192020,056,JEFFERSON,275,Jefferson County,069,Watson Lane Elementary,275069,056275069,210299000663,"",909,02,17,19,2,4,6,1,0,1,0,0,0,2,0,2,0,0,0,1,0,1,13,13,26,36
20192020,056,JEFFERSON,275,Jefferson County,069,Watson Lane Elementary,275069,056275069,210299000663,"",909,03,19,24,3,3,6,0,0,0,0,0,0,0,1,1,0,0,0,1,2,3,20,13,33,43
20192020,056,JEFFERSON,275,Jefferson County,069,Watson Lane Elementary,275069,056275069,210299000663,"",909,04,15,26,1,3,4,0,0,0,0,0,0,4,1,5,0,0,0,2,0,2,19,11,30,41
20192020,056,JEFFERSON,275,Jefferson County,069,Watson Lane Elementary,275069,056275069,210299000663,"",909,05,31,23,2,6,8,0,0,0,0,0,0,1,1,2,0,0,0,2,1,3,18,23,41,54
20192020,056,JEFFERSON,275,Jefferson County,070,DuValle Education Center,275070,056275070,210299001777,"",909,All Students,0,0,0,0,0,0,0,0,0,0,0,0,0,0,0,0,0,0,0,0,0,0,0,0
20192020,056,JEFFERSON,275,Jefferson County,070,DuValle Education Center,275070,056275070,210299001777,"",909,PS,154,172,151,137,288,1,0,1,0,0,0,4,5,9,0,0,0,5,8,13,11,4,15,326
20192020,056,JEFFERSON,275,Jefferson County,071,Stonestreet Elementary,275071,056275071,210299000665,"",909,PS,11,9,0,2,2,0,0,0,1,0,1,1,3,4,0,0,0,1,0,1,6,6,12,20
20192020,056,JEFFERSON,275,Jefferson County,071,Stonestreet Elementary,275071,056275071,210299000665,"",909,KG,33,47,3,3,6,0,0,0,1,0,1,7,3,10,0,0,0,2,1,3,34,26,60,80
20192020,056,JEFFERSON,275,Jefferson County,071,Stonestreet Elementary,275071,056275071,210299000665,"",909,01,31,46,7,4,11,0,0,0,0,0,0,9,7,16,0,1,1,4,0,4,26,19,45,77
20192020,056,JEFFERSON,275,Jefferson County,071,Stonestreet Elementary,275071,056275071,210299000665,"",909,02,27,32,3,0,3,0,0,0,0,1,1,9,6,15,1,2,3,3,2,5,16,16,32,59
20192020,056,JEFFERSON,275,Jefferson County,071,Stonestreet Elementary,275071,056275071,210299000665,"",909,03,37,37,1,3,4,0,0,0,0,0,0,6,9,15,1,0,1,0,5,5,29,20,49,74
20192020,056,JEFFERSON,275,Jefferson County,071,Stonestreet Elementary,275071,056275071,210299000665,"",909,05,38,34,2,3,5,0,0,0,0,1,1,7,6,13,0,0,0,2,3,5,23,25,48,72
20192020,056,JEFFERSON,275,Jefferson County,071,Stonestreet Elementary,275071,056275071,210299000665,"",909,04,35,43,2,5,7,0,0,0,0,1,1,7,6,13,1,1,2,2,1,3,31,21,52,78
20192020,056,JEFFERSON,275,Jefferson County,071,Stonestreet Elementary,275071,056275071,210299000665,"",909,All Students,201,239,18,18,36,0,0,0,1,3,4,45,37,82,3,4,7,13,12,25,159,127,286,440
20192020,056,JEFFERSON,275,Jefferson County,072,Watterson Elementary,275072,056275072,210299000666,"",909,04,50,47,17,26,43,0,0,0,2,0,2,6,6,12,0,1,1,4,4,8,18,13,31,97
20192020,056,JEFFERSON,275,Jefferson County,072,Watterson Elementary,275072,056275072,210299000666,"",909,All Students,226,285,118,100,218,0,0,0,11,8,19,30,19,49,0,1,1,21,17,38,105,81,186,511
20192020,056,JEFFERSON,275,Jefferson County,072,Watterson Elementary,275072,056275072,210299000666,"",909,KG,33,42,15,13,28,0,0,0,2,1,3,5,3,8,0,0,0,5,2,7,15,14,29,75
20192020,056,JEFFERSON,275,Jefferson County,072,Watterson Elementary,275072,056275072,210299000666,"",909,01,42,39,14,22,36,0,0,0,5,1,6,4,4,8,0,0,0,2,3,5,14,12,26,81
20192020,056,JEFFERSON,275,Jefferson County,072,Watterson Elementary,275072,056275072,210299000666,"",909,02,28,46,18,10,28,0,0,0,1,2,3,6,1,7,0,0,0,2,2,4,19,13,32,74
20192020,056,JEFFERSON,275,Jefferson County,072,Watterson Elementary,275072,056275072,210299000666,"",909,03,40,53,24,16,40,0,0,0,0,3,3,6,2,8,0,0,0,5,3,8,18,16,34,93
20192020,056,JEFFERSON,275,Jefferson County,072,Watterson Elementary,275072,056275072,210299000666,"",909,05,33,58,30,13,43,0,0,0,1,1,2,3,3,6,0,0,0,3,3,6,21,13,34,91
20192020,056,JEFFERSON,275,Jefferson County,073,Seneca High,275073,056275073,210299000667,"",909,All Students,613,588,233,239,472,2,1,3,36,24,60,127,107,234,2,1,3,15,18,33,173,223,396,1201
20192020,056,JEFFERSON,275,Jefferson County,073,Seneca High,275073,056275073,210299000667,"",909,09,191,196,93,76,169,0,0,0,10,7,17,34,27,61,0,1,1,6,8,14,53,72,125,387
20192020,056,JEFFERSON,275,Jefferson County,073,Seneca High,275073,056275073,210299000667,"",909,10,149,129,54,59,113,0,0,0,10,5,15,18,27,45,0,0,0,3,3,6,44,55,99,278
20192020,056,JEFFERSON,275,Jefferson County,073,Seneca High,275073,056275073,210299000667,"",909,11,140,133,49,63,112,0,1,1,8,7,15,33,20,53,2,0,2,3,3,6,38,46,84,273
20192020,056,JEFFERSON,275,Jefferson County,073,Seneca High,275073,056275073,210299000667,"",909,12,132,128,37,40,77,2,0,2,8,5,13,42,33,75,0,0,0,3,4,7,36,50,86,260
20192020,056,JEFFERSON,275,Jefferson County,073,Seneca High,275073,056275073,210299000667,"",909,14,1,2,0,1,1,0,0,0,0,0,0,0,0,0,0,0,0,0,0,0,2,0,2,3
20192020,056,JEFFERSON,275,Jefferson County,075,Pleasure Ridge Park High,275075,056275075,210299000668,"",909,All Students,801,781,252,261,513,2,0,2,5,6,11,35,35,70,1,2,3,30,37,67,456,460,916,1582
20192020,056,JEFFERSON,275,Jefferson County,075,Pleasure Ridge Park High,275075,056275075,210299000668,"",909,09,231,247,81,84,165,1,0,1,0,0,0,13,12,25,0,1,1,12,15,27,140,119,259,478
20192020,056,JEFFERSON,275,Jefferson County,075,Pleasure Ridge Park High,275075,056275075,210299000668,"",909,10,170,195,59,50,109,1,0,1,4,4,8,11,7,18,0,0,0,4,8,12,116,101,217,365
20192020,056,JEFFERSON,275,Jefferson County,075,Pleasure Ridge Park High,275075,056275075,210299000668,"",909,11,206,166,60,69,129,0,0,0,1,0,1,4,8,12,0,1,1,7,8,15,94,120,214,372
20192020,056,JEFFERSON,275,Jefferson County,075,Pleasure Ridge Park High,275075,056275075,210299000668,"",909,12,193,166,49,58,107,0,0,0,0,2,2,7,8,15,1,0,1,7,6,13,102,119,221,359
20192020,056,JEFFERSON,275,Jefferson County,075,Pleasure Ridge Park High,275075,056275075,210299000668,"",909,14,1,7,3,0,3,0,0,0,0,0,0,0,0,0,0,0,0,0,0,0,4,1,5,8
20192020,056,JEFFERSON,275,Jefferson County,076,Indian Trail Elementary,275076,056275076,210299000669,"",909,05,42,48,25,21,46,0,0,0,1,0,1,14,14,28,0,0,0,4,1,5,4,6,10,90
20192020,056,JEFFERSON,275,Jefferson County,076,Indian Trail Elementary,275076,056275076,210299000669,"",909,03,42,55,25,22,47,1,0,1,0,1,1,16,15,31,0,0,0,8,2,10,5,2,7,97
20192020,056,JEFFERSON,275,Jefferson County,076,Indian Trail Elementary,275076,056275076,210299000669,"",909,All Students,253,274,135,129,264,1,1,2,1,2,3,77,80,157,0,0,0,22,12,34,38,29,67,527
20192020,056,JEFFERSON,275,Jefferson County,076,Indian Trail Elementary,275076,056275076,210299000669,"",909,04,42,44,20,24,44,0,0,0,0,0,0,16,12,28,0,0,0,2,1,3,6,5,11,86
20192020,056,JEFFERSON,275,Jefferson County,076,Indian Trail Elementary,275076,056275076,210299000669,"",909,KG,47,54,33,27,60,0,0,0,0,1,1,11,12,23,0,0,0,3,1,4,7,6,13,101
20192020,056,JEFFERSON,275,Jefferson County,076,Indian Trail Elementary,275076,056275076,210299000669,"",909,01,39,43,18,16,34,0,1,1,0,0,0,10,12,22,0,0,0,5,4,9,10,6,16,82
20192020,056,JEFFERSON,275,Jefferson County,076,Indian Trail Elementary,275076,056275076,210299000669,"",909,02,41,30,14,19,33,0,0,0,0,0,0,10,15,25,0,0,0,0,3,3,6,4,10,71
20192020,056,JEFFERSON,275,Jefferson County,077,Westport Middle,275077,056275077,210299000670,"",909,All Students,607,705,237,221,458,1,1,2,26,10,36,102,87,189,0,3,3,31,47,78,308,238,546,1312
20192020,056,JEFFERSON,275,Jefferson County,077,Westport Middle,275077,056275077,210299000670,"",909,07,214,247,87,86,173,1,0,1,10,1,11,30,29,59,0,0,0,11,14,25,108,84,192,461
20192020,056,JEFFERSON,275,Jefferson County,077,Westport Middle,275077,056275077,210299000670,"",909,08,200,242,81,62,143,0,1,1,9,3,12,36,26,62,0,1,1,10,17,27,106,90,196,442
20192020,056,JEFFERSON,275,Jefferson County,077,Westport Middle,275077,056275077,210299000670,"",909,06,193,216,69,73,142,0,0,0,7,6,13,36,32,68,0,2,2,10,16,26,94,64,158,409
20192020,056,JEFFERSON,275,Jefferson County,078,Zachary Taylor Elementary,275078,056275078,210299000671,"",909,KG,40,33,11,15,26,0,0,0,2,5,7,10,7,17,0,0,0,3,4,7,7,9,16,73
20192020,056,JEFFERSON,275,Jefferson County,078,Zachary Taylor Elementary,275078,056275078,210299000671,"",909,All Students,186,187,75,79,154,0,0,0,9,17,26,47,35,82,0,1,1,13,17,30,43,37,80,373
20192020,056,JEFFERSON,275,Jefferson County,078,Zachary Taylor Elementary,275078,056275078,210299000671,"",909,01,32,26,9,15,24,0,0,0,1,2,3,6,6,12,0,0,0,4,2,6,6,7,13,58
20192020,056,JEFFERSON,275,Jefferson County,078,Zachary Taylor Elementary,275078,056275078,210299000671,"",909,02,22,21,11,8,19,0,0,0,2,3,5,5,7,12,0,0,0,0,1,1,3,3,6,43
20192020,056,JEFFERSON,275,Jefferson County,078,Zachary Taylor Elementary,275078,056275078,210299000671,"",909,03,30,38,16,15,31,0,0,0,2,3,5,9,4,13,0,0,0,3,2,5,8,6,14,68
20192020,056,JEFFERSON,275,Jefferson County,078,Zachary Taylor Elementary,275078,056275078,210299000671,"",909,04,32,30,12,13,25,0,0,0,1,3,4,5,4,9,0,1,1,2,7,9,10,4,14,62
20192020,056,JEFFERSON,275,Jefferson County,078,Zachary Taylor Elementary,275078,056275078,210299000671,"",909,05,30,39,16,13,29,0,0,0,1,1,2,12,7,19,0,0,0,1,1,2,9,8,17,69
20192020,056,JEFFERSON,275,Jefferson County,079,Kerrick Elementary,275079,056275079,210299000672,"",909,05,43,22,9,19,28,0,0,0,1,1,2,3,2,5,0,0,0,2,2,4,7,19,26,65
20192020,056,JEFFERSON,275,Jefferson County,079,Kerrick Elementary,275079,056275079,210299000672,"",909,All Students,221,206,74,95,169,0,0,0,2,3,5,7,14,21,0,0,0,16,13,29,107,96,203,427
20192020,056,JEFFERSON,275,Jefferson County,079,Kerrick Elementary,275079,056275079,210299000672,"",909,KG,35,37,17,15,32,0,0,0,1,0,1,2,1,3,0,0,0,2,3,5,15,16,31,72
20192020,056,JEFFERSON,275,Jefferson County,079,Kerrick Elementary,275079,056275079,210299000672,"",909,01,40,30,11,13,24,0,0,0,0,2,2,1,2,3,0,0,0,4,4,8,14,19,33,70
20192020,056,JEFFERSON,275,Jefferson County,079,Kerrick Elementary,275079,056275079,210299000672,"",909,02,29,33,9,13,22,0,0,0,0,0,0,0,2,2,0,0,0,5,4,9,19,10,29,62
20192020,056,JEFFERSON,275,Jefferson County,079,Kerrick Elementary,275079,056275079,210299000672,"",909,03,37,43,17,17,34,0,0,0,0,0,0,1,6,7,0,0,0,2,0,2,23,14,37,80
20192020,056,JEFFERSON,275,Jefferson County,079,Kerrick Elementary,275079,056275079,210299000672,"",909,04,37,41,11,18,29,0,0,0,0,0,0,0,1,1,0,0,0,1,0,1,29,18,47,78
20192020,056,JEFFERSON,275,Jefferson County,081,Rangeland Elementary,275081,056275081,210299000674,"",909,04,35,48,23,15,38,0,0,0,2,1,3,14,13,27,0,0,0,1,2,3,8,4,12,83
20192020,056,JEFFERSON,275,Jefferson County,081,Rangeland Elementary,275081,056275081,210299000674,"",909,All Students,193,225,104,78,182,0,0,0,18,13,31,58,62,120,0,0,0,9,9,18,36,31,67,418
20192020,056,JEFFERSON,275,Jefferson County,081,Rangeland Elementary,275081,056275081,210299000674,"",909,KG,32,42,16,17,33,0,0,0,1,2,3,12,9,21,0,0,0,3,2,5,10,2,12,74
20192020,056,JEFFERSON,275,Jefferson County,081,Rangeland Elementary,275081,056275081,210299000674,"",909,01,30,44,17,9,26,0,0,0,5,4,9,12,11,23,0,0,0,2,2,4,8,4,12,74
20192020,056,JEFFERSON,275,Jefferson County,081,Rangeland Elementary,275081,056275081,210299000674,"",909,02,22,25,12,11,23,0,0,0,5,0,5,6,8,14,0,0,0,1,2,3,1,1,2,47
20192020,056,JEFFERSON,275,Jefferson County,081,Rangeland Elementary,275081,056275081,210299000674,"",909,03,37,36,15,14,29,0,0,0,3,2,5,10,12,22,0,0,0,2,0,2,6,9,15,73
20192020,056,JEFFERSON,275,Jefferson County,081,Rangeland Elementary,275081,056275081,210299000674,"",909,05,37,30,21,12,33,0,0,0,2,4,6,4,9,13,0,0,0,0,1,1,3,11,14,67
20192020,056,JEFFERSON,275,Jefferson County,082,Dixie Elementary,275082,056275082,210299000675,"",909,04,38,26,16,18,34,0,0,0,0,0,0,1,2,3,0,0,0,2,6,8,7,12,19,64
20192020,056,JEFFERSON,275,Jefferson County,082,Dixie Elementary,275082,056275082,210299000675,"",909,All Students,182,176,73,73,146,0,0,0,1,3,4,12,14,26,1,1,2,11,21,32,78,70,148,358
20192020,056,JEFFERSON,275,Jefferson County,082,Dixie Elementary,275082,056275082,210299000675,"",909,PS,20,18,4,2,6,0,0,0,2,1,3,1,3,4,1,0,1,2,2,4,8,12,20,38
20192020,056,JEFFERSON,275,Jefferson County,082,Dixie Elementary,275082,056275082,210299000675,"",909,KG,22,30,10,9,19,0,0,0,1,2,3,1,1,2,1,0,1,2,3,5,15,7,22,52
20192020,056,JEFFERSON,275,Jefferson County,082,Dixie Elementary,275082,056275082,210299000675,"",909,01,34,34,17,13,30,0,0,0,0,0,0,2,6,8,0,0,0,3,4,7,12,11,23,68
20192020,056,JEFFERSON,275,Jefferson County,082,Dixie Elementary,275082,056275082,210299000675,"",909,02,23,24,8,8,16,0,0,0,0,1,1,2,2,4,0,0,0,1,3,4,13,9,22,47
20192020,056,JEFFERSON,275,Jefferson County,082,Dixie Elementary,275082,056275082,210299000675,"",909,03,28,31,8,10,18,0,0,0,0,0,0,3,2,5,0,0,0,2,3,5,18,13,31,59
20192020,056,JEFFERSON,275,Jefferson County,082,Dixie Elementary,275082,056275082,210299000675,"",909,05,37,31,14,15,29,0,0,0,0,0,0,3,1,4,0,1,1,1,2,3,13,18,31,68
20192020,056,JEFFERSON,275,Jefferson County,083,Cochrane Elementary,275083,056275083,210299000676,"",909,04,35,28,6,7,13,0,0,0,4,1,5,9,12,21,0,0,0,1,3,4,8,12,20,63
20192020,056,JEFFERSON,275,Jefferson County,083,Cochrane Elementary,275083,056275083,210299000676,"",909,All Students,228,221,45,54,99,0,0,0,15,15,30,72,62,134,3,1,4,9,19,28,77,77,154,449
20192020,056,JEFFERSON,275,Jefferson County,083,Cochrane Elementary,275083,056275083,210299000676,"",909,PS,20,20,5,6,11,0,0,0,0,1,1,8,7,15,0,0,0,1,3,4,6,3,9,40
20192020,056,JEFFERSON,275,Jefferson County,083,Cochrane Elementary,275083,056275083,210299000676,"",909,KG,40,38,11,10,21,0,0,0,5,4,9,10,6,16,0,1,1,2,5,7,10,14,24,78
20192020,056,JEFFERSON,275,Jefferson County,083,Cochrane Elementary,275083,056275083,210299000676,"",909,01,32,42,8,10,18,0,0,0,2,2,4,12,8,20,1,0,1,1,3,4,18,9,27,74
20192020,056,JEFFERSON,275,Jefferson County,083,Cochrane Elementary,275083,056275083,210299000676,"",909,02,36,40,8,3,11,0,0,0,2,3,5,14,12,26,0,0,0,2,2,4,14,16,30,76
20192020,056,JEFFERSON,275,Jefferson County,083,Cochrane Elementary,275083,056275083,210299000676,"",909,03,39,37,9,14,23,0,0,0,1,1,2,9,13,22,2,0,2,1,1,2,15,10,25,76
20192020,056,JEFFERSON,275,Jefferson County,083,Cochrane Elementary,275083,056275083,210299000676,"",909,05,46,36,3,10,13,0,0,0,1,4,5,18,11,29,0,0,0,2,5,7,12,16,28,82
20192020,056,JEFFERSON,275,Jefferson County,084,Western High,275084,056275084,210299000677,"",909,12,63,83,59,46,105,0,0,0,0,0,0,8,1,9,0,0,0,0,3,3,16,13,29,146
20192020,056,JEFFERSON,275,Jefferson County,084,Western High,275084,056275084,210299000677,"",909,All Students,291,385,269,208,477,0,0,0,1,0,1,24,11,35,1,1,2,9,14,23,81,57,138,676
20192020,056,JEFFERSON,275,Jefferson County,084,Western High,275084,056275084,210299000677,"",909,09,94,130,91,68,159,0,0,0,0,0,0,8,0,8,0,0,0,3,6,9,28,20,48,224
20192020,056,JEFFERSON,275,Jefferson County,084,Western High,275084,056275084,210299000677,"",909,10,69,76,50,46,96,0,0,0,0,0,0,6,8,14,0,1,1,2,3,5,18,11,29,145
20192020,056,JEFFERSON,275,Jefferson County,084,Western High,275084,056275084,210299000677,"",909,11,63,90,64,47,111,0,0,0,1,0,1,2,2,4,1,0,1,4,2,6,18,12,30,153
20192020,056,JEFFERSON,275,Jefferson County,084,Western High,275084,056275084,210299000677,"",909,14,2,6,5,1,6,0,0,0,0,0,0,0,0,0,0,0,0,0,0,0,1,1,2,8
20192020,056,JEFFERSON,275,Jefferson County,085,Robert Frost Sixth-Grade Academy,275085,056275085,210299000678,"",909,All Students,194,246,115,81,196,0,0,0,3,0,3,16,22,38,3,0,3,21,7,28,88,84,172,440
20192020,056,JEFFERSON,275,Jefferson County,085,Robert Frost Sixth-Grade Academy,275085,056275085,210299000678,"",909,06,194,246,115,81,196,0,0,0,3,0,3,16,22,38,3,0,3,21,7,28,88,84,172,440
20192020,056,JEFFERSON,275,Jefferson County,086,Sanders Elementary,275086,056275086,210299000679,"",909,03,36,35,15,22,37,0,0,0,0,0,0,0,1,1,0,0,0,2,1,3,18,12,30,71
20192020,056,JEFFERSON,275,Jefferson County,086,Sanders Elementary,275086,056275086,210299000679,"",909,All Students,206,215,77,80,157,0,1,1,1,0,1,10,9,19,0,0,0,19,17,36,108,99,207,421
20192020,056,JEFFERSON,275,Jefferson County,086,Sanders Elementary,275086,056275086,210299000679,"",909,KG,40,29,11,9,20,0,1,1,0,0,0,1,5,6,0,0,0,2,6,8,15,19,34,69
20192020,056,JEFFERSON,275,Jefferson County,086,Sanders Elementary,275086,056275086,210299000679,"",909,01,38,41,18,16,34,0,0,0,0,0,0,3,0,3,0,0,0,5,4,9,15,18,33,79
20192020,056,JEFFERSON,275,Jefferson County,086,Sanders Elementary,275086,056275086,210299000679,"",909,02,24,22,7,12,19,0,0,0,1,0,1,2,0,2,0,0,0,1,2,3,11,10,21,46
20192020,056,JEFFERSON,275,Jefferson County,086,Sanders Elementary,275086,056275086,210299000679,"",909,04,36,43,13,9,22,0,0,0,0,0,0,2,0,2,0,0,0,3,3,6,25,24,49,79
20192020,056,JEFFERSON,275,Jefferson County,086,Sanders Elementary,275086,056275086,210299000679,"",909,05,32,45,13,12,25,0,0,0,0,0,0,2,3,5,0,0,0,6,1,7,24,16,40,77
20192020,056,JEFFERSON,275,Jefferson County,087,Smyrna Elementary School,275087,056275087,210299000680,"",909,05,31,42,12,16,28,0,0,0,0,0,0,3,5,8,0,0,0,4,2,6,23,8,31,73
20192020,056,JEFFERSON,275,Jefferson County,087,Smyrna Elementary School,275087,056275087,210299000680,"",909,All Students,220,252,80,73,153,0,0,0,9,3,12,37,28,65,0,0,0,16,20,36,110,96,206,472
20192020,056,JEFFERSON,275,Jefferson County,087,Smyrna Elementary School,275087,056275087,210299000680,"",909,PS,23,37,8,8,16,0,0,0,5,2,7,8,4,12,0,0,0,7,1,8,9,8,17,60
20192020,056,JEFFERSON,275,Jefferson County,087,Smyrna Elementary School,275087,056275087,210299000680,"",909,KG,32,47,11,10,21,0,0,0,3,1,4,7,5,12,0,0,0,3,4,7,23,12,35,79
20192020,056,JEFFERSON,275,Jefferson County,087,Smyrna Elementary School,275087,056275087,210299000680,"",909,01,30,42,11,6,17,0,0,0,1,1,2,8,1,9,0,0,0,1,1,2,21,21,42,72
20192020,056,JEFFERSON,275,Jefferson County,087,Smyrna Elementary School,275087,056275087,210299000680,"",909,02,39,29,9,14,23,0,0,0,0,0,0,6,5,11,0,0,0,2,2,4,12,18,30,68
20192020,056,JEFFERSON,275,Jefferson County,087,Smyrna Elementary School,275087,056275087,210299000680,"",909,03,46,50,21,16,37,0,0,0,2,1,3,9,5,14,0,0,0,2,7,9,16,17,33,96
20192020,056,JEFFERSON,275,Jefferson County,087,Smyrna Elementary School,275087,056275087,210299000680,"",909,04,42,42,16,11,27,0,0,0,3,0,3,4,7,11,0,0,0,4,4,8,15,20,35,84
20192020,056,JEFFERSON,275,Jefferson County,090,Thomas Jefferson Middle,275090,056275090,210299000682,"",909,07,182,210,81,79,160,0,1,1,8,6,14,59,53,112,1,0,1,8,12,20,53,31,84,392
20192020,056,JEFFERSON,275,Jefferson County,090,Thomas Jefferson Middle,275090,056275090,210299000682,"",909,All Students,481,594,225,202,427,2,1,3,26,20,46,173,145,318,1,0,1,26,25,51,141,88,229,1075
20192020,056,JEFFERSON,275,Jefferson County,090,Thomas Jefferson Middle,275090,056275090,210299000682,"",909,06,146,187,69,60,129,1,0,1,11,7,18,61,46,107,0,0,0,7,9,16,38,24,62,333
20192020,056,JEFFERSON,275,Jefferson County,090,Thomas Jefferson Middle,275090,056275090,210299000682,"",909,08,153,197,75,63,138,1,0,1,7,7,14,53,46,99,0,0,0,11,4,15,50,33,83,350
20192020,056,JEFFERSON,275,Jefferson County,091,Blue Lick Elementary,275091,056275091,210299000683,"",909,KG,39,45,8,6,14,0,0,0,0,0,0,6,4,10,0,0,0,4,3,7,27,26,53,84
20192020,056,JEFFERSON,275,Jefferson County,091,Blue Lick Elementary,275091,056275091,210299000683,"",909,All Students,219,235,55,54,109,0,0,0,1,0,1,33,28,61,0,1,1,21,17,38,125,119,244,454
20192020,056,JEFFERSON,275,Jefferson County,091,Blue Lick Elementary,275091,056275091,210299000683,"",909,PS,25,35,4,5,9,0,0,0,0,2,2,8,4,12,0,0,0,1,0,1,22,14,36,60
20192020,056,JEFFERSON,275,Jefferson County,091,Blue Lick Elementary,275091,056275091,210299000683,"",909,01,43,35,8,10,18,0,0,0,0,0,0,4,4,8,0,0,0,5,3,8,18,26,44,78
20192020,056,JEFFERSON,275,Jefferson County,091,Blue Lick Elementary,275091,056275091,210299000683,"",909,02,31,36,11,9,20,0,0,0,0,0,0,5,2,7,0,0,0,2,0,2,18,20,38,67
20192020,056,JEFFERSON,275,Jefferson County,091,Blue Lick Elementary,275091,056275091,210299000683,"",909,03,34,38,5,9,14,0,0,0,1,0,1,7,7,14,0,0,0,4,4,8,21,14,35,72
20192020,056,JEFFERSON,275,Jefferson County,091,Blue Lick Elementary,275091,056275091,210299000683,"",909,04,37,43,14,11,25,0,0,0,0,0,0,5,7,12,0,0,0,2,3,5,22,16,38,80
20192020,056,JEFFERSON,275,Jefferson County,091,Blue Lick Elementary,275091,056275091,210299000683,"",909,05,35,38,9,9,18,0,0,0,0,0,0,6,4,10,0,1,1,4,4,8,19,17,36,73
20192020,056,JEFFERSON,275,Jefferson County,092,Crums Lane Elementary,275092,056275092,210299000684,"",909,05,34,35,29,25,54,0,0,0,0,0,0,0,2,2,0,0,0,1,3,4,5,4,9,69
20192020,056,JEFFERSON,275,Jefferson County,092,Crums Lane Elementary,275092,056275092,210299000684,"",909,All Students,185,242,188,139,327,0,0,0,1,0,1,8,7,15,0,0,0,7,13,20,38,26,64,427
20192020,056,JEFFERSON,275,Jefferson County,092,Crums Lane Elementary,275092,056275092,210299000684,"",909,KG,30,35,28,20,48,0,0,0,0,0,0,3,1,4,0,0,0,0,3,3,4,6,10,65
20192020,056,JEFFERSON,275,Jefferson County,092,Crums Lane Elementary,275092,056275092,210299000684,"",909,01,27,56,43,24,67,0,0,0,0,0,0,1,0,1,0,0,0,3,1,4,9,2,11,83
20192020,056,JEFFERSON,275,Jefferson County,092,Crums Lane Elementary,275092,056275092,210299000684,"",909,02,27,35,29,21,50,0,0,0,0,0,0,0,0,0,0,0,0,0,1,1,6,5,11,62
20192020,056,JEFFERSON,275,Jefferson County,092,Crums Lane Elementary,275092,056275092,210299000684,"",909,03,39,44,33,29,62,0,0,0,0,0,0,2,2,4,0,0,0,2,3,5,7,5,12,83
20192020,056,JEFFERSON,275,Jefferson County,092,Crums Lane Elementary,275092,056275092,210299000684,"",909,04,28,37,26,20,46,0,0,0,1,0,1,2,2,4,0,0,0,1,2,3,7,4,11,65
20192020,056,JEFFERSON,275,Jefferson County,094,Bowen Elementary,275094,056275094,210299000685,"",909,03,68,57,9,13,22,0,0,0,5,5,10,9,13,22,0,0,0,5,4,9,29,33,62,125
20192020,056,JEFFERSON,275,Jefferson County,094,Bowen Elementary,275094,056275094,210299000685,"",909,05,54,63,5,4,9,0,0,0,5,7,12,11,5,16,0,0,0,10,1,11,32,37,69,117
20192020,056,JEFFERSON,275,Jefferson County,094,Bowen Elementary,275094,056275094,210299000685,"",909,All Students,350,372,49,44,93,1,0,1,27,27,54,66,65,131,0,1,1,33,17,50,196,196,392,722
20192020,056,JEFFERSON,275,Jefferson County,094,Bowen Elementary,275094,056275094,210299000685,"",909,KG,64,60,9,7,16,1,0,1,3,5,8,10,11,21,0,0,0,3,2,5,34,39,73,124
20192020,056,JEFFERSON,275,Jefferson County,094,Bowen Elementary,275094,056275094,210299000685,"",909,01,67,59,4,8,12,0,0,0,5,1,6,12,18,30,0,0,0,4,4,8,34,36,70,126
20192020,056,JEFFERSON,275,Jefferson County,094,Bowen Elementary,275094,056275094,210299000685,"",909,02,45,64,11,6,17,0,0,0,7,4,11,8,8,16,0,1,1,6,2,8,32,24,56,109
20192020,056,JEFFERSON,275,Jefferson County,094,Bowen Elementary,275094,056275094,210299000685,"",909,04,52,69,11,6,17,0,0,0,2,5,7,16,10,26,0,0,0,5,4,9,35,27,62,121
20192020,056,JEFFERSON,275,Jefferson County,095,Hite Elementary,275095,056275095,210299000686,"",909,04,40,45,6,8,14,0,0,0,4,2,6,1,1,2,0,0,0,4,4,8,30,25,55,85
20192020,056,JEFFERSON,275,Jefferson County,095,Hite Elementary,275095,056275095,210299000686,"",909,05,48,42,5,5,10,0,0,0,2,4,6,1,4,5,0,0,0,4,3,7,30,32,62,90
20192020,056,JEFFERSON,275,Jefferson County,095,Hite Elementary,275095,056275095,210299000686,"",909,03,40,34,4,4,8,0,0,0,1,2,3,0,1,1,0,0,0,5,4,9,24,29,53,74
20192020,056,JEFFERSON,275,Jefferson County,095,Hite Elementary,275095,056275095,210299000686,"",909,All Students,236,244,28,34,62,0,0,0,15,15,30,11,15,26,0,0,0,20,23,43,170,149,319,480
20192020,056,JEFFERSON,275,Jefferson County,095,Hite Elementary,275095,056275095,210299000686,"",909,KG,35,48,3,4,7,0,0,0,3,1,4,1,4,5,0,0,0,2,5,7,39,21,60,83
20192020,056,JEFFERSON,275,Jefferson County,095,Hite Elementary,275095,056275095,210299000686,"",909,01,35,41,6,3,9,0,0,0,3,1,4,4,4,8,0,0,0,4,5,9,24,22,46,76
20192020,056,JEFFERSON,275,Jefferson County,095,Hite Elementary,275095,056275095,210299000686,"",909,02,38,34,4,10,14,0,0,0,2,5,7,4,1,5,0,0,0,1,2,3,23,20,43,72
20192020,056,JEFFERSON,275,Jefferson County,096,Norton Elementary,275096,056275096,210299000687,"",909,03,59,74,4,6,10,0,0,0,6,4,10,3,4,7,0,0,0,9,6,15,52,39,91,133
20192020,056,JEFFERSON,275,Jefferson County,096,Norton Elementary,275096,056275096,210299000687,"",909,All Students,343,398,40,42,82,2,2,4,54,42,96,20,15,35,1,0,1,26,22,48,255,220,475,741
20192020,056,JEFFERSON,275,Jefferson County,096,Norton Elementary,275096,056275096,210299000687,"",909,KG,58,68,8,10,18,1,0,1,7,7,14,3,2,5,1,0,1,3,5,8,45,34,79,126
20192020,056,JEFFERSON,275,Jefferson County,096,Norton Elementary,275096,056275096,210299000687,"",909,01,62,63,6,9,15,0,1,1,11,10,21,3,0,3,0,0,0,4,3,7,39,39,78,125
20192020,056,JEFFERSON,275,Jefferson County,096,Norton Elementary,275096,056275096,210299000687,"",909,02,58,59,8,7,15,0,0,0,6,9,15,4,7,11,0,0,0,4,2,6,37,33,70,117
20192020,056,JEFFERSON,275,Jefferson County,096,Norton Elementary,275096,056275096,210299000687,"",909,04,49,70,9,3,12,1,0,1,13,6,19,1,0,1,0,0,0,1,3,4,45,37,82,119
20192020,056,JEFFERSON,275,Jefferson County,096,Norton Elementary,275096,056275096,210299000687,"",909,05,57,64,5,7,12,0,1,1,11,6,17,6,2,8,0,0,0,5,3,8,37,38,75,121
20192020,056,JEFFERSON,275,Jefferson County,097,Shacklette Elementary,275097,056275097,210299000688,"",909,04,27,29,11,14,25,0,0,0,0,1,1,10,7,17,0,0,0,1,1,2,7,4,11,56
20192020,056,JEFFERSON,275,Jefferson County,097,Shacklette Elementary,275097,056275097,210299000688,"",909,05,34,37,12,12,24,0,0,0,2,2,4,10,7,17,0,0,0,2,4,6,11,9,20,71
20192020,056,JEFFERSON,275,Jefferson County,097,Shacklette Elementary,275097,056275097,210299000688,"",909,All Students,151,175,57,50,107,0,0,0,12,7,19,49,39,88,0,0,0,10,14,24,47,41,88,326
20192020,056,JEFFERSON,275,Jefferson County,097,Shacklette Elementary,275097,056275097,210299000688,"",909,PS,31,49,19,14,33,0,0,0,1,1,2,9,8,17,0,0,0,3,2,5,17,6,23,80
20192020,056,JEFFERSON,275,Jefferson County,097,Shacklette Elementary,275097,056275097,210299000688,"",909,KG,22,27,9,5,14,0,0,0,2,1,3,6,6,12,0,0,0,4,4,8,6,6,12,49
20192020,056,JEFFERSON,275,Jefferson County,097,Shacklette Elementary,275097,056275097,210299000688,"",909,01,28,26,10,4,14,0,0,0,1,2,3,7,11,18,0,0,0,2,2,4,6,9,15,54
20192020,056,JEFFERSON,275,Jefferson County,097,Shacklette Elementary,275097,056275097,210299000688,"",909,02,18,25,6,9,15,0,0,0,1,0,1,7,3,10,0,0,0,0,2,2,11,4,15,43
20192020,056,JEFFERSON,275,Jefferson County,097,Shacklette Elementary,275097,056275097,210299000688,"",909,03,22,31,9,6,15,0,0,0,6,1,7,9,5,14,0,0,0,1,1,2,6,9,15,53
20192020,056,JEFFERSON,275,Jefferson County,099,Minors Lane Elementary,275099,056275099,210299000690,"",909,03,26,24,6,3,9,0,0,0,2,2,4,15,17,32,0,0,0,0,1,1,1,3,4,50
20192020,056,JEFFERSON,275,Jefferson County,099,Minors Lane Elementary,275099,056275099,210299000690,"",909,05,29,39,13,7,20,0,0,0,4,1,5,14,12,26,0,0,0,2,1,3,6,8,14,68
20192020,056,JEFFERSON,275,Jefferson County,099,Minors Lane Elementary,275099,056275099,210299000690,"",909,All Students,180,179,57,51,108,0,0,0,9,7,16,73,90,163,0,0,0,5,3,8,35,29,64,359
20192020,056,JEFFERSON,275,Jefferson County,099,Minors Lane Elementary,275099,056275099,210299000690,"",909,PS,21,33,4,4,8,0,0,0,1,2,3,15,12,27,0,0,0,2,1,3,11,2,13,54
20192020,056,JEFFERSON,275,Jefferson County,099,Minors Lane Elementary,275099,056275099,210299000690,"",909,KG,29,26,6,7,13,0,0,0,0,1,1,11,17,28,0,0,0,2,0,2,7,4,11,55
20192020,056,JEFFERSON,275,Jefferson County,099,Minors Lane Elementary,275099,056275099,210299000690,"",909,01,31,32,11,10,21,0,0,0,1,1,2,10,15,25,0,0,0,0,0,0,10,5,15,63
20192020,056,JEFFERSON,275,Jefferson County,099,Minors Lane Elementary,275099,056275099,210299000690,"",909,02,20,16,4,7,11,0,0,0,1,0,1,7,10,17,0,0,0,0,1,1,4,2,6,36
20192020,056,JEFFERSON,275,Jefferson County,099,Minors Lane Elementary,275099,056275099,210299000690,"",909,04,45,42,17,17,34,0,0,0,1,2,3,16,19,35,0,0,0,1,0,1,7,7,14,87
20192020,056,JEFFERSON,275,Jefferson County,100,Doss High,275100,056275100,210299000691,"",909,11,99,111,55,41,96,0,0,0,2,0,2,15,18,33,1,1,2,2,7,9,36,32,68,210
20192020,056,JEFFERSON,275,Jefferson County,100,Doss High,275100,056275100,210299000691,"",909,14,1,7,3,0,3,0,0,0,0,0,0,0,0,0,0,0,0,0,0,0,4,1,5,8
20192020,056,JEFFERSON,275,Jefferson County,100,Doss High,275100,056275100,210299000691,"",909,All Students,437,547,266,219,485,1,0,1,18,10,28,96,73,169,2,4,6,10,13,23,154,118,272,984
20192020,056,JEFFERSON,275,Jefferson County,100,Doss High,275100,056275100,210299000691,"",909,09,113,143,61,62,123,0,0,0,7,2,9,38,18,56,1,1,2,1,2,3,35,28,63,256
20192020,056,JEFFERSON,275,Jefferson County,100,Doss High,275100,056275100,210299000691,"",909,10,113,145,68,52,120,1,0,1,6,4,10,22,22,44,0,2,2,2,4,6,46,29,75,258
20192020,056,JEFFERSON,275,Jefferson County,100,Doss High,275100,056275100,210299000691,"",909,12,111,141,79,64,143,0,0,0,3,4,7,21,15,36,0,0,0,5,0,5,33,28,61,252
20192020,056,JEFFERSON,275,Jefferson County,102,Chancey Elementary,275102,056275102,210299001959,"",909,03,47,50,19,22,41,0,0,0,1,2,3,9,7,16,0,0,0,4,7,11,17,9,26,97
20192020,056,JEFFERSON,275,Jefferson County,102,Chancey Elementary,275102,056275102,210299001959,"",909,05,60,54,20,23,43,0,0,0,1,3,4,11,7,18,0,0,0,7,5,12,15,22,37,114
20192020,056,JEFFERSON,275,Jefferson County,102,Chancey Elementary,275102,056275102,210299001959,"",909,All Students,274,300,115,114,229,0,0,0,9,13,22,63,44,107,1,0,1,24,32,56,88,71,159,574
20192020,056,JEFFERSON,275,Jefferson County,102,Chancey Elementary,275102,056275102,210299001959,"",909,KG,46,46,20,16,36,0,0,0,3,4,7,10,8,18,0,0,0,4,6,10,9,12,21,92
20192020,056,JEFFERSON,275,Jefferson County,102,Chancey Elementary,275102,056275102,210299001959,"",909,01,36,55,17,12,29,0,0,0,2,1,3,16,7,23,0,0,0,2,5,7,18,11,29,91
20192020,056,JEFFERSON,275,Jefferson County,102,Chancey Elementary,275102,056275102,210299001959,"",909,02,40,32,12,22,34,0,0,0,1,1,2,9,7,16,0,0,0,2,4,6,8,6,14,72
20192020,056,JEFFERSON,275,Jefferson County,102,Chancey Elementary,275102,056275102,210299001959,"",909,04,45,63,27,19,46,0,0,0,1,2,3,8,8,16,1,0,1,5,5,10,21,11,32,108
20192020,056,JEFFERSON,275,Jefferson County,103,Slaughter Elementary,275103,056275103,210299000693,"",909,03,43,39,12,18,30,0,0,0,0,1,1,24,16,40,0,0,0,2,3,5,1,5,6,82
20192020,056,JEFFERSON,275,Jefferson County,103,Slaughter Elementary,275103,056275103,210299000693,"",909,05,28,36,12,15,27,0,0,0,0,0,0,20,8,28,1,0,1,0,3,3,3,2,5,64
20192020,056,JEFFERSON,275,Jefferson County,103,Slaughter Elementary,275103,056275103,210299000693,"",909,All Students,203,225,75,79,154,0,1,1,2,3,5,109,92,201,2,0,2,8,9,17,29,19,48,428
20192020,056,JEFFERSON,275,Jefferson County,103,Slaughter Elementary,275103,056275103,210299000693,"",909,KG,34,39,11,10,21,0,1,1,0,1,1,18,20,38,0,0,0,0,1,1,10,1,11,73
20192020,056,JEFFERSON,275,Jefferson County,103,Slaughter Elementary,275103,056275103,210299000693,"",909,01,37,38,10,12,22,0,0,0,1,0,1,16,20,36,0,0,0,4,0,4,7,5,12,75
20192020,056,JEFFERSON,275,Jefferson County,103,Slaughter Elementary,275103,056275103,210299000693,"",909,02,26,27,13,7,20,0,0,0,1,1,2,11,13,24,0,0,0,1,1,2,1,4,5,53
20192020,056,JEFFERSON,275,Jefferson County,103,Slaughter Elementary,275103,056275103,210299000693,"",909,04,35,46,17,17,34,0,0,0,0,0,0,20,15,35,1,0,1,1,1,2,7,2,9,81
20192020,056,JEFFERSON,275,Jefferson County,104,Trunnell Elementary,275104,056275104,210299000694,"",909,05,33,38,15,12,27,0,0,0,1,0,1,8,7,15,0,0,0,2,1,3,12,13,25,71
20192020,056,JEFFERSON,275,Jefferson County,104,Trunnell Elementary,275104,056275104,210299000694,"",909,All Students,203,209,80,83,163,1,0,1,3,7,10,46,41,87,0,0,0,9,10,19,70,62,132,412
20192020,056,JEFFERSON,275,Jefferson County,104,Trunnell Elementary,275104,056275104,210299000694,"",909,PS,20,40,17,7,24,0,0,0,1,1,2,2,5,7,0,0,0,3,1,4,17,6,23,60
20192020,056,JEFFERSON,275,Jefferson County,104,Trunnell Elementary,275104,056275104,210299000694,"",909,KG,36,39,13,14,27,0,0,0,0,2,2,13,8,21,0,0,0,2,1,3,11,11,22,75
20192020,056,JEFFERSON,275,Jefferson County,104,Trunnell Elementary,275104,056275104,210299000694,"",909,01,35,34,12,15,27,0,0,0,1,2,3,8,9,17,0,0,0,2,2,4,11,7,18,69
20192020,056,JEFFERSON,275,Jefferson County,104,Trunnell Elementary,275104,056275104,210299000694,"",909,02,34,31,18,15,33,1,0,1,0,0,0,3,7,10,0,0,0,0,1,1,9,11,20,65
20192020,056,JEFFERSON,275,Jefferson County,104,Trunnell Elementary,275104,056275104,210299000694,"",909,03,32,34,11,15,26,0,0,0,1,0,1,5,4,9,0,0,0,1,4,5,16,9,25,66
20192020,056,JEFFERSON,275,Jefferson County,104,Trunnell Elementary,275104,056275104,210299000694,"",909,04,33,33,11,12,23,0,0,0,0,3,3,9,6,15,0,0,0,2,1,3,11,11,22,66
20192020,056,JEFFERSON,275,Jefferson County,105,Ballard High,275105,056275105,210299000695,"",909,14,4,9,3,1,4,0,0,0,0,0,0,2,0,2,0,0,0,0,0,0,4,3,7,13
20192020,056,JEFFERSON,275,Jefferson County,105,Ballard High,275105,056275105,210299000695,"",909,All Students,1005,913,296,275,571,0,3,3,42,55,97,48,67,115,1,0,1,36,39,75,490,566,1056,1918
20192020,056,JEFFERSON,275,Jefferson County,105,Ballard High,275105,056275105,210299000695,"",909,09,287,262,80,81,161,0,2,2,23,13,36,14,25,39,0,0,0,12,15,27,133,151,284,549
20192020,056,JEFFERSON,275,Jefferson County,105,Ballard High,275105,056275105,210299000695,"",909,10,264,247,82,82,164,0,1,1,6,16,22,10,20,30,0,0,0,9,9,18,140,136,276,511
20192020,056,JEFFERSON,275,Jefferson County,105,Ballard High,275105,056275105,210299000695,"",909,11,230,212,77,48,125,0,0,0,6,18,24,14,13,27,1,0,1,7,8,15,107,143,250,442
20192020,056,JEFFERSON,275,Jefferson County,105,Ballard High,275105,056275105,210299000695,"",909,12,220,183,54,63,117,0,0,0,7,8,15,8,9,17,0,0,0,8,7,15,106,133,239,403
20192020,056,JEFFERSON,275,Jefferson County,106,Johnsontown Road Elementary,275106,056275106,210299000696,"",909,04,25,27,11,9,20,0,0,0,0,0,0,0,3,3,0,0,0,0,0,0,16,13,29,52
20192020,056,JEFFERSON,275,Jefferson County,106,Johnsontown Road Elementary,275106,056275106,210299000696,"",909,03,20,34,14,11,25,0,0,0,1,0,1,4,2,6,0,0,0,1,1,2,14,6,20,54
20192020,056,JEFFERSON,275,Jefferson County,106,Johnsontown Road Elementary,275106,056275106,210299000696,"",909,05,28,44,19,11,30,0,0,0,0,0,0,2,4,6,0,0,0,3,1,4,20,12,32,72
20192020,056,JEFFERSON,275,Jefferson County,106,Johnsontown Road Elementary,275106,056275106,210299000696,"",909,All Students,139,182,74,57,131,0,0,0,1,0,1,8,12,20,0,0,0,9,5,14,90,65,155,321
20192020,056,JEFFERSON,275,Jefferson County,106,Johnsontown Road Elementary,275106,056275106,210299000696,"",909,KG,22,27,8,10,18,0,0,0,0,0,0,1,1,2,0,0,0,2,0,2,16,11,27,49
20192020,056,JEFFERSON,275,Jefferson County,106,Johnsontown Road Elementary,275106,056275106,210299000696,"",909,01,24,26,12,11,23,0,0,0,0,0,0,0,0,0,0,0,0,2,3,5,12,10,22,50
20192020,056,JEFFERSON,275,Jefferson County,106,Johnsontown Road Elementary,275106,056275106,210299000696,"",909,02,20,24,10,5,15,0,0,0,0,0,0,1,2,3,0,0,0,1,0,1,12,13,25,44
20192020,056,JEFFERSON,275,Jefferson County,107,Luhr Elementary,275107,056275107,210299000697,"",909,03,42,39,9,12,21,0,0,0,6,4,10,10,8,18,0,0,0,1,0,1,13,18,31,81
20192020,056,JEFFERSON,275,Jefferson County,107,Luhr Elementary,275107,056275107,210299000697,"",909,05,30,47,18,11,29,0,0,0,3,4,7,16,8,24,0,0,0,2,1,3,8,6,14,77
20192020,056,JEFFERSON,275,Jefferson County,107,Luhr Elementary,275107,056275107,210299000697,"",909,All Students,216,263,73,64,137,0,0,0,24,21,45,66,43,109,2,0,2,12,11,23,86,77,163,479
20192020,056,JEFFERSON,275,Jefferson County,107,Luhr Elementary,275107,056275107,210299000697,"",909,KG,35,44,16,10,26,0,0,0,3,5,8,8,2,10,0,0,0,2,2,4,15,16,31,79
20192020,056,JEFFERSON,275,Jefferson County,107,Luhr Elementary,275107,056275107,210299000697,"",909,01,39,41,10,13,23,0,0,0,6,2,8,11,9,20,1,0,1,3,1,4,10,14,24,80
20192020,056,JEFFERSON,275,Jefferson County,107,Luhr Elementary,275107,056275107,210299000697,"",909,02,34,41,6,8,14,0,0,0,2,4,6,12,8,20,1,0,1,1,3,4,19,11,30,75
20192020,056,JEFFERSON,275,Jefferson County,107,Luhr Elementary,275107,056275107,210299000697,"",909,04,36,51,14,10,24,0,0,0,4,2,6,9,8,17,0,0,0,3,4,7,21,12,33,87
20192020,056,JEFFERSON,275,Jefferson County,109,Wheeler Elementary,275109,056275109,210299000699,"",909,05,59,60,15,16,31,0,0,0,3,1,4,4,6,10,0,0,0,3,4,7,35,32,67,119
20192020,056,JEFFERSON,275,Jefferson County,109,Wheeler Elementary,275109,056275109,210299000699,"",909,All Students,324,332,67,62,129,0,1,1,12,20,32,23,19,42,1,1,2,21,29,50,208,192,400,656
20192020,056,JEFFERSON,275,Jefferson County,109,Wheeler Elementary,275109,056275109,210299000699,"",909,KG,55,49,10,11,21,0,0,0,5,0,5,1,1,2,0,1,1,8,4,12,25,38,63,104
20192020,056,JEFFERSON,275,Jefferson County,109,Wheeler Elementary,275109,056275109,210299000699,"",909,01,41,59,12,7,19,0,0,0,1,4,5,7,1,8,1,0,1,3,7,10,35,22,57,100
20192020,056,JEFFERSON,275,Jefferson County,109,Wheeler Elementary,275109,056275109,210299000699,"",909,02,51,53,9,7,16,0,1,1,0,5,5,5,4,9,0,0,0,2,4,6,37,30,67,104
20192020,056,JEFFERSON,275,Jefferson County,109,Wheeler Elementary,275109,056275109,210299000699,"",909,03,65,48,10,15,25,0,0,0,1,7,8,2,3,5,0,0,0,2,4,6,33,36,69,113
20192020,056,JEFFERSON,275,Jefferson County,109,Wheeler Elementary,275109,056275109,210299000699,"",909,04,53,63,11,6,17,0,0,0,2,3,5,4,4,8,0,0,0,3,6,9,43,34,77,116
20192020,056,JEFFERSON,275,Jefferson County,110,Western Day Treatment,275110,056275110,210299001857,"",909,03,1,5,4,0,4,0,0,0,0,0,0,0,0,0,0,0,0,0,0,0,1,1,2,6
20192020,056,JEFFERSON,275,Jefferson County,110,Western Day Treatment,275110,056275110,210299001857,"",909,04,2,2,1,2,3,0,0,0,0,0,0,1,0,1,0,0,0,0,0,0,0,0,0,4
20192020,056,JEFFERSON,275,Jefferson County,110,Western Day Treatment,275110,056275110,210299001857,"",909,All Students,5,18,11,3,14,0,0,0,1,0,1,1,0,1,0,0,0,0,0,0,5,2,7,23
20192020,056,JEFFERSON,275,Jefferson County,110,Western Day Treatment,275110,056275110,210299001857,"",909,KG,0,2,1,0,1,0,0,0,0,0,0,0,0,0,0,0,0,0,0,0,1,0,1,2
20192020,056,JEFFERSON,275,Jefferson County,110,Western Day Treatment,275110,056275110,210299001857,"",909,01,1,4,3,1,4,0,0,0,0,0,0,0,0,0,0,0,0,0,0,0,1,0,1,5
20192020,056,JEFFERSON,275,Jefferson County,110,Western Day Treatment,275110,056275110,210299001857,"",909,02,1,5,2,0,2,0,0,0,1,0,1,0,0,0,0,0,0,0,0,0,2,1,3,6
20192020,056,JEFFERSON,275,Jefferson County,115,Gutermuth Elementary,275115,056275115,210299000700,"",909,05,32,40,20,10,30,0,0,0,2,3,5,11,8,19,0,0,0,0,2,2,7,9,16,72
20192020,056,JEFFERSON,275,Jefferson County,115,Gutermuth Elementary,275115,056275115,210299000700,"",909,All Students,178,210,93,69,162,0,1,1,19,22,41,40,32,72,0,3,3,4,14,18,54,37,91,388
20192020,056,JEFFERSON,275,Jefferson County,115,Gutermuth Elementary,275115,056275115,210299000700,"",909,KG,29,40,15,9,24,0,0,0,3,6,9,10,3,13,0,0,0,0,2,2,12,9,21,69
20192020,056,JEFFERSON,275,Jefferson County,115,Gutermuth Elementary,275115,056275115,210299000700,"",909,01,35,38,17,16,33,0,0,0,6,6,12,5,10,15,0,0,0,1,1,2,9,2,11,73
20192020,056,JEFFERSON,275,Jefferson County,115,Gutermuth Elementary,275115,056275115,210299000700,"",909,02,21,23,9,8,17,0,0,0,2,3,5,2,3,5,0,1,1,1,1,2,9,5,14,44
20192020,056,JEFFERSON,275,Jefferson County,115,Gutermuth Elementary,275115,056275115,210299000700,"",909,03,33,40,20,15,35,0,1,1,4,1,5,5,5,10,0,1,1,2,3,5,9,7,16,73
20192020,056,JEFFERSON,275,Jefferson County,115,Gutermuth Elementary,275115,056275115,210299000700,"",909,04,28,29,12,11,23,0,0,0,2,3,5,7,3,10,0,1,1,0,5,5,8,5,13,57
20192020,056,JEFFERSON,275,Jefferson County,116,Wellington Elementary,275116,056275116,210299000701,"",909,All Students,228,211,123,126,249,0,0,0,2,0,2,14,13,27,0,0,0,13,16,29,59,73,132,439
20192020,056,JEFFERSON,275,Jefferson County,116,Wellington Elementary,275116,056275116,210299000701,"",909,KG,44,30,12,26,38,0,0,0,1,0,1,2,0,2,0,0,0,1,6,7,14,12,26,74
20192020,056,JEFFERSON,275,Jefferson County,116,Wellington Elementary,275116,056275116,210299000701,"",909,03,41,41,25,22,47,0,0,0,0,0,0,3,2,5,0,0,0,2,2,4,11,15,26,82
20192020,056,JEFFERSON,275,Jefferson County,116,Wellington Elementary,275116,056275116,210299000701,"",909,04,45,32,23,25,48,0,0,0,0,0,0,1,4,5,0,0,0,3,2,5,5,14,19,77
20192020,056,JEFFERSON,275,Jefferson County,116,Wellington Elementary,275116,056275116,210299000701,"",909,05,38,38,22,21,43,0,0,0,0,0,0,1,3,4,0,0,0,2,2,4,13,12,25,76
20192020,056,JEFFERSON,275,Jefferson County,116,Wellington Elementary,275116,056275116,210299000701,"",909,01,33,41,27,21,48,0,0,0,1,0,1,5,3,8,0,0,0,2,3,5,6,6,12,74
20192020,056,JEFFERSON,275,Jefferson County,116,Wellington Elementary,275116,056275116,210299000701,"",909,02,27,29,14,11,25,0,0,0,0,0,0,2,1,3,0,0,0,3,1,4,10,14,24,56
20192020,056,JEFFERSON,275,Jefferson County,117,Wilt Elementary,275117,056275117,210299000702,"",909,KG,38,43,9,6,15,0,0,0,4,2,6,6,4,10,0,0,0,6,2,8,18,24,42,81
20192020,056,JEFFERSON,275,Jefferson County,117,Wilt Elementary,275117,056275117,210299000702,"",909,All Students,221,266,55,43,98,0,2,2,18,14,32,47,37,84,0,0,0,26,9,35,120,116,236,487
20192020,056,JEFFERSON,275,Jefferson County,117,Wilt Elementary,275117,056275117,210299000702,"",909,PS,14,26,5,2,7,0,0,0,0,1,1,3,2,5,0,0,0,3,1,4,15,8,23,40
20192020,056,JEFFERSON,275,Jefferson County,117,Wilt Elementary,275117,056275117,210299000702,"",909,01,32,46,7,9,16,0,0,0,2,2,4,11,5,16,0,0,0,7,3,10,19,13,32,78
20192020,056,JEFFERSON,275,Jefferson County,117,Wilt Elementary,275117,056275117,210299000702,"",909,02,37,37,6,5,11,0,0,0,7,1,8,6,9,15,0,0,0,4,0,4,14,22,36,74
20192020,056,JEFFERSON,275,Jefferson County,117,Wilt Elementary,275117,056275117,210299000702,"",909,03,36,42,11,7,18,0,0,0,2,4,6,8,6,14,0,0,0,2,1,3,19,18,37,78
20192020,056,JEFFERSON,275,Jefferson County,117,Wilt Elementary,275117,056275117,210299000702,"",909,04,40,48,10,9,19,0,2,2,2,2,4,8,6,14,0,0,0,2,1,3,26,20,46,88
20192020,056,JEFFERSON,275,Jefferson County,117,Wilt Elementary,275117,056275117,210299000702,"",909,05,38,50,12,7,19,0,0,0,1,3,4,8,7,15,0,0,0,5,2,7,24,19,43,88
20192020,056,JEFFERSON,275,Jefferson County,119,Crosby Middle,275119,056275119,210299000703,"",909,07,154,191,61,54,115,0,0,0,13,6,19,12,10,22,0,0,0,8,8,16,97,76,173,345
20192020,056,JEFFERSON,275,Jefferson County,119,Crosby Middle,275119,056275119,210299000703,"",909,08,180,198,63,56,119,1,0,1,8,15,23,17,16,33,1,0,1,4,10,14,104,83,187,378
20192020,056,JEFFERSON,275,Jefferson County,119,Crosby Middle,275119,056275119,210299000703,"",909,All Students,507,567,167,175,342,1,0,1,32,31,63,49,41,90,1,0,1,20,24,44,297,236,533,1074
20192020,056,JEFFERSON,275,Jefferson County,119,Crosby Middle,275119,056275119,210299000703,"",909,06,173,178,43,65,108,0,0,0,11,10,21,20,15,35,0,0,0,8,6,14,96,77,173,351
20192020,056,JEFFERSON,275,Jefferson County,121,Hartstern Elementary,275121,056275121,210299000704,"",909,KG,47,34,9,15,24,0,0,0,0,5,5,12,14,26,0,0,0,1,4,5,12,9,21,81
20192020,056,JEFFERSON,275,Jefferson County,121,Hartstern Elementary,275121,056275121,210299000704,"",909,01,35,48,12,13,25,0,0,0,6,2,8,18,11,29,0,0,0,0,0,0,12,9,21,83
20192020,056,JEFFERSON,275,Jefferson County,121,Hartstern Elementary,275121,056275121,210299000704,"",909,02,36,42,17,10,27,0,0,0,1,4,5,11,7,18,0,0,0,3,4,7,10,11,21,78
20192020,056,JEFFERSON,275,Jefferson County,121,Hartstern Elementary,275121,056275121,210299000704,"",909,04,37,51,13,16,29,0,0,0,3,0,3,15,13,28,0,0,0,1,0,1,19,8,27,88
20192020,056,JEFFERSON,275,Jefferson County,121,Hartstern Elementary,275121,056275121,210299000704,"",909,03,42,37,11,9,20,0,0,0,0,3,3,15,16,31,0,0,0,3,2,5,8,12,20,79
20192020,056,JEFFERSON,275,Jefferson County,121,Hartstern Elementary,275121,056275121,210299000704,"",909,05,39,33,6,7,13,0,0,0,1,2,3,14,11,25,0,0,0,0,3,3,12,16,28,72
20192020,056,JEFFERSON,275,Jefferson County,121,Hartstern Elementary,275121,056275121,210299000704,"",909,All Students,236,245,68,70,138,0,0,0,11,16,27,85,72,157,0,0,0,8,13,21,73,65,138,481
20192020,056,JEFFERSON,275,Jefferson County,121,Hartstern Elementary,275121,056275121,210299000704,"",909,PS,13,7,1,4,5,0,0,0,1,0,1,0,4,4,0,0,0,0,0,0,5,5,10,20
20192020,056,JEFFERSON,275,Jefferson County,124,U of L PACT Program,275124,056275124,210299001935,"",909,All Students,9,11,4,3,7,0,0,0,1,0,1,0,0,0,0,0,0,0,0,0,6,6,12,20
20192020,056,JEFFERSON,275,Jefferson County,124,U of L PACT Program,275124,056275124,210299001935,"",909,14,6,10,3,3,6,0,0,0,1,0,1,0,0,0,0,0,0,0,0,0,6,3,9,16
20192020,056,JEFFERSON,275,Jefferson County,124,U of L PACT Program,275124,056275124,210299001935,"",909,12,3,1,1,0,1,0,0,0,0,0,0,0,0,0,0,0,0,0,0,0,0,3,3,4
20192020,056,JEFFERSON,275,Jefferson County,126,Layne Elementary,275126,056275126,210299000706,"",909,03,26,34,7,2,9,0,0,0,1,0,1,5,2,7,0,0,0,3,1,4,18,21,39,60
20192020,056,JEFFERSON,275,Jefferson County,126,Layne Elementary,275126,056275126,210299000706,"",909,05,36,28,2,11,13,0,0,0,0,0,0,1,5,6,0,0,0,2,4,6,23,16,39,64
20192020,056,JEFFERSON,275,Jefferson County,126,Layne Elementary,275126,056275126,210299000706,"",909,All Students,175,196,33,27,60,0,0,0,2,0,2,19,21,40,0,1,1,14,19,33,128,107,235,371
20192020,056,JEFFERSON,275,Jefferson County,126,Layne Elementary,275126,056275126,210299000706,"",909,KG,37,41,4,5,9,0,0,0,0,0,0,4,3,7,0,0,0,4,5,9,29,24,53,78
20192020,056,JEFFERSON,275,Jefferson County,126,Layne Elementary,275126,056275126,210299000706,"",909,01,33,34,9,4,13,0,0,0,0,0,0,4,7,11,0,0,0,1,3,4,20,19,39,67
20192020,056,JEFFERSON,275,Jefferson County,126,Layne Elementary,275126,056275126,210299000706,"",909,02,19,28,3,3,6,0,0,0,0,0,0,2,2,4,0,0,0,1,2,3,22,12,34,47
20192020,056,JEFFERSON,275,Jefferson County,126,Layne Elementary,275126,056275126,210299000706,"",909,04,24,31,8,2,10,0,0,0,1,0,1,3,2,5,0,1,1,3,4,7,16,15,31,55
20192020,056,JEFFERSON,275,Jefferson County,127,Auburndale Elementary,275127,056275127,210299000707,"",909,03,40,57,12,9,21,0,0,0,7,3,10,10,10,20,0,0,0,0,1,1,28,17,45,97
20192020,056,JEFFERSON,275,Jefferson County,127,Auburndale Elementary,275127,056275127,210299000707,"",909,05,40,48,11,7,18,0,0,0,3,5,8,8,8,16,0,0,0,1,3,4,25,17,42,88
20192020,056,JEFFERSON,275,Jefferson County,127,Auburndale Elementary,275127,056275127,210299000707,"",909,All Students,272,291,65,65,130,0,0,0,28,31,59,63,42,105,0,1,1,12,14,26,123,119,242,563
20192020,056,JEFFERSON,275,Jefferson County,127,Auburndale Elementary,275127,056275127,210299000707,"",909,PS,12,27,9,1,10,0,0,0,1,0,1,6,4,10,0,0,0,0,0,0,11,7,18,39
20192020,056,JEFFERSON,275,Jefferson County,127,Auburndale Elementary,275127,056275127,210299000707,"",909,KG,52,50,13,20,33,0,0,0,3,4,7,8,5,13,0,0,0,6,4,10,20,19,39,102
20192020,056,JEFFERSON,275,Jefferson County,127,Auburndale Elementary,275127,056275127,210299000707,"",909,01,53,47,6,10,16,0,0,0,9,6,15,15,8,23,0,0,0,0,2,2,17,27,44,100
20192020,056,JEFFERSON,275,Jefferson County,127,Auburndale Elementary,275127,056275127,210299000707,"",909,02,47,45,13,9,22,0,0,0,5,5,10,8,8,16,0,0,0,4,2,6,15,23,38,92
20192020,056,JEFFERSON,275,Jefferson County,127,Auburndale Elementary,275127,056275127,210299000707,"",909,04,40,44,10,10,20,0,0,0,1,8,9,14,3,17,0,1,1,1,2,3,18,16,34,84
20192020,056,JEFFERSON,275,Jefferson County,128,Price Elementary,275128,056275128,210299000708,"",909,03,42,36,21,24,45,0,0,0,1,1,2,4,10,14,0,1,1,4,1,5,6,5,11,78
20192020,056,JEFFERSON,275,Jefferson County,128,Price Elementary,275128,056275128,210299000708,"",909,05,32,49,27,21,48,0,0,0,5,2,7,8,5,13,0,0,0,3,1,4,6,3,9,81
20192020,056,JEFFERSON,275,Jefferson County,128,Price Elementary,275128,056275128,210299000708,"",909,All Students,209,228,135,125,260,0,0,0,13,13,26,34,36,70,0,1,1,22,9,31,24,25,49,437
20192020,056,JEFFERSON,275,Jefferson County,128,Price Elementary,275128,056275128,210299000708,"",909,KG,38,42,25,22,47,0,0,0,3,3,6,4,4,8,0,0,0,4,2,6,6,7,13,80
20192020,056,JEFFERSON,275,Jefferson County,128,Price Elementary,275128,056275128,210299000708,"",909,01,33,34,18,16,34,0,0,0,0,5,5,8,6,14,0,0,0,7,2,9,1,4,5,67
20192020,056,JEFFERSON,275,Jefferson County,128,Price Elementary,275128,056275128,210299000708,"",909,02,21,29,18,14,32,0,0,0,2,0,2,5,5,10,0,0,0,1,1,2,3,1,4,50
20192020,056,JEFFERSON,275,Jefferson County,128,Price Elementary,275128,056275128,210299000708,"",909,04,43,38,26,28,54,0,0,0,2,2,4,5,6,11,0,0,0,3,2,5,2,5,7,81
20192020,056,JEFFERSON,275,Jefferson County,129,Breckinridge Metropolitan High,275129,056275129,210299001965,"",909,11,3,16,10,3,13,0,0,0,0,0,0,1,0,1,0,0,0,0,0,0,5,0,5,19
20192020,056,JEFFERSON,275,Jefferson County,129,Breckinridge Metropolitan High,275129,056275129,210299001965,"",909,All Students,26,105,79,24,103,0,0,0,0,0,0,8,0,8,0,0,0,4,1,5,14,1,15,131
20192020,056,JEFFERSON,275,Jefferson County,129,Breckinridge Metropolitan High,275129,056275129,210299001965,"",909,09,11,32,26,10,36,0,0,0,0,0,0,3,0,3,0,0,0,1,0,1,2,1,3,43
20192020,056,JEFFERSON,275,Jefferson County,129,Breckinridge Metropolitan High,275129,056275129,210299001965,"",909,10,8,27,21,8,29,0,0,0,0,0,0,1,0,1,0,0,0,3,0,3,2,0,2,35
20192020,056,JEFFERSON,275,Jefferson County,129,Breckinridge Metropolitan High,275129,056275129,210299001965,"",909,12,4,30,22,3,25,0,0,0,0,0,0,3,0,3,0,0,0,0,1,1,5,0,5,34
20192020,056,JEFFERSON,275,Jefferson County,131,Eisenhower Elementary,275131,056275131,210299000710,"",909,04,49,48,15,11,26,0,0,0,0,0,0,4,2,6,0,0,0,3,5,8,26,31,57,97
20192020,056,JEFFERSON,275,Jefferson County,131,Eisenhower Elementary,275131,056275131,210299000710,"",909,05,49,53,14,14,28,0,1,1,0,0,0,3,1,4,0,0,0,1,4,5,35,29,64,102
20192020,056,JEFFERSON,275,Jefferson County,131,Eisenhower Elementary,275131,056275131,210299000710,"",909,All Students,318,282,53,59,112,0,1,1,0,0,0,14,5,19,0,0,0,20,26,46,195,227,422,600
20192020,056,JEFFERSON,275,Jefferson County,131,Eisenhower Elementary,275131,056275131,210299000710,"",909,KG,56,42,5,10,15,0,0,0,0,0,0,0,0,0,0,0,0,6,6,12,31,40,71,98
20192020,056,JEFFERSON,275,Jefferson County,131,Eisenhower Elementary,275131,056275131,210299000710,"",909,01,51,52,8,8,16,0,0,0,0,0,0,3,0,3,0,0,0,4,2,6,37,41,78,103
20192020,056,JEFFERSON,275,Jefferson County,131,Eisenhower Elementary,275131,056275131,210299000710,"",909,02,52,48,7,8,15,0,0,0,0,0,0,3,1,4,0,0,0,5,4,9,33,39,72,100
20192020,056,JEFFERSON,275,Jefferson County,131,Eisenhower Elementary,275131,056275131,210299000710,"",909,03,61,39,4,8,12,0,0,0,0,0,0,1,1,2,0,0,0,1,5,6,33,47,80,100
20192020,056,JEFFERSON,275,Jefferson County,133,Lassiter Middle,275133,056275133,210299000711,"",909,06,145,171,31,46,77,0,0,0,7,4,11,50,27,77,0,0,0,9,6,15,74,62,136,316
20192020,056,JEFFERSON,275,Jefferson County,133,Lassiter Middle,275133,056275133,210299000711,"",909,08,158,170,31,40,71,0,0,0,10,4,14,38,44,82,1,1,2,5,7,12,85,62,147,328
20192020,056,JEFFERSON,275,Jefferson County,133,Lassiter Middle,275133,056275133,210299000711,"",909,All Students,474,527,107,123,230,0,0,0,27,12,39,132,114,246,1,1,2,20,20,40,240,204,444,1001
20192020,056,JEFFERSON,275,Jefferson County,133,Lassiter Middle,275133,056275133,210299000711,"",909,07,171,186,45,37,82,0,0,0,10,4,14,44,43,87,0,0,0,6,7,13,81,80,161,357
20192020,056,JEFFERSON,275,Jefferson County,134,Klondike Lane Elementary,275134,056275134,210299000712,"",909,03,43,28,12,13,25,0,0,0,1,4,5,5,15,20,0,0,0,2,1,3,8,10,18,71
20192020,056,JEFFERSON,275,Jefferson County,134,Klondike Lane Elementary,275134,056275134,210299000712,"",909,05,43,45,11,12,23,0,0,0,2,2,4,16,16,32,0,0,0,6,2,8,10,11,21,88
20192020,056,JEFFERSON,275,Jefferson County,134,Klondike Lane Elementary,275134,056275134,210299000712,"",909,All Students,224,209,49,67,116,1,1,2,21,18,39,76,62,138,0,0,0,12,11,23,50,65,115,433
20192020,056,JEFFERSON,275,Jefferson County,134,Klondike Lane Elementary,275134,056275134,210299000712,"",909,PS,15,22,7,4,11,0,0,0,6,2,8,5,5,10,0,0,0,0,0,0,4,4,8,37
20192020,056,JEFFERSON,275,Jefferson County,134,Klondike Lane Elementary,275134,056275134,210299000712,"",909,KG,34,46,8,10,18,1,1,2,5,3,8,12,10,22,0,0,0,2,1,3,18,9,27,80
20192020,056,JEFFERSON,275,Jefferson County,134,Klondike Lane Elementary,275134,056275134,210299000712,"",909,01,42,31,4,14,18,0,0,0,6,5,11,15,7,22,0,0,0,2,2,4,4,14,18,73
20192020,056,JEFFERSON,275,Jefferson County,134,Klondike Lane Elementary,275134,056275134,210299000712,"",909,02,17,33,6,4,10,0,0,0,5,2,7,16,3,19,0,0,0,0,1,1,6,7,13,50
20192020,056,JEFFERSON,275,Jefferson County,134,Klondike Lane Elementary,275134,056275134,210299000712,"",909,04,45,26,8,14,22,0,0,0,2,2,4,12,11,23,0,0,0,0,4,4,4,14,18,71
20192020,056,JEFFERSON,275,Jefferson County,138,Louisville Day,275138,056275138,210299000713,"",909,All Students,3,25,15,2,17,0,0,0,1,0,1,2,0,2,0,0,0,2,0,2,5,1,6,28
20192020,056,JEFFERSON,275,Jefferson County,138,Louisville Day,275138,056275138,210299000713,"",909,09,1,8,6,1,7,0,0,0,1,0,1,1,0,1,0,0,0,0,0,0,0,0,0,9
20192020,056,JEFFERSON,275,Jefferson County,138,Louisville Day,275138,056275138,210299000713,"",909,10,0,7,4,0,4,0,0,0,0,0,0,1,0,1,0,0,0,1,0,1,1,0,1,7
20192020,056,JEFFERSON,275,Jefferson County,138,Louisville Day,275138,056275138,210299000713,"",909,11,1,4,3,1,4,0,0,0,0,0,0,0,0,0,0,0,0,0,0,0,1,0,1,5
20192020,056,JEFFERSON,275,Jefferson County,138,Louisville Day,275138,056275138,210299000713,"",909,12,1,6,2,0,2,0,0,0,0,0,0,0,0,0,0,0,0,1,0,1,3,1,4,7
20192020,056,JEFFERSON,275,Jefferson County,144,Stuart Academy,275144,056275144,210299001427,"",909,All Students,356,434,164,137,301,1,1,2,1,6,7,36,29,65,0,2,2,27,25,52,205,156,361,790
20192020,056,JEFFERSON,275,Jefferson County,144,Stuart Academy,275144,056275144,210299001427,"",909,07,189,208,86,74,160,1,0,1,1,3,4,15,19,34,0,2,2,13,17,30,92,74,166,397
20192020,056,JEFFERSON,275,Jefferson County,144,Stuart Academy,275144,056275144,210299001427,"",909,08,167,226,78,63,141,0,1,1,0,3,3,21,10,31,0,0,0,14,8,22,113,82,195,393
20192020,056,JEFFERSON,275,Jefferson County,145,Laukhuf Elementary,275145,056275145,210299000716,"",909,PS,16,24,10,6,16,0,0,0,0,1,1,3,2,5,0,0,0,1,2,3,10,5,15,40
20192020,056,JEFFERSON,275,Jefferson County,145,Laukhuf Elementary,275145,056275145,210299000716,"",909,KG,45,56,14,10,24,0,0,0,1,1,2,9,3,12,0,0,0,1,2,3,31,29,60,101
20192020,056,JEFFERSON,275,Jefferson County,145,Laukhuf Elementary,275145,056275145,210299000716,"",909,01,56,45,12,13,25,0,0,0,0,1,1,4,4,8,0,0,0,2,5,7,27,33,60,101
20192020,056,JEFFERSON,275,Jefferson County,145,Laukhuf Elementary,275145,056275145,210299000716,"",909,02,36,40,8,8,16,1,0,1,1,0,1,7,1,8,0,0,0,2,2,4,21,25,46,76
20192020,056,JEFFERSON,275,Jefferson County,145,Laukhuf Elementary,275145,056275145,210299000716,"",909,04,27,44,8,4,12,1,0,1,3,0,3,5,3,8,0,0,0,3,3,6,24,17,41,71
20192020,056,JEFFERSON,275,Jefferson County,145,Laukhuf Elementary,275145,056275145,210299000716,"",909,03,40,40,10,4,14,0,0,0,0,0,0,5,7,12,0,0,0,3,2,5,22,27,49,80
20192020,056,JEFFERSON,275,Jefferson County,145,Laukhuf Elementary,275145,056275145,210299000716,"",909,05,31,38,7,8,15,0,0,0,1,0,1,5,2,7,0,0,0,0,1,1,25,20,45,69
20192020,056,JEFFERSON,275,Jefferson County,145,Laukhuf Elementary,275145,056275145,210299000716,"",909,All Students,235,263,59,47,106,2,0,2,6,2,8,35,20,55,0,0,0,11,15,26,150,151,301,498
20192020,056,JEFFERSON,275,Jefferson County,146,Lowe Elementary,275146,056275146,210299000717,"",909,KG,46,56,10,5,15,0,0,0,11,13,24,2,2,4,0,0,0,8,3,11,25,23,48,102
20192020,056,JEFFERSON,275,Jefferson County,146,Lowe Elementary,275146,056275146,210299000717,"",909,02,49,47,6,5,11,1,0,1,9,13,22,1,5,6,0,0,0,2,5,7,28,21,49,96
20192020,056,JEFFERSON,275,Jefferson County,146,Lowe Elementary,275146,056275146,210299000717,"",909,All Students,267,308,36,27,63,1,1,2,65,70,135,17,18,35,0,2,2,27,18,45,162,131,293,575
20192020,056,JEFFERSON,275,Jefferson County,146,Lowe Elementary,275146,056275146,210299000717,"",909,03,46,57,3,6,9,0,1,1,13,14,27,5,1,6,0,2,2,2,0,2,34,22,56,103
20192020,056,JEFFERSON,275,Jefferson County,146,Lowe Elementary,275146,056275146,210299000717,"",909,04,42,42,7,1,8,0,0,0,10,8,18,2,4,6,0,0,0,4,3,7,19,26,45,84
20192020,056,JEFFERSON,275,Jefferson County,146,Lowe Elementary,275146,056275146,210299000717,"",909,05,43,45,6,6,12,0,0,0,7,11,18,3,4,7,0,0,0,6,3,9,23,19,42,88
20192020,056,JEFFERSON,275,Jefferson County,146,Lowe Elementary,275146,056275146,210299000717,"",909,01,41,61,4,4,8,0,0,0,15,11,26,4,2,6,0,0,0,5,4,9,33,20,53,102
20192020,056,JEFFERSON,275,Jefferson County,147,Mill Creek Elementary,275147,056275147,210299000718,"",909,PS,22,16,9,20,29,0,0,0,1,0,1,2,0,2,0,0,0,1,1,2,3,1,4,38
20192020,056,JEFFERSON,275,Jefferson County,147,Mill Creek Elementary,275147,056275147,210299000718,"",909,All Students,221,259,221,192,413,1,1,2,0,0,0,9,4,13,0,0,0,10,11,21,18,13,31,480
20192020,056,JEFFERSON,275,Jefferson County,147,Mill Creek Elementary,275147,056275147,210299000718,"",909,KG,27,48,42,24,66,1,0,1,0,0,0,0,0,0,0,0,0,1,1,2,4,2,6,75
20192020,056,JEFFERSON,275,Jefferson County,147,Mill Creek Elementary,275147,056275147,210299000718,"",909,01,37,42,35,31,66,0,0,0,0,0,0,4,1,5,0,0,0,1,3,4,2,2,4,79
20192020,056,JEFFERSON,275,Jefferson County,147,Mill Creek Elementary,275147,056275147,210299000718,"",909,02,35,37,26,30,56,0,0,0,0,0,0,2,1,3,0,0,0,5,0,5,4,4,8,72
20192020,056,JEFFERSON,275,Jefferson County,147,Mill Creek Elementary,275147,056275147,210299000718,"",909,03,40,36,30,34,64,0,0,0,0,0,0,1,1,2,0,0,0,1,4,5,4,1,5,76
20192020,056,JEFFERSON,275,Jefferson County,147,Mill Creek Elementary,275147,056275147,210299000718,"",909,04,42,46,41,38,79,0,0,0,0,0,0,1,0,1,0,0,0,2,0,2,2,4,6,88
20192020,056,JEFFERSON,275,Jefferson County,147,Mill Creek Elementary,275147,056275147,210299000718,"",909,05,40,50,47,35,82,0,1,1,0,0,0,1,1,2,0,0,0,0,3,3,2,0,2,90
20192020,056,JEFFERSON,275,Jefferson County,149,Blake Elementary,275149,056275149,210299000719,"",909,05,36,46,14,10,24,0,0,0,0,0,0,8,6,14,0,0,0,1,3,4,23,17,40,82
20192020,056,JEFFERSON,275,Jefferson County,149,Blake Elementary,275149,056275149,210299000719,"",909,All Students,201,249,77,58,135,0,0,0,5,5,10,58,55,113,1,0,1,24,11,35,84,72,156,450
20192020,056,JEFFERSON,275,Jefferson County,149,Blake Elementary,275149,056275149,210299000719,"",909,PS,26,27,7,14,21,0,0,0,0,2,2,8,3,11,0,0,0,2,0,2,10,7,17,53
20192020,056,JEFFERSON,275,Jefferson County,149,Blake Elementary,275149,056275149,210299000719,"",909,KG,37,43,18,7,25,0,0,0,1,2,3,7,11,18,0,0,0,4,1,5,13,16,29,80
20192020,056,JEFFERSON,275,Jefferson County,149,Blake Elementary,275149,056275149,210299000719,"",909,01,40,35,8,13,21,0,0,0,0,2,2,13,10,23,1,0,1,4,1,5,9,14,23,75
20192020,056,JEFFERSON,275,Jefferson County,149,Blake Elementary,275149,056275149,210299000719,"",909,02,27,42,11,9,20,0,0,0,0,1,1,14,8,22,0,0,0,2,0,2,15,9,24,69
20192020,056,JEFFERSON,275,Jefferson County,149,Blake Elementary,275149,056275149,210299000719,"",909,03,24,50,18,8,26,0,0,0,3,0,3,8,10,18,0,0,0,4,1,5,17,5,22,74
20192020,056,JEFFERSON,275,Jefferson County,149,Blake Elementary,275149,056275149,210299000719,"",909,04,37,33,8,11,19,0,0,0,1,0,1,8,10,18,0,0,0,9,5,14,7,11,18,70
20192020,056,JEFFERSON,275,Jefferson County,155,Marion C. Moore School,275155,056275155,210299002026,"",909,12,136,143,57,55,112,0,0,0,6,4,10,31,28,59,0,0,0,4,4,8,45,45,90,279
20192020,056,JEFFERSON,275,Jefferson County,155,Marion C. Moore School,275155,056275155,210299002026,"",909,11,137,143,47,51,98,1,1,2,6,8,14,36,26,62,0,0,0,3,5,8,50,46,96,280
20192020,056,JEFFERSON,275,Jefferson County,155,Marion C. Moore School,275155,056275155,210299002026,"",909,14,3,1,1,1,2,0,0,0,0,1,1,0,0,0,0,0,0,0,0,0,0,1,1,4
20192020,056,JEFFERSON,275,Jefferson County,155,Marion C. Moore School,275155,056275155,210299002026,"",909,All Students,1118,1206,433,398,831,1,5,6,33,36,69,270,255,525,0,2,2,43,39,82,426,383,809,2324
20192020,056,JEFFERSON,275,Jefferson County,155,Marion C. Moore School,275155,056275155,210299002026,"",909,06,180,171,61,64,125,0,0,0,2,2,4,33,36,69,0,0,0,11,11,22,64,67,131,351
20192020,056,JEFFERSON,275,Jefferson County,155,Marion C. Moore School,275155,056275155,210299002026,"",909,07,182,208,76,58,134,0,1,1,8,9,17,41,53,94,0,0,0,10,8,18,73,53,126,390
20192020,056,JEFFERSON,275,Jefferson County,155,Marion C. Moore School,275155,056275155,210299002026,"",909,08,185,173,65,68,133,0,1,1,4,4,8,45,40,85,0,1,1,6,8,14,53,63,116,358
20192020,056,JEFFERSON,275,Jefferson County,155,Marion C. Moore School,275155,056275155,210299002026,"",909,09,142,189,65,56,121,0,0,0,4,2,6,38,27,65,0,0,0,6,3,9,76,54,130,331
20192020,056,JEFFERSON,275,Jefferson County,155,Marion C. Moore School,275155,056275155,210299002026,"",909,10,153,178,61,45,106,0,2,2,3,6,9,46,45,91,0,1,1,3,0,3,65,54,119,331
20192020,056,JEFFERSON,275,Jefferson County,156,Dunn Elementary,275156,056275156,210299000722,"",909,03,44,53,6,6,12,0,0,0,10,4,14,2,3,5,0,0,0,3,8,11,32,23,55,97
20192020,056,JEFFERSON,275,Jefferson County,156,Dunn Elementary,275156,056275156,210299000722,"",909,05,55,31,8,7,15,0,0,0,5,5,10,1,0,1,0,0,0,2,5,7,15,38,53,86
20192020,056,JEFFERSON,275,Jefferson County,156,Dunn Elementary,275156,056275156,210299000722,"",909,All Students,268,276,32,32,64,0,1,1,34,29,63,8,17,25,0,0,0,15,23,38,187,166,353,544
20192020,056,JEFFERSON,275,Jefferson County,156,Dunn Elementary,275156,056275156,210299000722,"",909,KG,44,54,5,6,11,0,1,1,6,4,10,1,3,4,0,0,0,6,1,7,36,29,65,98
20192020,056,JEFFERSON,275,Jefferson County,156,Dunn Elementary,275156,056275156,210299000722,"",909,01,43,52,3,5,8,0,0,0,6,9,15,1,2,3,0,0,0,2,2,4,40,25,65,95
20192020,056,JEFFERSON,275,Jefferson County,156,Dunn Elementary,275156,056275156,210299000722,"",909,02,44,41,5,2,7,0,0,0,4,3,7,1,4,5,0,0,0,0,5,5,31,30,61,85
20192020,056,JEFFERSON,275,Jefferson County,156,Dunn Elementary,275156,056275156,210299000722,"",909,04,38,45,5,6,11,0,0,0,3,4,7,2,5,7,0,0,0,2,2,4,33,21,54,83
20192020,056,JEFFERSON,275,Jefferson County,162,Kammerer Middle,275162,056275162,210299000724,"",909,06,148,158,60,53,113,0,1,1,2,1,3,12,11,23,0,0,0,5,13,18,79,69,148,306
20192020,056,JEFFERSON,275,Jefferson County,162,Kammerer Middle,275162,056275162,210299000724,"",909,08,142,154,61,45,106,0,0,0,5,3,8,6,12,18,0,1,1,14,9,23,68,72,140,296
20192020,056,JEFFERSON,275,Jefferson County,162,Kammerer Middle,275162,056275162,210299000724,"",909,All Students,456,471,180,167,347,0,1,1,11,5,16,29,32,61,0,2,2,31,30,61,220,219,439,927
20192020,056,JEFFERSON,275,Jefferson County,162,Kammerer Middle,275162,056275162,210299000724,"",909,07,166,159,59,69,128,0,0,0,4,1,5,11,9,20,0,1,1,12,8,20,73,78,151,325
20192020,056,JEFFERSON,275,Jefferson County,163,Knight Middle,275163,056275163,210299000725,"",909,06,72,85,18,23,41,0,0,0,2,0,2,12,12,24,0,0,0,7,5,12,46,32,78,157
20192020,056,JEFFERSON,275,Jefferson County,163,Knight Middle,275163,056275163,210299000725,"",909,08,77,83,31,28,59,0,0,0,0,2,2,19,8,27,0,0,0,2,2,4,31,37,68,160
20192020,056,JEFFERSON,275,Jefferson County,163,Knight Middle,275163,056275163,210299000725,"",909,All Students,219,241,61,67,128,0,0,0,2,6,8,49,34,83,0,0,0,14,10,24,115,102,217,460
20192020,056,JEFFERSON,275,Jefferson County,163,Knight Middle,275163,056275163,210299000725,"",909,07,70,73,12,16,28,0,0,0,0,4,4,18,14,32,0,0,0,5,3,8,38,33,71,143
20192020,056,JEFFERSON,275,Jefferson County,164,Conway Middle,275164,056275164,210299000726,"",909,06,117,149,62,31,93,0,0,0,1,0,1,13,11,24,1,0,1,8,7,15,64,68,132,266
20192020,056,JEFFERSON,275,Jefferson County,164,Conway Middle,275164,056275164,210299000726,"",909,08,128,139,53,55,108,0,0,0,1,1,2,11,7,18,0,0,0,5,4,9,69,61,130,267
20192020,056,JEFFERSON,275,Jefferson County,164,Conway Middle,275164,056275164,210299000726,"",909,All Students,391,431,167,147,314,0,0,0,5,1,6,33,35,68,1,0,1,22,23,45,203,185,388,822
20192020,056,JEFFERSON,275,Jefferson County,164,Conway Middle,275164,056275164,210299000726,"",909,07,146,143,52,61,113,0,0,0,3,0,3,9,17,26,0,0,0,9,12,21,70,56,126,289
20192020,056,JEFFERSON,275,Jefferson County,165,J. Graham Brown School,275165,056275165,210299002027,"",909,12,28,23,4,9,13,0,0,0,0,1,1,1,2,3,0,0,0,0,3,3,18,13,31,51
20192020,056,JEFFERSON,275,Jefferson County,165,J. Graham Brown School,275165,056275165,210299002027,"",909,All Students,425,320,51,100,151,0,1,1,13,15,28,18,30,48,0,1,1,27,34,61,211,244,455,745
20192020,056,JEFFERSON,275,Jefferson County,165,J. Graham Brown School,275165,056275165,210299002027,"",909,KG,26,22,2,6,8,0,0,0,2,1,3,0,2,2,0,0,0,5,3,8,13,14,27,48
20192020,056,JEFFERSON,275,Jefferson County,165,J. Graham Brown School,275165,056275165,210299002027,"",909,01,31,17,2,6,8,0,0,0,0,1,1,1,4,5,0,0,0,5,4,9,9,16,25,48
20192020,056,JEFFERSON,275,Jefferson County,165,J. Graham Brown School,275165,056275165,210299002027,"",909,02,27,20,5,8,13,0,0,0,2,3,5,1,4,5,0,1,1,2,3,5,10,8,18,47
20192020,056,JEFFERSON,275,Jefferson County,165,J. Graham Brown School,275165,056275165,210299002027,"",909,03,28,20,2,5,7,0,0,0,1,2,3,3,2,5,0,0,0,1,1,2,13,18,31,48
20192020,056,JEFFERSON,275,Jefferson County,165,J. Graham Brown School,275165,056275165,210299002027,"",909,04,34,22,2,10,12,0,1,1,1,1,2,1,0,1,0,0,0,1,4,5,17,18,35,56
20192020,056,JEFFERSON,275,Jefferson County,165,J. Graham Brown School,275165,056275165,210299002027,"",909,05,37,21,0,6,6,0,0,0,2,1,3,4,0,4,0,0,0,3,1,4,12,29,41,58
20192020,056,JEFFERSON,275,Jefferson County,165,J. Graham Brown School,275165,056275165,210299002027,"",909,06,44,32,8,12,20,0,0,0,2,0,2,2,2,4,0,0,0,1,1,2,19,29,48,76
20192020,056,JEFFERSON,275,Jefferson County,165,J. Graham Brown School,275165,056275165,210299002027,"",909,07,37,37,8,6,14,0,0,0,2,1,3,0,6,6,0,0,0,4,5,9,23,19,42,74
20192020,056,JEFFERSON,275,Jefferson County,165,J. Graham Brown School,275165,056275165,210299002027,"",909,08,38,27,7,6,13,0,0,0,1,2,3,2,3,5,0,0,0,1,2,3,16,25,41,65
20192020,056,JEFFERSON,275,Jefferson County,165,J. Graham Brown School,275165,056275165,210299002027,"",909,09,37,27,5,9,14,0,0,0,0,1,1,0,2,2,0,0,0,0,2,2,22,23,45,64
20192020,056,JEFFERSON,275,Jefferson County,165,J. Graham Brown School,275165,056275165,210299002027,"",909,10,29,28,3,8,11,0,0,0,0,1,1,1,0,1,0,0,0,1,1,2,23,19,42,57
20192020,056,JEFFERSON,275,Jefferson County,165,J. Graham Brown School,275165,056275165,210299002027,"",909,11,29,24,3,9,12,0,0,0,0,0,0,2,3,5,0,0,0,3,4,7,16,13,29,53
20192020,056,JEFFERSON,275,Jefferson County,166,Jeffersontown Elementary,275166,056275166,210299000727,"",909,04,50,62,9,8,17,0,0,0,3,3,6,16,11,27,0,0,0,4,2,6,30,26,56,112
20192020,056,JEFFERSON,275,Jefferson County,166,Jeffersontown Elementary,275166,056275166,210299000727,"",909,All Students,323,390,88,57,145,2,1,3,14,17,31,74,65,139,1,2,3,31,19,50,180,162,342,713
20192020,056,JEFFERSON,275,Jefferson County,166,Jeffersontown Elementary,275166,056275166,210299000727,"",909,05,54,71,16,15,31,0,0,0,2,4,6,17,8,25,0,0,0,5,2,7,31,25,56,125
20192020,056,JEFFERSON,275,Jefferson County,166,Jeffersontown Elementary,275166,056275166,210299000727,"",909,01,69,68,16,10,26,1,0,1,2,3,5,8,14,22,0,1,1,6,5,11,35,36,71,137
20192020,056,JEFFERSON,275,Jefferson County,166,Jeffersontown Elementary,275166,056275166,210299000727,"",909,KG,54,79,18,9,27,1,1,2,1,4,5,11,10,21,0,1,1,10,2,12,38,27,65,133
20192020,056,JEFFERSON,275,Jefferson County,166,Jeffersontown Elementary,275166,056275166,210299000727,"",909,02,36,44,12,5,17,0,0,0,2,3,5,10,8,18,0,0,0,3,2,5,17,18,35,80
20192020,056,JEFFERSON,275,Jefferson County,166,Jeffersontown Elementary,275166,056275166,210299000727,"",909,03,60,66,17,10,27,0,0,0,4,0,4,12,14,26,1,0,1,3,6,9,29,30,59,126
20192020,056,JEFFERSON,275,Jefferson County,167,Carrithers Middle,275167,056275167,210299000728,"",909,All Students,311,348,130,113,243,1,0,1,5,5,10,39,48,87,0,0,0,20,16,36,153,129,282,659
20192020,056,JEFFERSON,275,Jefferson County,167,Carrithers Middle,275167,056275167,210299000728,"",909,06,109,114,42,36,78,0,0,0,0,4,4,19,18,37,0,0,0,5,5,10,48,46,94,223
20192020,056,JEFFERSON,275,Jefferson County,167,Carrithers Middle,275167,056275167,210299000728,"",909,07,103,109,38,39,77,1,0,1,2,0,2,14,18,32,0,0,0,7,4,11,47,42,89,212
20192020,056,JEFFERSON,275,Jefferson County,167,Carrithers Middle,275167,056275167,210299000728,"",909,08,99,125,50,38,88,0,0,0,3,1,4,6,12,18,0,0,0,8,7,15,58,41,99,224
20192020,056,JEFFERSON,275,Jefferson County,175,Alex R. Kennedy Elementary,275175,056275175,210299002421,"",909,02,19,34,10,7,17,0,0,0,1,4,5,3,1,4,0,0,0,3,0,3,17,7,24,53
20192020,056,JEFFERSON,275,Jefferson County,175,Alex R. Kennedy Elementary,275175,056275175,210299002421,"",909,03,19,29,12,7,19,0,0,0,1,1,2,3,2,5,0,0,0,2,1,3,11,8,19,48
20192020,056,JEFFERSON,275,Jefferson County,175,Alex R. Kennedy Elementary,275175,056275175,210299002421,"",909,All Students,120,168,61,40,101,0,0,0,6,6,12,17,10,27,0,0,0,15,12,27,69,52,121,288
20192020,056,JEFFERSON,275,Jefferson County,175,Alex R. Kennedy Elementary,275175,056275175,210299002421,"",909,PS,54,66,19,15,34,0,0,0,7,11,18,5,6,11,0,0,0,4,6,10,31,16,47,120
20192020,056,JEFFERSON,275,Jefferson County,175,Alex R. Kennedy Elementary,275175,056275175,210299002421,"",909,KG,21,32,12,5,17,0,0,0,1,0,1,5,0,5,0,0,0,1,1,2,13,15,28,53
20192020,056,JEFFERSON,275,Jefferson County,175,Alex R. Kennedy Elementary,275175,056275175,210299002421,"",909,05,12,19,6,5,11,0,0,0,0,0,0,1,1,2,0,0,0,4,2,6,8,4,12,31
20192020,056,JEFFERSON,275,Jefferson County,175,Alex R. Kennedy Elementary,275175,056275175,210299002421,"",909,04,23,27,11,8,19,0,0,0,0,1,1,2,3,5,0,0,0,3,1,4,11,10,21,50
20192020,056,JEFFERSON,275,Jefferson County,175,Alex R. Kennedy Elementary,275175,056275175,210299002421,"",909,01,26,27,10,8,18,0,0,0,3,0,3,3,3,6,0,0,0,2,7,9,9,8,17,53
20192020,056,JEFFERSON,275,Jefferson County,179,Central High Magnet Career Academy,275179,056275179,210299000730,"",909,10,221,102,71,172,243,0,0,0,6,6,12,13,19,32,0,0,0,2,7,9,10,17,27,323
20192020,056,JEFFERSON,275,Jefferson County,179,Central High Magnet Career Academy,275179,056275179,210299000730,"",909,12,171,88,62,131,193,0,0,0,4,4,8,12,23,35,0,0,0,0,2,2,10,11,21,259
20192020,056,JEFFERSON,275,Jefferson County,179,Central High Magnet Career Academy,275179,056275179,210299000730,"",909,14,0,4,2,0,2,0,0,0,0,0,0,0,0,0,0,0,0,0,0,0,2,0,2,4
20192020,056,JEFFERSON,275,Jefferson County,179,Central High Magnet Career Academy,275179,056275179,210299000730,"",909,All Students,831,390,269,634,903,0,0,0,19,28,47,46,85,131,0,1,1,5,24,29,51,59,110,1221
20192020,056,JEFFERSON,275,Jefferson County,179,Central High Magnet Career Academy,275179,056275179,210299000730,"",909,09,225,111,76,169,245,0,0,0,5,6,11,13,24,37,0,1,1,1,9,10,16,16,32,336
20192020,056,JEFFERSON,275,Jefferson County,179,Central High Magnet Career Academy,275179,056275179,210299000730,"",909,11,214,85,58,162,220,0,0,0,4,12,16,8,19,27,0,0,0,2,6,8,13,15,28,299
20192020,056,JEFFERSON,275,Jefferson County,182,Wheatley Elementary,275182,056275182,210299000731,"",909,KG,26,27,22,18,40,0,0,0,1,1,2,3,4,7,0,0,0,1,1,2,0,2,2,53
20192020,056,JEFFERSON,275,Jefferson County,182,Wheatley Elementary,275182,056275182,210299000731,"",909,02,15,21,19,13,32,0,0,0,0,0,0,1,0,1,0,0,0,1,1,2,0,1,1,36
20192020,056,JEFFERSON,275,Jefferson County,182,Wheatley Elementary,275182,056275182,210299000731,"",909,03,32,25,21,26,47,0,0,0,0,0,0,2,5,7,0,0,0,2,1,3,0,0,0,57
20192020,056,JEFFERSON,275,Jefferson County,182,Wheatley Elementary,275182,056275182,210299000731,"",909,05,27,35,33,24,57,0,0,0,0,0,0,1,3,4,0,0,0,0,0,0,1,0,1,62
20192020,056,JEFFERSON,275,Jefferson County,182,Wheatley Elementary,275182,056275182,210299000731,"",909,04,25,32,25,18,43,1,1,2,1,0,1,4,3,7,0,0,0,1,2,3,0,1,1,57
20192020,056,JEFFERSON,275,Jefferson County,182,Wheatley Elementary,275182,056275182,210299000731,"",909,All Students,152,174,151,122,273,1,2,3,3,1,4,12,18,30,0,0,0,6,5,11,1,4,5,326
20192020,056,JEFFERSON,275,Jefferson County,182,Wheatley Elementary,275182,056275182,210299000731,"",909,01,27,34,31,23,54,0,1,1,1,0,1,1,3,4,0,0,0,1,0,1,0,0,0,61
20192020,056,JEFFERSON,275,Jefferson County,183,Binet School,275183,056275183,210299000732,"",909,08,1,2,0,0,0,0,0,0,0,0,0,1,0,1,0,0,0,1,0,1,0,1,1,3
20192020,056,JEFFERSON,275,Jefferson County,183,Binet School,275183,056275183,210299000732,"",909,All Students,14,44,29,5,34,0,0,0,0,0,0,2,1,3,0,0,0,2,1,3,11,7,18,58
20192020,056,JEFFERSON,275,Jefferson County,183,Binet School,275183,056275183,210299000732,"",909,KG,0,1,1,0,1,0,0,0,0,0,0,0,0,0,0,0,0,0,0,0,0,0,0,1
20192020,056,JEFFERSON,275,Jefferson County,183,Binet School,275183,056275183,210299000732,"",909,01,1,1,1,0,1,0,0,0,0,0,0,0,1,1,0,0,0,0,0,0,0,0,0,2
20192020,056,JEFFERSON,275,Jefferson County,183,Binet School,275183,056275183,210299000732,"",909,02,0,2,1,0,1,0,0,0,0,0,0,0,0,0,0,0,0,0,0,0,1,0,1,2
20192020,056,JEFFERSON,275,Jefferson County,183,Binet School,275183,056275183,210299000732,"",909,03,0,2,2,0,2,0,0,0,0,0,0,0,0,0,0,0,0,0,0,0,0,0,0,2
20192020,056,JEFFERSON,275,Jefferson County,183,Binet School,275183,056275183,210299000732,"",909,04,0,2,2,0,2,0,0,0,0,0,0,0,0,0,0,0,0,0,0,0,0,0,0,2
20192020,056,JEFFERSON,275,Jefferson County,183,Binet School,275183,056275183,210299000732,"",909,05,0,5,4,0,4,0,0,0,0,0,0,0,0,0,0,0,0,0,0,0,1,0,1,5
20192020,056,JEFFERSON,275,Jefferson County,183,Binet School,275183,056275183,210299000732,"",909,06,2,0,0,1,1,0,0,0,0,0,0,0,0,0,0,0,0,0,0,0,0,1,1,2
20192020,056,JEFFERSON,275,Jefferson County,183,Binet School,275183,056275183,210299000732,"",909,07,0,3,2,0,2,0,0,0,0,0,0,0,0,0,0,0,0,0,0,0,1,0,1,3
20192020,056,JEFFERSON,275,Jefferson County,183,Binet School,275183,056275183,210299000732,"",909,09,3,3,2,1,3,0,0,0,0,0,0,0,0,0,0,0,0,1,1,2,0,1,1,6
20192020,056,JEFFERSON,275,Jefferson County,183,Binet School,275183,056275183,210299000732,"",909,10,4,4,3,1,4,0,0,0,0,0,0,0,0,0,0,0,0,0,0,0,1,3,4,8
20192020,056,JEFFERSON,275,Jefferson County,183,Binet School,275183,056275183,210299000732,"",909,11,0,3,2,0,2,0,0,0,0,0,0,1,0,1,0,0,0,0,0,0,0,0,0,3
20192020,056,JEFFERSON,275,Jefferson County,183,Binet School,275183,056275183,210299000732,"",909,12,0,8,4,0,4,0,0,0,0,0,0,0,0,0,0,0,0,0,0,0,4,0,4,8
20192020,056,JEFFERSON,275,Jefferson County,183,Binet School,275183,056275183,210299000732,"",909,14,3,8,5,2,7,0,0,0,0,0,0,0,0,0,0,0,0,0,0,0,3,1,4,11
20192020,056,JEFFERSON,275,Jefferson County,185,Atkinson Academy,275185,056275185,210299000733,"",909,05,30,24,10,13,23,0,0,0,0,1,1,0,0,0,0,0,0,1,3,4,13,13,26,54
20192020,056,JEFFERSON,275,Jefferson County,185,Atkinson Academy,275185,056275185,210299000733,"",909,All Students,169,167,87,87,174,1,0,1,0,2,2,2,3,5,0,0,0,19,19,38,58,58,116,336
20192020,056,JEFFERSON,275,Jefferson County,185,Atkinson Academy,275185,056275185,210299000733,"",909,KG,33,19,11,19,30,1,0,1,0,0,0,0,0,0,0,0,0,1,2,3,6,12,18,52
20192020,056,JEFFERSON,275,Jefferson County,185,Atkinson Academy,275185,056275185,210299000733,"",909,01,21,31,16,11,27,0,0,0,0,0,0,0,0,0,0,0,0,5,3,8,10,7,17,52
20192020,056,JEFFERSON,275,Jefferson County,185,Atkinson Academy,275185,056275185,210299000733,"",909,02,19,27,11,13,24,0,0,0,0,0,0,0,0,0,0,0,0,4,0,4,12,6,18,46
20192020,056,JEFFERSON,275,Jefferson County,185,Atkinson Academy,275185,056275185,210299000733,"",909,03,36,34,19,16,35,0,0,0,0,0,0,0,2,2,0,0,0,7,8,15,8,10,18,70
20192020,056,JEFFERSON,275,Jefferson County,185,Atkinson Academy,275185,056275185,210299000733,"",909,04,30,32,20,15,35,0,0,0,0,1,1,2,1,3,0,0,0,1,3,4,9,10,19,62
20192020,056,JEFFERSON,275,Jefferson County,186,Newcomer Academy,275186,056275186,210299002180,"",909,11,10,19,6,2,8,0,0,0,0,0,0,12,8,20,0,0,0,0,0,0,1,0,1,29
20192020,056,JEFFERSON,275,Jefferson County,186,Newcomer Academy,275186,056275186,210299002180,"",909,10,69,77,24,28,52,0,0,0,2,1,3,49,40,89,0,0,0,0,0,0,2,0,2,146
20192020,056,JEFFERSON,275,Jefferson County,186,Newcomer Academy,275186,056275186,210299002180,"",909,12,6,5,3,6,9,0,0,0,0,0,0,2,0,2,0,0,0,0,0,0,0,0,0,11
20192020,056,JEFFERSON,275,Jefferson County,186,Newcomer Academy,275186,056275186,210299002180,"",909,All Students,300,389,113,126,239,0,0,0,10,7,17,260,165,425,0,0,0,0,0,0,6,2,8,689
20192020,056,JEFFERSON,275,Jefferson County,186,Newcomer Academy,275186,056275186,210299002180,"",909,06,36,49,9,11,20,0,0,0,2,1,3,37,24,61,0,0,0,0,0,0,1,0,1,85
20192020,056,JEFFERSON,275,Jefferson County,186,Newcomer Academy,275186,056275186,210299002180,"",909,07,32,52,21,18,39,0,0,0,1,1,2,30,13,43,0,0,0,0,0,0,0,0,0,84
20192020,056,JEFFERSON,275,Jefferson County,186,Newcomer Academy,275186,056275186,210299002180,"",909,08,34,42,13,8,21,0,0,0,1,2,3,28,22,50,0,0,0,0,0,0,0,2,2,76
20192020,056,JEFFERSON,275,Jefferson County,186,Newcomer Academy,275186,056275186,210299002180,"",909,09,113,145,37,53,90,0,0,0,4,2,6,102,58,160,0,0,0,0,0,0,2,0,2,258
20192020,056,JEFFERSON,275,Jefferson County,191,W.E.B. DuBois Academy,275191,056275191,210299002458,"",909,All Students,0,282,248,0,248,0,0,0,1,0,1,10,0,10,0,0,0,18,0,18,5,0,5,282
20192020,056,JEFFERSON,275,Jefferson County,191,W.E.B. DuBois Academy,275191,056275191,210299002458,"",909,07,0,140,123,0,123,0,0,0,0,0,0,4,0,4,0,0,0,10,0,10,3,0,3,140
20192020,056,JEFFERSON,275,Jefferson County,191,W.E.B. DuBois Academy,275191,056275191,210299002458,"",909,06,0,142,125,0,125,0,0,0,1,0,1,6,0,6,0,0,0,8,0,8,2,0,2,142
20192020,056,JEFFERSON,275,Jefferson County,193,Mary Jo and William MacDonald Maryhurst,275193,056275193,210299001492,"",909,10,17,0,0,2,2,0,0,0,0,0,0,0,1,1,0,0,0,0,1,1,0,13,13,17
20192020,056,JEFFERSON,275,Jefferson County,193,Mary Jo and William MacDonald Maryhurst,275193,056275193,210299001492,"",909,12,20,0,0,3,3,0,0,0,0,0,0,0,1,1,0,0,0,0,0,0,0,16,16,20
20192020,056,JEFFERSON,275,Jefferson County,193,Mary Jo and William MacDonald Maryhurst,275193,056275193,210299001492,"",909,All Students,81,0,0,8,8,0,0,0,0,0,0,0,4,4,0,0,0,0,2,2,0,67,67,81
20192020,056,JEFFERSON,275,Jefferson County,193,Mary Jo and William MacDonald Maryhurst,275193,056275193,210299001492,"",909,05,1,0,0,0,0,0,0,0,0,0,0,0,0,0,0,0,0,0,0,0,0,1,1,1
20192020,056,JEFFERSON,275,Jefferson County,193,Mary Jo and William MacDonald Maryhurst,275193,056275193,210299001492,"",909,06,3,0,0,0,0,0,0,0,0,0,0,0,0,0,0,0,0,0,0,0,0,3,3,3
20192020,056,JEFFERSON,275,Jefferson County,193,Mary Jo and William MacDonald Maryhurst,275193,056275193,210299001492,"",909,07,2,0,0,0,0,0,0,0,0,0,0,0,0,0,0,0,0,0,0,0,0,2,2,2
20192020,056,JEFFERSON,275,Jefferson County,193,Mary Jo and William MacDonald Maryhurst,275193,056275193,210299001492,"",909,08,6,0,0,1,1,0,0,0,0,0,0,0,1,1,0,0,0,0,0,0,0,4,4,6
20192020,056,JEFFERSON,275,Jefferson County,193,Mary Jo and William MacDonald Maryhurst,275193,056275193,210299001492,"",909,09,19,0,0,0,0,0,0,0,0,0,0,0,1,1,0,0,0,0,0,0,0,18,18,19
20192020,056,JEFFERSON,275,Jefferson County,193,Mary Jo and William MacDonald Maryhurst,275193,056275193,210299001492,"",909,11,13,0,0,2,2,0,0,0,0,0,0,0,0,0,0,0,0,0,1,1,0,10,10,13
20192020,056,JEFFERSON,275,Jefferson County,200,duPont Manual High,275200,056275200,210299000734,"",909,10,272,190,36,49,85,0,1,1,38,41,79,8,13,21,0,0,0,2,10,12,106,158,264,462
20192020,056,JEFFERSON,275,Jefferson County,200,duPont Manual High,275200,056275200,210299000734,"",909,12,296,173,17,45,62,0,0,0,44,50,94,8,13,21,0,1,1,2,9,11,102,178,280,469
20192020,056,JEFFERSON,275,Jefferson County,200,duPont Manual High,275200,056275200,210299000734,"",909,All Students,1104,777,120,196,316,0,3,3,171,182,353,37,52,89,2,3,5,21,31,52,426,637,1063,1881
20192020,056,JEFFERSON,275,Jefferson County,200,duPont Manual High,275200,056275200,210299000734,"",909,09,261,213,39,46,85,0,0,0,48,47,95,14,13,27,0,1,1,11,8,19,101,146,247,474
20192020,056,JEFFERSON,275,Jefferson County,200,duPont Manual High,275200,056275200,210299000734,"",909,11,275,201,28,56,84,0,2,2,41,44,85,7,13,20,2,1,3,6,4,10,117,155,272,476
20192020,056,JEFFERSON,275,Jefferson County,201,The Phoenix School of Discovery,275201,056275201,210299002121,"",909,14,1,2,0,1,1,0,0,0,0,0,0,1,0,1,0,0,0,0,0,0,1,0,1,3
20192020,056,JEFFERSON,275,Jefferson County,201,The Phoenix School of Discovery,275201,056275201,210299002121,"",909,All Students,112,248,59,38,97,0,1,1,1,4,5,7,5,12,0,0,0,13,4,17,168,60,228,360
20192020,056,JEFFERSON,275,Jefferson County,201,The Phoenix School of Discovery,275201,056275201,210299002121,"",909,06,17,37,10,7,17,0,0,0,1,1,2,0,0,0,0,0,0,2,1,3,24,8,32,54
20192020,056,JEFFERSON,275,Jefferson County,201,The Phoenix School of Discovery,275201,056275201,210299002121,"",909,07,15,43,12,4,16,0,0,0,0,2,2,0,0,0,0,0,0,3,0,3,28,9,37,58
20192020,056,JEFFERSON,275,Jefferson County,201,The Phoenix School of Discovery,275201,056275201,210299002121,"",909,08,11,41,8,4,12,0,1,1,0,0,0,1,0,1,0,0,0,3,0,3,29,6,35,52
20192020,056,JEFFERSON,275,Jefferson County,201,The Phoenix School of Discovery,275201,056275201,210299002121,"",909,09,19,30,6,2,8,0,0,0,0,1,1,2,1,3,0,0,0,1,1,2,21,14,35,49
20192020,056,JEFFERSON,275,Jefferson County,201,The Phoenix School of Discovery,275201,056275201,210299002121,"",909,10,17,38,9,10,19,0,0,0,0,0,0,0,2,2,0,0,0,2,0,2,27,5,32,55
20192020,056,JEFFERSON,275,Jefferson County,201,The Phoenix School of Discovery,275201,056275201,210299002121,"",909,11,11,28,7,5,12,0,0,0,0,0,0,0,1,1,0,0,0,0,0,0,21,5,26,39
20192020,056,JEFFERSON,275,Jefferson County,201,The Phoenix School of Discovery,275201,056275201,210299002121,"",909,12,21,29,7,5,12,0,0,0,0,0,0,3,1,4,0,0,0,2,2,4,17,13,30,50
20192020,056,JEFFERSON,275,Jefferson County,202,Minor Daniels Academy,275202,056275202,210299002412,"",909,11,4,13,9,4,13,0,0,0,0,0,0,1,0,1,0,0,0,0,0,0,3,0,3,17
20192020,056,JEFFERSON,275,Jefferson County,202,Minor Daniels Academy,275202,056275202,210299002412,"",909,12,3,9,6,3,9,0,0,0,0,0,0,1,0,1,0,0,0,0,0,0,2,0,2,12
20192020,056,JEFFERSON,275,Jefferson County,202,Minor Daniels Academy,275202,056275202,210299002412,"",909,All Students,81,156,113,67,180,0,0,0,1,0,1,6,1,7,0,0,0,4,4,8,32,9,41,237
20192020,056,JEFFERSON,275,Jefferson County,202,Minor Daniels Academy,275202,056275202,210299002412,"",909,06,11,14,13,11,24,0,0,0,0,0,0,0,0,0,0,0,0,0,0,0,1,0,1,25
20192020,056,JEFFERSON,275,Jefferson County,202,Minor Daniels Academy,275202,056275202,210299002412,"",909,07,15,21,15,10,25,0,0,0,0,0,0,1,0,1,0,0,0,1,1,2,4,4,8,36
20192020,056,JEFFERSON,275,Jefferson County,202,Minor Daniels Academy,275202,056275202,210299002412,"",909,08,12,49,31,7,38,0,0,0,0,0,0,2,1,3,0,0,0,2,2,4,14,2,16,61
20192020,056,JEFFERSON,275,Jefferson County,202,Minor Daniels Academy,275202,056275202,210299002412,"",909,09,21,30,24,19,43,0,0,0,0,0,0,1,0,1,0,0,0,1,0,1,4,2,6,51
20192020,056,JEFFERSON,275,Jefferson County,202,Minor Daniels Academy,275202,056275202,210299002412,"",909,10,15,20,15,13,28,0,0,0,1,0,1,0,0,0,0,0,0,0,1,1,4,1,5,35
20192020,056,JEFFERSON,275,Jefferson County,211,Stopher Elementary,275211,056275211,210299002197,"",909,03,63,64,5,6,11,0,0,0,8,6,14,2,4,6,0,0,0,5,5,10,44,42,86,127
20192020,056,JEFFERSON,275,Jefferson County,211,Stopher Elementary,275211,056275211,210299002197,"",909,05,61,57,8,13,21,0,0,0,7,10,17,1,2,3,0,0,0,3,5,8,38,31,69,118
20192020,056,JEFFERSON,275,Jefferson County,211,Stopher Elementary,275211,056275211,210299002197,"",909,All Students,390,388,47,42,89,2,1,3,48,48,96,9,19,28,2,0,2,19,24,43,261,256,517,778
20192020,056,JEFFERSON,275,Jefferson County,211,Stopher Elementary,275211,056275211,210299002197,"",909,PS,15,19,4,1,5,0,0,0,2,3,5,0,0,0,0,0,0,1,3,4,12,8,20,34
20192020,056,JEFFERSON,275,Jefferson County,211,Stopher Elementary,275211,056275211,210299002197,"",909,KG,65,75,13,7,20,0,0,0,6,6,12,0,6,6,1,0,1,6,1,7,49,45,94,140
20192020,056,JEFFERSON,275,Jefferson County,211,Stopher Elementary,275211,056275211,210299002197,"",909,01,69,64,10,4,14,1,1,2,10,7,17,3,2,5,0,0,0,1,6,7,39,49,88,133
20192020,056,JEFFERSON,275,Jefferson County,211,Stopher Elementary,275211,056275211,210299002197,"",909,02,65,71,5,5,10,0,0,0,13,10,23,1,2,3,0,0,0,1,2,3,51,46,97,136
20192020,056,JEFFERSON,275,Jefferson County,211,Stopher Elementary,275211,056275211,210299002197,"",909,04,67,57,6,7,13,1,0,1,4,9,13,2,3,5,1,0,1,3,5,8,40,43,83,124
20192020,056,JEFFERSON,275,Jefferson County,212,Farmer Elementary,275212,056275212,210299002187,"",909,02,70,53,19,7,26,0,0,0,5,5,10,3,10,13,0,0,0,4,2,6,22,46,68,123
20192020,056,JEFFERSON,275,Jefferson County,212,Farmer Elementary,275212,056275212,210299002187,"",909,All Students,372,368,57,48,105,1,0,1,19,30,49,46,53,99,0,0,0,30,24,54,215,217,432,740
20192020,056,JEFFERSON,275,Jefferson County,212,Farmer Elementary,275212,056275212,210299002187,"",909,PS,14,26,8,8,16,0,0,0,2,0,2,2,1,3,0,0,0,1,2,3,13,3,16,40
20192020,056,JEFFERSON,275,Jefferson County,212,Farmer Elementary,275212,056275212,210299002187,"",909,KG,64,65,6,10,16,0,0,0,1,3,4,9,7,16,0,0,0,6,4,10,43,40,83,129
20192020,056,JEFFERSON,275,Jefferson County,212,Farmer Elementary,275212,056275212,210299002187,"",909,01,66,63,5,8,13,0,0,0,7,4,11,7,11,18,0,0,0,7,6,13,37,37,74,129
20192020,056,JEFFERSON,275,Jefferson County,212,Farmer Elementary,275212,056275212,210299002187,"",909,03,59,62,13,6,19,1,0,1,2,4,6,7,9,16,0,0,0,7,7,14,32,33,65,121
20192020,056,JEFFERSON,275,Jefferson County,212,Farmer Elementary,275212,056275212,210299002187,"",909,04,50,67,7,7,14,0,0,0,3,8,11,12,8,20,0,0,0,3,2,5,42,25,67,117
20192020,056,JEFFERSON,275,Jefferson County,212,Farmer Elementary,275212,056275212,210299002187,"",909,05,63,58,7,10,17,0,0,0,1,6,7,8,8,16,0,0,0,3,3,6,39,36,75,121
20192020,056,JEFFERSON,275,Jefferson County,219,Ramsey Middle,275219,056275219,210299002190,"",909,All Students,499,538,198,183,381,1,0,1,22,13,35,62,47,109,0,1,1,34,44,78,221,211,432,1037
20192020,056,JEFFERSON,275,Jefferson County,219,Ramsey Middle,275219,056275219,210299002190,"",909,06,175,196,70,62,132,0,0,0,10,1,11,22,19,41,0,0,0,16,14,30,78,79,157,371
20192020,056,JEFFERSON,275,Jefferson County,219,Ramsey Middle,275219,056275219,210299002190,"",909,07,167,163,52,67,119,0,0,0,6,5,11,24,15,39,0,0,0,10,8,18,71,72,143,330
20192020,056,JEFFERSON,275,Jefferson County,219,Ramsey Middle,275219,056275219,210299002190,"",909,08,157,179,76,54,130,1,0,1,6,7,13,16,13,29,0,1,1,8,22,30,72,60,132,336
20192020,056,JEFFERSON,275,Jefferson County,220,Bellewood,275220,056275220,210299002394,"",909,02,0,2,0,0,0,0,0,0,0,0,0,0,0,0,0,0,0,0,0,0,2,0,2,2
20192020,056,JEFFERSON,275,Jefferson County,220,Bellewood,275220,056275220,210299002394,"",909,04,1,8,1,0,1,0,0,0,0,0,0,1,0,1,0,0,0,2,0,2,4,1,5,9
20192020,056,JEFFERSON,275,Jefferson County,220,Bellewood,275220,056275220,210299002394,"",909,03,3,6,2,0,2,0,0,0,0,0,0,0,0,0,0,0,0,0,0,0,4,3,7,9
20192020,056,JEFFERSON,275,Jefferson County,220,Bellewood,275220,056275220,210299002394,"",909,05,9,10,4,2,6,0,0,0,0,0,0,1,0,1,0,0,0,0,1,1,5,6,11,19
20192020,056,JEFFERSON,275,Jefferson County,220,Bellewood,275220,056275220,210299002394,"",909,All Students,13,28,7,2,9,0,0,0,0,0,0,2,0,2,0,0,0,2,1,3,17,10,27,41
20192020,056,JEFFERSON,275,Jefferson County,220,Bellewood,275220,056275220,210299002394,"",909,01,0,2,0,0,0,0,0,0,0,0,0,0,0,0,0,0,0,0,0,0,2,0,2,2
20192020,056,JEFFERSON,275,Jefferson County,221,Brooklawn,275221,056275221,210299002399,"",909,09,9,15,4,2,6,0,0,0,0,0,0,0,0,0,0,0,0,2,2,4,9,5,14,24
20192020,056,JEFFERSON,275,Jefferson County,221,Brooklawn,275221,056275221,210299002399,"",909,11,0,8,0,0,0,0,0,0,0,0,0,0,0,0,0,0,0,0,0,0,8,0,8,8
20192020,056,JEFFERSON,275,Jefferson County,221,Brooklawn,275221,056275221,210299002399,"",909,12,3,9,2,0,2,0,0,0,0,0,0,0,0,0,0,0,0,1,0,1,6,3,9,12
20192020,056,JEFFERSON,275,Jefferson County,221,Brooklawn,275221,056275221,210299002399,"",909,10,9,21,3,4,7,0,0,0,0,0,0,0,0,0,0,0,0,1,0,1,17,5,22,30
20192020,056,JEFFERSON,275,Jefferson County,221,Brooklawn,275221,056275221,210299002399,"",909,All Students,43,95,13,8,21,0,0,0,1,1,2,0,0,0,0,0,0,6,3,9,75,31,106,138
20192020,056,JEFFERSON,275,Jefferson County,221,Brooklawn,275221,056275221,210299002399,"",909,06,6,11,1,1,2,0,0,0,0,0,0,0,0,0,0,0,0,0,0,0,10,5,15,17
20192020,056,JEFFERSON,275,Jefferson County,221,Brooklawn,275221,056275221,210299002399,"",909,07,8,15,1,0,1,0,0,0,0,0,0,0,0,0,0,0,0,1,1,2,13,7,20,23
20192020,056,JEFFERSON,275,Jefferson County,221,Brooklawn,275221,056275221,210299002399,"",909,08,8,16,2,1,3,0,0,0,1,1,2,0,0,0,0,0,0,1,0,1,12,6,18,24
20192020,056,JEFFERSON,275,Jefferson County,222,Westport Early Childhood Center,275222,056275222,210299002499,"",909,PS,87,179,42,17,59,0,0,0,14,9,23,33,9,42,1,0,1,13,9,22,76,43,119,266
20192020,056,JEFFERSON,275,Jefferson County,222,Westport Early Childhood Center,275222,056275222,210299002499,"",909,All Students,0,0,0,0,0,0,0,0,0,0,0,0,0,0,0,0,0,0,0,0,0,0,0,0
20192020,056,JEFFERSON,275,Jefferson County,225,Bloom Elementary,275225,056275225,210299000737,"",909,03,45,43,3,4,7,0,0,0,1,0,1,3,1,4,0,0,0,0,3,3,36,37,73,88
20192020,056,JEFFERSON,275,Jefferson County,225,Bloom Elementary,275225,056275225,210299000737,"",909,All Students,275,272,25,30,55,0,0,0,6,1,7,14,6,20,0,0,0,23,13,36,204,225,429,547
20192020,056,JEFFERSON,275,Jefferson County,225,Bloom Elementary,275225,056275225,210299000737,"",909,KG,45,49,3,8,11,0,0,0,0,0,0,1,2,3,0,0,0,5,3,8,40,32,72,94
20192020,056,JEFFERSON,275,Jefferson County,225,Bloom Elementary,275225,056275225,210299000737,"",909,01,46,45,3,2,5,0,0,0,2,0,2,3,0,3,0,0,0,4,0,4,33,44,77,91
20192020,056,JEFFERSON,275,Jefferson County,225,Bloom Elementary,275225,056275225,210299000737,"",909,02,46,47,3,3,6,0,0,0,1,0,1,2,1,3,0,0,0,5,5,10,36,37,73,93
20192020,056,JEFFERSON,275,Jefferson County,225,Bloom Elementary,275225,056275225,210299000737,"",909,04,45,44,6,6,12,0,0,0,1,1,2,3,2,5,0,0,0,5,1,6,29,35,64,89
20192020,056,JEFFERSON,275,Jefferson County,225,Bloom Elementary,275225,056275225,210299000737,"",909,05,48,44,7,7,14,0,0,0,1,0,1,2,0,2,0,0,0,4,1,5,30,40,70,92
20192020,056,JEFFERSON,275,Jefferson County,240,Engelhard Elementary,275240,056275240,210299000739,"",909,04,30,27,21,18,39,0,0,0,1,1,2,1,1,2,0,0,0,3,2,5,1,8,9,57
20192020,056,JEFFERSON,275,Jefferson County,240,Engelhard Elementary,275240,056275240,210299000739,"",909,05,29,36,22,16,38,0,0,0,1,2,3,4,1,5,0,0,0,1,7,8,8,3,11,65
20192020,056,JEFFERSON,275,Jefferson County,240,Engelhard Elementary,275240,056275240,210299000739,"",909,All Students,157,189,137,107,244,0,0,0,5,4,9,12,11,23,0,0,0,10,14,24,25,21,46,346
20192020,056,JEFFERSON,275,Jefferson County,240,Engelhard Elementary,275240,056275240,210299000739,"",909,KG,24,37,29,17,46,0,0,0,1,0,1,2,3,5,0,0,0,0,1,1,5,3,8,61
20192020,056,JEFFERSON,275,Jefferson County,240,Engelhard Elementary,275240,056275240,210299000739,"",909,01,21,30,24,17,41,0,0,0,0,0,0,2,0,2,0,0,0,1,1,2,3,3,6,51
20192020,056,JEFFERSON,275,Jefferson County,240,Engelhard Elementary,275240,056275240,210299000739,"",909,02,23,24,16,18,34,0,0,0,0,1,1,0,1,1,0,0,0,3,1,4,5,2,7,47
20192020,056,JEFFERSON,275,Jefferson County,240,Engelhard Elementary,275240,056275240,210299000739,"",909,03,30,35,25,21,46,0,0,0,2,0,2,3,5,8,0,0,0,2,2,4,3,2,5,65
20192020,056,JEFFERSON,275,Jefferson County,243,Byck Elementary,275243,056275243,210299000740,"",909,03,25,22,20,23,43,0,0,0,0,0,0,1,1,2,0,0,0,0,0,0,1,1,2,47
20192020,056,JEFFERSON,275,Jefferson County,243,Byck Elementary,275243,056275243,210299000740,"",909,05,34,29,27,33,60,0,0,0,0,0,0,0,0,0,0,0,0,0,0,0,2,1,3,63
20192020,056,JEFFERSON,275,Jefferson County,243,Byck Elementary,275243,056275243,210299000740,"",909,All Students,182,188,159,167,326,1,1,2,1,1,2,5,2,7,0,0,0,6,2,8,16,9,25,370
20192020,056,JEFFERSON,275,Jefferson County,243,Byck Elementary,275243,056275243,210299000740,"",909,KG,39,31,24,33,57,0,1,1,0,0,0,2,1,3,0,0,0,2,1,3,3,3,6,70
20192020,056,JEFFERSON,275,Jefferson County,243,Byck Elementary,275243,056275243,210299000740,"",909,01,31,43,37,28,65,0,0,0,0,0,0,1,0,1,0,0,0,2,1,3,3,2,5,74
20192020,056,JEFFERSON,275,Jefferson County,243,Byck Elementary,275243,056275243,210299000740,"",909,02,22,26,19,21,40,0,0,0,0,0,0,1,0,1,0,0,0,2,0,2,4,1,5,48
20192020,056,JEFFERSON,275,Jefferson County,243,Byck Elementary,275243,056275243,210299000740,"",909,04,31,37,32,29,61,1,0,1,1,1,2,0,0,0,0,0,0,0,0,0,3,1,4,68
20192020,056,JEFFERSON,275,Jefferson County,250,Field Elementary,275250,056275250,210299000741,"",909,03,41,34,11,12,23,0,0,0,2,1,3,1,2,3,0,0,0,0,1,1,20,25,45,75
20192020,056,JEFFERSON,275,Jefferson County,250,Field Elementary,275250,056275250,210299000741,"",909,05,34,20,6,8,14,0,0,0,1,0,1,1,2,3,0,0,0,1,2,3,11,22,33,54
20192020,056,JEFFERSON,275,Jefferson County,250,Field Elementary,275250,056275250,210299000741,"",909,All Students,218,196,47,52,99,0,0,0,7,7,14,11,6,17,0,0,0,16,18,34,115,135,250,414
20192020,056,JEFFERSON,275,Jefferson County,250,Field Elementary,275250,056275250,210299000741,"",909,KG,44,32,5,7,12,0,0,0,0,2,2,1,1,2,0,0,0,2,2,4,24,32,56,76
20192020,056,JEFFERSON,275,Jefferson County,250,Field Elementary,275250,056275250,210299000741,"",909,01,30,42,10,8,18,0,0,0,0,1,1,4,1,5,0,0,0,3,5,8,25,15,40,72
20192020,056,JEFFERSON,275,Jefferson County,250,Field Elementary,275250,056275250,210299000741,"",909,02,39,36,7,8,15,0,0,0,2,2,4,2,0,2,0,0,0,5,2,7,20,27,47,75
20192020,056,JEFFERSON,275,Jefferson County,250,Field Elementary,275250,056275250,210299000741,"",909,04,30,32,8,9,17,0,0,0,2,1,3,2,0,2,0,0,0,5,6,11,15,14,29,62
20192020,056,JEFFERSON,275,Jefferson County,260,Brandeis Elementary,275260,056275260,210299000742,"",909,03,38,35,16,16,32,0,0,0,7,12,19,1,2,3,0,0,0,1,1,2,10,7,17,73
20192020,056,JEFFERSON,275,Jefferson County,260,Brandeis Elementary,275260,056275260,210299000742,"",909,05,51,51,21,27,48,0,0,0,10,8,18,1,1,2,0,0,0,4,2,6,15,13,28,102
20192020,056,JEFFERSON,275,Jefferson County,260,Brandeis Elementary,275260,056275260,210299000742,"",909,All Students,247,259,107,113,220,0,0,0,53,59,112,12,11,23,0,0,0,14,8,22,73,56,129,506
20192020,056,JEFFERSON,275,Jefferson County,260,Brandeis Elementary,275260,056275260,210299000742,"",909,PS,7,13,9,4,13,0,0,0,1,1,2,1,1,2,0,0,0,0,1,1,2,0,2,20
20192020,056,JEFFERSON,275,Jefferson County,260,Brandeis Elementary,275260,056275260,210299000742,"",909,KG,34,43,22,18,40,0,0,0,5,6,11,2,1,3,0,0,0,4,0,4,10,9,19,77
20192020,056,JEFFERSON,275,Jefferson County,260,Brandeis Elementary,275260,056275260,210299000742,"",909,01,36,39,14,16,30,0,0,0,9,10,19,2,3,5,0,0,0,3,1,4,11,6,17,75
20192020,056,JEFFERSON,275,Jefferson County,260,Brandeis Elementary,275260,056275260,210299000742,"",909,02,46,49,21,19,40,0,0,0,12,10,22,3,2,5,0,0,0,1,3,4,12,12,24,95
20192020,056,JEFFERSON,275,Jefferson County,260,Brandeis Elementary,275260,056275260,210299000742,"",909,04,42,42,13,17,30,0,0,0,10,13,23,3,2,5,0,0,0,1,1,2,15,9,24,84
20192020,056,JEFFERSON,275,Jefferson County,270,Foster Traditional Academy,275270,056275270,210299000745,"",909,05,62,49,47,58,105,0,0,0,0,0,0,1,0,1,0,0,0,1,2,3,0,2,2,111
20192020,056,JEFFERSON,275,Jefferson County,270,Foster Traditional Academy,275270,056275270,210299000745,"",909,03,50,44,40,44,84,0,0,0,0,0,0,1,3,4,0,0,0,1,1,2,2,2,4,94
20192020,056,JEFFERSON,275,Jefferson County,270,Foster Traditional Academy,275270,056275270,210299000745,"",909,04,45,50,49,41,90,0,0,0,0,0,0,0,1,1,0,0,0,0,2,2,1,1,2,95
20192020,056,JEFFERSON,275,Jefferson County,270,Foster Traditional Academy,275270,056275270,210299000745,"",909,All Students,287,279,261,266,527,0,0,0,0,0,0,7,5,12,0,0,0,8,10,18,3,6,9,566
20192020,056,JEFFERSON,275,Jefferson County,270,Foster Traditional Academy,275270,056275270,210299000745,"",909,KG,47,47,43,43,86,0,0,0,0,0,0,2,1,3,0,0,0,2,3,5,0,0,0,94
20192020,056,JEFFERSON,275,Jefferson County,270,Foster Traditional Academy,275270,056275270,210299000745,"",909,01,41,55,53,38,91,0,0,0,0,0,0,0,0,0,0,0,0,2,2,4,0,1,1,96
20192020,056,JEFFERSON,275,Jefferson County,270,Foster Traditional Academy,275270,056275270,210299000745,"",909,02,42,34,29,42,71,0,0,0,0,0,0,3,0,3,0,0,0,2,0,2,0,0,0,76
20192020,056,JEFFERSON,275,Jefferson County,285,Center at Riverport,275285,056275285,210299002063,"",909,PS,34,55,24,14,38,0,0,0,1,0,1,5,4,9,0,0,0,4,0,4,21,16,37,89
20192020,056,JEFFERSON,275,Jefferson County,285,Center at Riverport,275285,056275285,210299002063,"",909,All Students,0,0,0,0,0,0,0,0,0,0,0,0,0,0,0,0,0,0,0,0,0,0,0,0
20192020,056,JEFFERSON,275,Jefferson County,290,Frayser Elementary,275290,056275290,210299000747,"",909,04,44,50,29,27,56,1,0,1,2,2,4,9,10,19,0,0,0,1,1,2,8,4,12,94
20192020,056,JEFFERSON,275,Jefferson County,290,Frayser Elementary,275290,056275290,210299000747,"",909,All Students,163,175,96,89,185,1,0,1,10,8,18,35,39,74,0,0,0,5,5,10,28,22,50,338
20192020,056,JEFFERSON,275,Jefferson County,290,Frayser Elementary,275290,056275290,210299000747,"",909,KG,24,26,13,12,25,0,0,0,2,1,3,6,8,14,0,0,0,1,1,2,4,2,6,50
20192020,056,JEFFERSON,275,Jefferson County,290,Frayser Elementary,275290,056275290,210299000747,"",909,01,24,29,12,11,23,0,0,0,3,1,4,8,8,16,0,0,0,2,0,2,4,4,8,53
20192020,056,JEFFERSON,275,Jefferson County,290,Frayser Elementary,275290,056275290,210299000747,"",909,02,19,9,8,11,19,0,0,0,0,3,3,1,2,3,0,0,0,0,1,1,0,2,2,28
20192020,056,JEFFERSON,275,Jefferson County,290,Frayser Elementary,275290,056275290,210299000747,"",909,03,31,27,19,16,35,0,0,0,2,1,3,4,6,10,0,0,0,0,0,0,2,8,10,58
20192020,056,JEFFERSON,275,Jefferson County,290,Frayser Elementary,275290,056275290,210299000747,"",909,05,21,34,15,12,27,0,0,0,1,0,1,7,5,12,0,0,0,1,2,3,10,2,12,55
20192020,056,JEFFERSON,275,Jefferson County,300,Hazelwood Elementary,275300,056275300,210299000748,"",909,04,32,24,7,9,16,0,0,0,4,4,8,5,7,12,0,0,0,5,3,8,3,9,12,56
20192020,056,JEFFERSON,275,Jefferson County,300,Hazelwood Elementary,275300,056275300,210299000748,"",909,05,30,30,10,4,14,0,0,0,0,3,3,9,11,20,0,0,0,2,0,2,9,12,21,60
20192020,056,JEFFERSON,275,Jefferson County,300,Hazelwood Elementary,275300,056275300,210299000748,"",909,All Students,186,192,71,61,132,0,0,0,19,20,39,40,46,86,0,1,1,17,10,27,45,48,93,378
20192020,056,JEFFERSON,275,Jefferson County,300,Hazelwood Elementary,275300,056275300,210299000748,"",909,01,35,30,9,9,18,0,0,0,7,3,10,5,12,17,0,0,0,2,0,2,7,11,18,65
20192020,056,JEFFERSON,275,Jefferson County,300,Hazelwood Elementary,275300,056275300,210299000748,"",909,PS,75,85,39,32,71,0,0,0,12,17,29,18,10,28,0,0,0,1,5,6,15,11,26,160
20192020,056,JEFFERSON,275,Jefferson County,300,Hazelwood Elementary,275300,056275300,210299000748,"",909,KG,30,46,23,16,39,0,0,0,5,5,10,7,3,10,0,0,0,3,1,4,8,5,13,76
20192020,056,JEFFERSON,275,Jefferson County,300,Hazelwood Elementary,275300,056275300,210299000748,"",909,02,33,27,8,11,19,0,0,0,1,3,4,11,9,20,0,1,1,2,3,5,5,6,11,60
20192020,056,JEFFERSON,275,Jefferson County,300,Hazelwood Elementary,275300,056275300,210299000748,"",909,03,26,35,14,12,26,0,0,0,2,2,4,3,4,7,0,0,0,3,3,6,13,5,18,61
20192020,056,JEFFERSON,275,Jefferson County,320,Highland Middle,275320,056275320,210299000750,"",909,All Students,482,422,151,156,307,1,1,2,7,8,15,48,45,93,0,1,1,22,36,58,193,235,428,904
20192020,056,JEFFERSON,275,Jefferson County,320,Highland Middle,275320,056275320,210299000750,"",909,07,152,139,49,45,94,1,0,1,3,4,7,16,11,27,0,0,0,4,14,18,66,78,144,291
20192020,056,JEFFERSON,275,Jefferson County,320,Highland Middle,275320,056275320,210299000750,"",909,08,174,138,48,62,110,0,0,0,1,3,4,12,13,25,0,1,1,10,9,19,67,86,153,312
20192020,056,JEFFERSON,275,Jefferson County,320,Highland Middle,275320,056275320,210299000750,"",909,06,156,145,54,49,103,0,1,1,3,1,4,20,21,41,0,0,0,8,13,21,60,71,131,301
20192020,056,JEFFERSON,275,Jefferson County,323,Cochran Elementary,275323,056275323,210299000751,"",909,02,20,22,12,10,22,0,0,0,0,2,2,0,0,0,0,0,0,5,3,8,5,5,10,42
20192020,056,JEFFERSON,275,Jefferson County,323,Cochran Elementary,275323,056275323,210299000751,"",909,04,32,29,18,19,37,0,0,0,0,0,0,2,1,3,0,0,0,1,2,3,8,10,18,61
20192020,056,JEFFERSON,275,Jefferson County,323,Cochran Elementary,275323,056275323,210299000751,"",909,05,28,27,11,17,28,0,0,0,1,1,2,2,1,3,0,0,0,0,1,1,13,8,21,55
20192020,056,JEFFERSON,275,Jefferson County,323,Cochran Elementary,275323,056275323,210299000751,"",909,All Students,154,179,93,83,176,0,0,0,2,4,6,12,6,18,0,0,0,14,12,26,58,49,107,333
20192020,056,JEFFERSON,275,Jefferson County,323,Cochran Elementary,275323,056275323,210299000751,"",909,KG,32,41,25,16,41,0,0,0,1,0,1,2,1,3,0,0,0,2,4,6,11,11,22,73
20192020,056,JEFFERSON,275,Jefferson County,323,Cochran Elementary,275323,056275323,210299000751,"",909,01,20,31,14,8,22,0,0,0,0,1,1,2,1,3,0,0,0,5,1,6,10,9,19,51
20192020,056,JEFFERSON,275,Jefferson County,323,Cochran Elementary,275323,056275323,210299000751,"",909,03,22,29,13,13,26,0,0,0,0,0,0,4,2,6,0,0,0,1,1,2,11,6,17,51
20192020,056,JEFFERSON,275,Jefferson County,325,Jacob Elementary,275325,056275325,210299000752,"",909,02,19,27,20,15,35,0,0,0,0,0,0,1,0,1,0,0,0,1,2,3,5,2,7,46
20192020,056,JEFFERSON,275,Jefferson County,325,Jacob Elementary,275325,056275325,210299000752,"",909,05,46,45,22,32,54,0,0,0,0,0,0,5,1,6,0,0,0,5,4,9,13,9,22,91
20192020,056,JEFFERSON,275,Jefferson County,325,Jacob Elementary,275325,056275325,210299000752,"",909,04,41,46,29,23,52,0,0,0,0,1,1,4,2,6,0,0,0,4,3,7,9,12,21,87
20192020,056,JEFFERSON,275,Jefferson County,325,Jacob Elementary,275325,056275325,210299000752,"",909,All Students,225,228,139,133,272,0,0,0,1,3,4,18,11,29,0,0,0,24,29,53,46,49,95,453
20192020,056,JEFFERSON,275,Jefferson County,325,Jacob Elementary,275325,056275325,210299000752,"",909,PS,33,27,14,26,40,0,0,0,1,2,3,3,1,4,0,0,0,2,1,3,7,3,10,60
20192020,056,JEFFERSON,275,Jefferson County,325,Jacob Elementary,275325,056275325,210299000752,"",909,KG,46,34,17,22,39,0,0,0,1,1,2,5,4,9,0,0,0,6,7,13,5,12,17,80
20192020,056,JEFFERSON,275,Jefferson County,325,Jacob Elementary,275325,056275325,210299000752,"",909,01,41,31,20,26,46,0,0,0,0,1,1,2,1,3,0,0,0,6,6,12,3,7,10,72
20192020,056,JEFFERSON,275,Jefferson County,325,Jacob Elementary,275325,056275325,210299000752,"",909,03,32,45,31,15,46,0,0,0,0,0,0,1,3,4,0,0,0,2,7,9,11,7,18,77
20192020,056,JEFFERSON,275,Jefferson County,335,Iroquois High,275335,056275335,210299000753,"",909,14,3,3,2,0,2,0,0,0,0,0,0,0,2,2,0,0,0,0,0,0,1,1,2,6
20192020,056,JEFFERSON,275,Jefferson County,335,Iroquois High,275335,056275335,210299000753,"",909,09,134,183,105,74,179,0,0,0,5,5,10,23,13,36,2,1,3,6,4,10,42,37,79,317
20192020,056,JEFFERSON,275,Jefferson County,335,Iroquois High,275335,056275335,210299000753,"",909,10,142,147,77,92,169,0,0,0,10,10,20,24,14,38,0,0,0,3,4,7,33,22,55,289
20192020,056,JEFFERSON,275,Jefferson County,335,Iroquois High,275335,056275335,210299000753,"",909,11,89,114,69,53,122,0,0,0,9,5,14,13,15,28,0,0,0,2,3,5,21,13,34,203
20192020,056,JEFFERSON,275,Jefferson County,335,Iroquois High,275335,056275335,210299000753,"",909,12,128,181,94,80,174,0,1,1,18,11,29,27,15,42,0,1,1,7,3,10,35,17,52,309
20192020,056,JEFFERSON,275,Jefferson County,335,Iroquois High,275335,056275335,210299000753,"",909,All Students,496,628,347,299,646,0,1,1,42,31,73,87,59,146,2,2,4,18,14,32,132,90,222,1124
20192020,056,JEFFERSON,275,Jefferson County,340,Meyzeek Middle,275340,056275340,210299000754,"",909,08,142,204,54,57,111,0,0,0,36,36,72,4,2,6,0,0,0,7,10,17,103,37,140,346
20192020,056,JEFFERSON,275,Jefferson County,340,Meyzeek Middle,275340,056275340,210299000754,"",909,07,140,219,74,48,122,0,0,0,42,32,74,4,3,7,0,0,0,17,9,26,82,48,130,359
20192020,056,JEFFERSON,275,Jefferson County,340,Meyzeek Middle,275340,056275340,210299000754,"",909,All Students,438,631,175,157,332,1,0,1,120,106,226,18,12,30,1,1,2,36,25,61,280,137,417,1069
20192020,056,JEFFERSON,275,Jefferson County,340,Meyzeek Middle,275340,056275340,210299000754,"",909,06,156,208,47,52,99,1,0,1,42,38,80,10,7,17,1,1,2,12,6,18,95,52,147,364
20192020,056,JEFFERSON,275,Jefferson County,371,Norton Commons Elementary,275371,056275371,210299002430,"",909,All Students,239,249,42,35,77,1,0,1,28,22,50,13,16,29,1,3,4,20,20,40,144,143,287,488
20192020,056,JEFFERSON,275,Jefferson County,371,Norton Commons Elementary,275371,056275371,210299002430,"",909,01,41,54,10,9,19,0,0,0,6,7,13,3,1,4,1,0,1,7,3,10,27,21,48,95
20192020,056,JEFFERSON,275,Jefferson County,371,Norton Commons Elementary,275371,056275371,210299002430,"",909,04,46,32,8,5,13,1,0,1,6,1,7,0,3,3,0,3,3,2,9,11,15,25,40,78
20192020,056,JEFFERSON,275,Jefferson County,371,Norton Commons Elementary,275371,056275371,210299002430,"",909,05,25,35,5,3,8,0,0,0,6,3,9,3,5,8,0,0,0,2,1,3,19,13,32,60
20192020,056,JEFFERSON,275,Jefferson County,371,Norton Commons Elementary,275371,056275371,210299002430,"",909,KG,53,50,3,7,10,0,0,0,4,6,10,4,1,5,0,0,0,3,4,7,36,35,71,103
20192020,056,JEFFERSON,275,Jefferson County,371,Norton Commons Elementary,275371,056275371,210299002430,"",909,02,36,38,9,5,14,0,0,0,3,2,5,1,2,3,0,0,0,3,1,4,22,26,48,74
20192020,056,JEFFERSON,275,Jefferson County,371,Norton Commons Elementary,275371,056275371,210299002430,"",909,03,38,40,7,6,13,0,0,0,3,3,6,2,4,6,0,0,0,3,2,5,25,23,48,78
20192020,056,JEFFERSON,275,Jefferson County,371,Norton Commons Elementary,275371,056275371,210299002430,"",909,PS,42,56,15,14,29,0,0,0,0,2,2,8,3,11,0,0,0,6,5,11,27,18,45,98
20192020,056,JEFFERSON,275,Jefferson County,374,Young Elementary,275374,056275374,210299000757,"",909,02,29,30,21,19,40,0,0,0,0,0,0,4,8,12,0,0,0,2,2,4,3,0,3,59
20192020,056,JEFFERSON,275,Jefferson County,374,Young Elementary,275374,056275374,210299000757,"",909,All Students,164,164,99,113,212,0,1,1,1,1,2,39,33,72,0,0,0,11,9,20,14,7,21,328
20192020,056,JEFFERSON,275,Jefferson County,374,Young Elementary,275374,056275374,210299000757,"",909,KG,23,14,6,15,21,0,0,0,0,0,0,6,6,12,0,0,0,2,1,3,0,1,1,37
20192020,056,JEFFERSON,275,Jefferson County,374,Young Elementary,275374,056275374,210299000757,"",909,01,14,28,18,9,27,0,0,0,0,0,0,5,4,9,0,0,0,2,0,2,3,1,4,42
20192020,056,JEFFERSON,275,Jefferson County,374,Young Elementary,275374,056275374,210299000757,"",909,03,39,31,21,28,49,0,1,1,0,0,0,7,5,12,0,0,0,3,4,7,0,1,1,70
20192020,056,JEFFERSON,275,Jefferson County,374,Young Elementary,275374,056275374,210299000757,"",909,04,41,24,16,28,44,0,0,0,1,0,1,6,9,15,0,0,0,0,2,2,1,2,3,65
20192020,056,JEFFERSON,275,Jefferson County,374,Young Elementary,275374,056275374,210299000757,"",909,05,18,37,17,14,31,0,0,0,0,1,1,11,1,12,0,0,0,2,0,2,7,2,9,55
20192020,056,JEFFERSON,275,Jefferson County,396,Jefferson County Traditional Middle,275396,056275396,210299000760,"",909,All Students,525,397,131,208,339,2,0,2,9,10,19,28,32,60,0,0,0,17,37,54,210,238,448,922
20192020,056,JEFFERSON,275,Jefferson County,396,Jefferson County Traditional Middle,275396,056275396,210299000760,"",909,06,181,136,45,74,119,0,0,0,3,3,6,12,12,24,0,0,0,5,12,17,71,80,151,317
20192020,056,JEFFERSON,275,Jefferson County,396,Jefferson County Traditional Middle,275396,056275396,210299000760,"",909,07,173,129,47,62,109,0,0,0,4,6,10,4,12,16,0,0,0,4,16,20,70,77,147,302
20192020,056,JEFFERSON,275,Jefferson County,396,Jefferson County Traditional Middle,275396,056275396,210299000760,"",909,08,171,132,39,72,111,2,0,2,2,1,3,12,8,20,0,0,0,8,9,17,69,81,150,303
20192020,056,JEFFERSON,275,Jefferson County,432,King Elementary,275432,056275432,210299000762,"",909,KG,23,32,24,21,45,0,1,1,0,0,0,1,1,2,0,0,0,2,0,2,5,0,5,55
20192020,056,JEFFERSON,275,Jefferson County,432,King Elementary,275432,056275432,210299000762,"",909,01,28,21,16,26,42,0,0,0,0,0,0,1,2,3,0,0,0,3,0,3,1,0,1,49
20192020,056,JEFFERSON,275,Jefferson County,432,King Elementary,275432,056275432,210299000762,"",909,03,30,31,23,26,49,0,0,0,0,0,0,5,0,5,0,0,0,2,1,3,1,3,4,61
20192020,056,JEFFERSON,275,Jefferson County,432,King Elementary,275432,056275432,210299000762,"",909,02,27,21,16,22,38,0,0,0,0,0,0,2,3,5,0,0,0,2,1,3,1,1,2,48
20192020,056,JEFFERSON,275,Jefferson County,432,King Elementary,275432,056275432,210299000762,"",909,04,43,33,24,34,58,0,0,0,0,0,0,3,5,8,0,0,0,1,2,3,5,2,7,76
20192020,056,JEFFERSON,275,Jefferson County,432,King Elementary,275432,056275432,210299000762,"",909,05,41,36,33,33,66,0,0,0,0,0,0,0,2,2,0,0,0,2,2,4,1,4,5,77
20192020,056,JEFFERSON,275,Jefferson County,432,King Elementary,275432,056275432,210299000762,"",909,All Students,192,174,136,162,298,0,1,1,0,0,0,12,13,25,0,0,0,12,6,18,14,10,24,366
20192020,056,JEFFERSON,275,Jefferson County,435,Noe Middle,275435,056275435,210299000763,"",909,All Students,757,581,209,236,445,0,2,2,16,42,58,60,59,119,0,2,2,23,48,71,273,368,641,1338
20192020,056,JEFFERSON,275,Jefferson County,435,Noe Middle,275435,056275435,210299000763,"",909,07,253,181,58,85,143,0,1,1,8,11,19,19,16,35,0,1,1,8,17,25,88,122,210,434
20192020,056,JEFFERSON,275,Jefferson County,435,Noe Middle,275435,056275435,210299000763,"",909,08,242,200,78,72,150,0,1,1,5,18,23,18,19,37,0,0,0,5,13,18,94,119,213,442
20192020,056,JEFFERSON,275,Jefferson County,435,Noe Middle,275435,056275435,210299000763,"",909,06,262,200,73,79,152,0,0,0,3,13,16,23,24,47,0,1,1,10,18,28,91,127,218,462
20192020,056,JEFFERSON,275,Jefferson County,440,Mcferran Preparatory Academy,275440,056275440,210299000764,"",909,02,45,46,38,38,76,0,0,0,0,0,0,4,3,7,0,0,0,2,2,4,2,2,4,91
20192020,056,JEFFERSON,275,Jefferson County,440,Mcferran Preparatory Academy,275440,056275440,210299000764,"",909,04,69,52,37,53,90,0,0,0,0,1,1,9,6,15,0,0,0,1,3,4,5,6,11,121
20192020,056,JEFFERSON,275,Jefferson County,440,Mcferran Preparatory Academy,275440,056275440,210299000764,"",909,05,54,60,51,43,94,0,0,0,0,0,0,5,3,8,0,0,0,3,2,5,1,6,7,114
20192020,056,JEFFERSON,275,Jefferson County,440,Mcferran Preparatory Academy,275440,056275440,210299000764,"",909,All Students,367,327,250,276,526,0,0,0,3,5,8,39,49,88,0,0,0,13,14,27,22,23,45,694
20192020,056,JEFFERSON,275,Jefferson County,440,Mcferran Preparatory Academy,275440,056275440,210299000764,"",909,PS,111,103,73,83,156,0,0,0,1,1,2,11,12,23,0,0,0,5,2,7,13,13,26,214
20192020,056,JEFFERSON,275,Jefferson County,440,Mcferran Preparatory Academy,275440,056275440,210299000764,"",909,KG,72,56,40,53,93,0,0,0,2,1,3,11,13,24,0,0,0,1,2,3,2,3,5,128
20192020,056,JEFFERSON,275,Jefferson County,440,Mcferran Preparatory Academy,275440,056275440,210299000764,"",909,01,63,62,47,40,87,0,0,0,1,2,3,3,15,18,0,0,0,5,3,8,6,3,9,125
20192020,056,JEFFERSON,275,Jefferson County,440,Mcferran Preparatory Academy,275440,056275440,210299000764,"",909,03,64,51,37,49,86,0,0,0,0,1,1,7,9,16,0,0,0,1,2,3,6,3,9,115
20192020,056,JEFFERSON,275,Jefferson County,456,Ackerly,275456,056275456,210299001859,"",909,09,0,0,0,0,0,0,0,0,0,0,0,0,0,0,0,0,0,0,0,0,0,0,0,0
20192020,056,JEFFERSON,275,Jefferson County,456,Ackerly,275456,056275456,210299001859,"",909,11,0,0,0,0,0,0,0,0,0,0,0,0,0,0,0,0,0,0,0,0,0,0,0,0
20192020,056,JEFFERSON,275,Jefferson County,456,Ackerly,275456,056275456,210299001859,"",909,12,0,0,0,0,0,0,0,0,0,0,0,0,0,0,0,0,0,0,0,0,0,0,0,0
20192020,056,JEFFERSON,275,Jefferson County,456,Ackerly,275456,056275456,210299001859,"",909,All Students,0,0,0,0,0,0,0,0,0,0,0,0,0,0,0,0,0,0,0,0,0,0,0,0
20192020,056,JEFFERSON,275,Jefferson County,456,Ackerly,275456,056275456,210299001859,"",909,05,0,0,0,0,0,0,0,0,0,0,0,0,0,0,0,0,0,0,0,0,0,0,0,0
20192020,056,JEFFERSON,275,Jefferson County,456,Ackerly,275456,056275456,210299001859,"",909,06,0,0,0,0,0,0,0,0,0,0,0,0,0,0,0,0,0,0,0,0,0,0,0,0
20192020,056,JEFFERSON,275,Jefferson County,456,Ackerly,275456,056275456,210299001859,"",909,07,0,0,0,0,0,0,0,0,0,0,0,0,0,0,0,0,0,0,0,0,0,0,0,0
20192020,056,JEFFERSON,275,Jefferson County,456,Ackerly,275456,056275456,210299001859,"",909,08,0,0,0,0,0,0,0,0,0,0,0,0,0,0,0,0,0,0,0,0,0,0,0,0
20192020,056,JEFFERSON,275,Jefferson County,456,Ackerly,275456,056275456,210299001859,"",909,10,0,0,0,0,0,0,0,0,0,0,0,0,0,0,0,0,0,0,0,0,0,0,0,0
20192020,056,JEFFERSON,275,Jefferson County,458,Mary Ryan Academy,275458,056275458,210299001860,"",909,09,3,6,2,1,3,0,0,0,0,0,0,0,1,1,0,0,0,0,0,0,4,1,5,9
20192020,056,JEFFERSON,275,Jefferson County,458,Mary Ryan Academy,275458,056275458,210299001860,"",909,12,4,4,3,2,5,0,0,0,0,0,0,0,0,0,0,0,0,0,0,0,1,2,3,8
20192020,056,JEFFERSON,275,Jefferson County,458,Mary Ryan Academy,275458,056275458,210299001860,"",909,11,4,1,0,1,1,0,0,0,0,0,0,0,0,0,0,0,0,0,1,1,1,2,3,5
20192020,056,JEFFERSON,275,Jefferson County,458,Mary Ryan Academy,275458,056275458,210299001860,"",909,All Students,17,18,7,6,13,0,0,0,0,0,0,0,1,1,0,0,0,0,1,1,11,9,20,35
20192020,056,JEFFERSON,275,Jefferson County,458,Mary Ryan Academy,275458,056275458,210299001860,"",909,10,6,7,2,2,4,0,0,0,0,0,0,0,0,0,0,0,0,0,0,0,5,4,9,13
20192020,056,JEFFERSON,275,Jefferson County,463,Louisville Metro Youth Center,275463,056275463,210299001082,"",909,09,0,1,1,0,1,0,0,0,0,0,0,0,0,0,0,0,0,0,0,0,0,0,0,1
20192020,056,JEFFERSON,275,Jefferson County,463,Louisville Metro Youth Center,275463,056275463,210299001082,"",909,All Students,0,7,4,0,4,0,0,0,0,0,0,0,0,0,0,0,0,0,0,0,3,0,3,7
20192020,056,JEFFERSON,275,Jefferson County,463,Louisville Metro Youth Center,275463,056275463,210299001082,"",909,08,0,1,1,0,1,0,0,0,0,0,0,0,0,0,0,0,0,0,0,0,0,0,0,1
20192020,056,JEFFERSON,275,Jefferson County,463,Louisville Metro Youth Center,275463,056275463,210299001082,"",909,10,0,5,2,0,2,0,0,0,0,0,0,0,0,0,0,0,0,0,0,0,3,0,3,5
20192020,056,JEFFERSON,275,Jefferson County,465,Heuser Hearing & Language Academy,275465,056275465,210299001941,"",909,PS,19,15,5,5,10,0,0,0,0,1,1,2,1,3,0,0,0,0,2,2,8,10,18,34
20192020,056,JEFFERSON,275,Jefferson County,465,Heuser Hearing & Language Academy,275465,056275465,210299001941,"",909,All Students,1,2,1,0,1,0,0,0,0,0,0,1,0,1,0,0,0,0,0,0,0,1,1,3
20192020,056,JEFFERSON,275,Jefferson County,465,Heuser Hearing & Language Academy,275465,056275465,210299001941,"",909,KG,1,2,1,0,1,0,0,0,0,0,0,1,0,1,0,0,0,0,0,0,0,1,1,3
20192020,056,JEFFERSON,275,Jefferson County,470,Johnson Traditional Middle,275470,056275470,210299000769,"",909,07,167,137,62,88,150,0,0,0,5,3,8,7,7,14,0,0,0,9,10,19,54,59,113,304
20192020,056,JEFFERSON,275,Jefferson County,470,Johnson Traditional Middle,275470,056275470,210299000769,"",909,06,141,147,72,83,155,0,2,2,3,1,4,9,10,19,0,0,0,5,7,12,58,38,96,288
20192020,056,JEFFERSON,275,Jefferson County,470,Johnson Traditional Middle,275470,056275470,210299000769,"",909,08,144,139,73,75,148,0,0,0,3,3,6,7,6,13,0,0,0,9,5,14,47,55,102,283
20192020,056,JEFFERSON,275,Jefferson County,470,Johnson Traditional Middle,275470,056275470,210299000769,"",909,All Students,452,423,207,246,453,0,2,2,11,7,18,23,23,46,0,0,0,23,22,45,159,152,311,875
20192020,056,JEFFERSON,275,Jefferson County,480,Maupin Elementary,275480,056275480,210299000770,"",909,03,23,20,18,20,38,0,0,0,0,0,0,0,1,1,0,0,0,2,2,4,0,0,0,43
20192020,056,JEFFERSON,275,Jefferson County,480,Maupin Elementary,275480,056275480,210299000770,"",909,02,19,21,20,18,38,0,0,0,0,0,0,1,1,2,0,0,0,0,0,0,0,0,0,40
20192020,056,JEFFERSON,275,Jefferson County,480,Maupin Elementary,275480,056275480,210299000770,"",909,05,24,30,22,19,41,0,0,0,0,0,0,1,2,3,0,0,0,2,2,4,5,1,6,54
20192020,056,JEFFERSON,275,Jefferson County,480,Maupin Elementary,275480,056275480,210299000770,"",909,04,20,17,16,17,33,0,0,0,0,0,0,0,1,1,0,0,0,1,2,3,0,0,0,37
20192020,056,JEFFERSON,275,Jefferson County,480,Maupin Elementary,275480,056275480,210299000770,"",909,All Students,120,124,108,103,211,0,0,0,0,0,0,3,6,9,0,0,0,7,7,14,6,4,10,244
20192020,056,JEFFERSON,275,Jefferson County,480,Maupin Elementary,275480,056275480,210299000770,"",909,PS,53,47,41,49,90,0,0,0,0,0,0,1,1,2,0,0,0,4,0,4,1,3,4,100
20192020,056,JEFFERSON,275,Jefferson County,480,Maupin Elementary,275480,056275480,210299000770,"",909,KG,14,13,11,10,21,0,0,0,0,0,0,0,1,1,0,0,0,1,1,2,1,2,3,27
20192020,056,JEFFERSON,275,Jefferson County,480,Maupin Elementary,275480,056275480,210299000770,"",909,01,20,23,21,19,40,0,0,0,0,0,0,1,0,1,0,0,0,1,0,1,0,1,1,43
20192020,056,JEFFERSON,275,Jefferson County,500,Portland Elementary,275500,056275500,210299000771,"",909,03,20,20,14,7,21,0,0,0,0,0,0,0,1,1,0,0,0,2,0,2,4,12,16,40
20192020,056,JEFFERSON,275,Jefferson County,500,Portland Elementary,275500,056275500,210299000771,"",909,All Students,122,139,72,59,131,0,0,0,0,0,0,6,4,10,0,0,0,9,4,13,52,55,107,261
20192020,056,JEFFERSON,275,Jefferson County,500,Portland Elementary,275500,056275500,210299000771,"",909,KG,25,26,11,15,26,0,0,0,0,0,0,2,0,2,0,0,0,2,1,3,11,9,20,51
20192020,056,JEFFERSON,275,Jefferson County,500,Portland Elementary,275500,056275500,210299000771,"",909,01,24,17,10,8,18,0,0,0,0,0,0,1,2,3,0,0,0,1,1,2,5,13,18,41
20192020,056,JEFFERSON,275,Jefferson County,500,Portland Elementary,275500,056275500,210299000771,"",909,02,18,24,12,11,23,0,0,0,0,0,0,1,1,2,0,0,0,0,1,1,11,5,16,42
20192020,056,JEFFERSON,275,Jefferson County,500,Portland Elementary,275500,056275500,210299000771,"",909,04,17,26,11,7,18,0,0,0,0,0,0,0,0,0,0,0,0,1,0,1,14,10,24,43
20192020,056,JEFFERSON,275,Jefferson County,500,Portland Elementary,275500,056275500,210299000771,"",909,05,18,26,14,11,25,0,0,0,0,0,0,2,0,2,0,0,0,3,1,4,7,6,13,44
20192020,056,JEFFERSON,275,Jefferson County,520,Lincoln Elementary Performing Arts,275520,056275520,210299000772,"",909,03,55,44,10,26,36,0,0,0,1,1,2,9,5,14,0,0,0,3,5,8,21,18,39,99
20192020,056,JEFFERSON,275,Jefferson County,520,Lincoln Elementary Performing Arts,275520,056275520,210299000772,"",909,04,72,29,11,23,34,0,0,0,0,2,2,4,9,13,0,0,0,0,3,3,14,35,49,101
20192020,056,JEFFERSON,275,Jefferson County,520,Lincoln Elementary Performing Arts,275520,056275520,210299000772,"",909,05,67,38,15,19,34,0,0,0,0,1,1,3,11,14,0,0,0,3,3,6,17,33,50,105
20192020,056,JEFFERSON,275,Jefferson County,520,Lincoln Elementary Performing Arts,275520,056275520,210299000772,"",909,All Students,368,204,64,134,198,0,1,1,1,6,7,31,44,75,0,0,0,16,24,40,92,159,251,572
20192020,056,JEFFERSON,275,Jefferson County,520,Lincoln Elementary Performing Arts,275520,056275520,210299000772,"",909,KG,47,27,7,23,30,0,1,1,0,0,0,4,5,9,0,0,0,4,2,6,12,16,28,74
20192020,056,JEFFERSON,275,Jefferson County,520,Lincoln Elementary Performing Arts,275520,056275520,210299000772,"",909,01,64,31,10,22,32,0,0,0,0,1,1,5,3,8,0,0,0,2,4,6,14,34,48,95
20192020,056,JEFFERSON,275,Jefferson County,520,Lincoln Elementary Performing Arts,275520,056275520,210299000772,"",909,02,63,35,11,21,32,0,0,0,0,1,1,6,11,17,0,0,0,4,7,11,14,23,37,98
20192020,056,JEFFERSON,275,Jefferson County,530,Roosevelt-Perry Elementary,275530,056275530,210299000773,"",909,03,15,11,7,13,20,0,0,0,0,0,0,0,0,0,0,0,0,0,1,1,4,1,5,26
20192020,056,JEFFERSON,275,Jefferson County,530,Roosevelt-Perry Elementary,275530,056275530,210299000773,"",909,05,10,17,13,9,22,0,0,0,0,0,0,1,0,1,0,0,0,2,0,2,1,1,2,27
20192020,056,JEFFERSON,275,Jefferson County,530,Roosevelt-Perry Elementary,275530,056275530,210299000773,"",909,All Students,86,106,81,73,154,0,0,0,1,1,2,2,1,3,0,0,0,6,4,10,16,7,23,192
20192020,056,JEFFERSON,275,Jefferson County,530,Roosevelt-Perry Elementary,275530,056275530,210299000773,"",909,KG,15,18,16,13,29,0,0,0,0,0,0,0,1,1,0,0,0,1,1,2,1,0,1,33
20192020,056,JEFFERSON,275,Jefferson County,530,Roosevelt-Perry Elementary,275530,056275530,210299000773,"",909,01,19,24,18,17,35,0,0,0,1,1,2,1,0,1,0,0,0,1,0,1,3,1,4,43
20192020,056,JEFFERSON,275,Jefferson County,530,Roosevelt-Perry Elementary,275530,056275530,210299000773,"",909,02,17,15,12,14,26,0,0,0,0,0,0,0,0,0,0,0,0,0,1,1,3,2,5,32
20192020,056,JEFFERSON,275,Jefferson County,530,Roosevelt-Perry Elementary,275530,056275530,210299000773,"",909,04,10,21,15,7,22,0,0,0,0,0,0,0,0,0,0,0,0,2,1,3,4,2,6,31
20192020,056,JEFFERSON,275,Jefferson County,560,Rutherford Elementary,275560,056275560,210299000775,"",909,05,40,43,20,15,35,0,0,0,5,5,10,9,5,14,0,0,0,0,4,4,9,11,20,83
20192020,056,JEFFERSON,275,Jefferson County,560,Rutherford Elementary,275560,056275560,210299000775,"",909,01,38,33,5,12,17,0,0,0,6,3,9,6,11,17,0,0,0,2,3,5,14,9,23,71
20192020,056,JEFFERSON,275,Jefferson County,560,Rutherford Elementary,275560,056275560,210299000775,"",909,03,32,41,13,6,19,0,0,0,2,4,6,7,12,19,1,0,1,4,0,4,14,10,24,73
20192020,056,JEFFERSON,275,Jefferson County,560,Rutherford Elementary,275560,056275560,210299000775,"",909,04,34,38,13,13,26,0,0,0,5,1,6,9,6,15,0,0,0,3,4,7,8,10,18,72
20192020,056,JEFFERSON,275,Jefferson County,560,Rutherford Elementary,275560,056275560,210299000775,"",909,All Students,210,237,83,73,156,0,0,0,32,17,49,43,46,89,1,0,1,11,19,30,67,55,122,447
20192020,056,JEFFERSON,275,Jefferson County,560,Rutherford Elementary,275560,056275560,210299000775,"",909,PS,16,24,5,6,11,0,0,0,7,1,8,5,7,12,0,0,0,2,0,2,5,2,7,40
20192020,056,JEFFERSON,275,Jefferson County,560,Rutherford Elementary,275560,056275560,210299000775,"",909,KG,39,41,17,16,33,0,0,0,3,4,7,7,5,12,0,0,0,1,5,6,13,9,22,80
20192020,056,JEFFERSON,275,Jefferson County,560,Rutherford Elementary,275560,056275560,210299000775,"",909,02,27,41,15,11,26,0,0,0,11,0,11,5,7,12,0,0,0,1,3,4,9,6,15,68
20192020,056,JEFFERSON,275,Jefferson County,580,Semple Elementary,275580,056275580,210299000776,"",909,03,52,47,21,24,45,0,0,0,3,4,7,7,7,14,0,0,0,3,3,6,13,14,27,99
20192020,056,JEFFERSON,275,Jefferson County,580,Semple Elementary,275580,056275580,210299000776,"",909,All Students,280,288,134,124,258,0,1,1,12,14,26,43,44,87,0,1,1,29,26,55,70,70,140,568
20192020,056,JEFFERSON,275,Jefferson County,580,Semple Elementary,275580,056275580,210299000776,"",909,KG,53,51,25,22,47,0,0,0,2,2,4,8,13,21,0,1,1,3,3,6,13,12,25,104
20192020,056,JEFFERSON,275,Jefferson County,580,Semple Elementary,275580,056275580,210299000776,"",909,01,47,56,22,18,40,0,1,1,3,1,4,12,6,18,0,0,0,6,6,12,13,15,28,103
20192020,056,JEFFERSON,275,Jefferson County,580,Semple Elementary,275580,056275580,210299000776,"",909,02,43,46,23,18,41,0,0,0,1,3,4,9,7,16,0,0,0,4,3,7,9,12,21,89
20192020,056,JEFFERSON,275,Jefferson County,580,Semple Elementary,275580,056275580,210299000776,"",909,04,49,37,17,26,43,0,0,0,1,0,1,4,6,10,0,0,0,6,6,12,9,11,20,86
20192020,056,JEFFERSON,275,Jefferson County,580,Semple Elementary,275580,056275580,210299000776,"",909,05,36,51,26,16,42,0,0,0,2,4,6,3,5,8,0,0,0,7,5,12,13,6,19,87
20192020,056,JEFFERSON,275,Jefferson County,590,The Academy @ Shawnee,275590,056275590,210299000777,"",909,12,41,47,17,25,42,0,1,1,0,1,1,3,0,3,0,0,0,1,0,1,26,14,40,88
20192020,056,JEFFERSON,275,Jefferson County,590,The Academy @ Shawnee,275590,056275590,210299000777,"",909,14,3,4,3,3,6,0,0,0,0,0,0,0,0,0,0,0,0,0,0,0,1,0,1,7
20192020,056,JEFFERSON,275,Jefferson County,590,The Academy @ Shawnee,275590,056275590,210299000777,"",909,All Students,221,297,163,135,298,2,1,3,2,3,5,13,8,21,1,0,1,13,7,20,103,67,170,518
20192020,056,JEFFERSON,275,Jefferson County,590,The Academy @ Shawnee,275590,056275590,210299000777,"",909,06,14,31,15,10,25,0,0,0,0,1,1,4,0,4,0,0,0,2,1,3,10,2,12,45
20192020,056,JEFFERSON,275,Jefferson County,590,The Academy @ Shawnee,275590,056275590,210299000777,"",909,07,25,20,6,23,29,0,0,0,1,0,1,2,0,2,0,0,0,1,0,1,10,2,12,45
20192020,056,JEFFERSON,275,Jefferson County,590,The Academy @ Shawnee,275590,056275590,210299000777,"",909,08,13,31,19,7,26,0,0,0,0,1,1,2,2,4,0,0,0,3,0,3,7,3,10,44
20192020,056,JEFFERSON,275,Jefferson County,590,The Academy @ Shawnee,275590,056275590,210299000777,"",909,09,47,64,42,24,66,0,0,0,1,0,1,0,3,3,0,0,0,3,2,5,18,18,36,111
20192020,056,JEFFERSON,275,Jefferson County,590,The Academy @ Shawnee,275590,056275590,210299000777,"",909,10,48,58,34,33,67,2,0,2,0,0,0,1,2,3,0,0,0,2,1,3,19,12,31,106
20192020,056,JEFFERSON,275,Jefferson County,590,The Academy @ Shawnee,275590,056275590,210299000777,"",909,11,30,42,27,10,37,0,0,0,0,0,0,1,1,2,1,0,1,1,3,4,12,16,28,72
20192020,056,JEFFERSON,275,Jefferson County,610,Shelby Traditional Academy,275610,056275610,210299000780,"",909,03,73,54,30,51,81,0,0,0,1,0,1,8,10,18,0,0,0,4,3,7,11,9,20,127
20192020,056,JEFFERSON,275,Jefferson County,610,Shelby Traditional Academy,275610,056275610,210299000780,"",909,05,76,73,52,46,98,0,0,0,1,1,2,12,7,19,0,0,0,2,3,5,6,19,25,149
20192020,056,JEFFERSON,275,Jefferson County,610,Shelby Traditional Academy,275610,056275610,210299000780,"",909,All Students,372,374,222,242,464,0,0,0,5,4,9,68,49,117,0,0,0,13,12,25,66,65,131,746
20192020,056,JEFFERSON,275,Jefferson County,610,Shelby Traditional Academy,275610,056275610,210299000780,"",909,KG,64,59,32,44,76,0,0,0,0,1,1,11,3,14,0,0,0,0,2,2,16,14,30,123
20192020,056,JEFFERSON,275,Jefferson County,610,Shelby Traditional Academy,275610,056275610,210299000780,"",909,01,58,64,42,36,78,0,0,0,2,0,2,12,9,21,0,0,0,0,3,3,8,10,18,122
20192020,056,JEFFERSON,275,Jefferson County,610,Shelby Traditional Academy,275610,056275610,210299000780,"",909,02,43,56,32,23,55,0,0,0,0,1,1,8,12,20,0,0,0,4,0,4,12,7,19,99
20192020,056,JEFFERSON,275,Jefferson County,610,Shelby Traditional Academy,275610,056275610,210299000780,"",909,04,58,68,34,42,76,0,0,0,1,1,2,17,8,25,0,0,0,3,1,4,13,6,19,126
20192020,056,JEFFERSON,275,Jefferson County,620,Frederick Law Olmsted Academy North,275620,056275620,210299000781,"",909,06,0,208,91,0,91,0,0,0,11,0,11,35,0,35,2,0,2,10,0,10,59,0,59,208
20192020,056,JEFFERSON,275,Jefferson County,620,Frederick Law Olmsted Academy North,275620,056275620,210299000781,"",909,08,0,219,94,0,94,0,0,0,18,0,18,43,0,43,0,0,0,5,0,5,59,0,59,219
20192020,056,JEFFERSON,275,Jefferson County,620,Frederick Law Olmsted Academy North,275620,056275620,210299000781,"",909,All Students,0,643,282,0,282,0,0,0,41,0,41,108,0,108,3,0,3,30,0,30,179,0,179,643
20192020,056,JEFFERSON,275,Jefferson County,620,Frederick Law Olmsted Academy North,275620,056275620,210299000781,"",909,07,0,216,97,0,97,0,0,0,12,0,12,30,0,30,1,0,1,15,0,15,61,0,61,216
20192020,056,JEFFERSON,275,Jefferson County,660,Coleridge-Taylor Montessori Elementary,275660,056275660,210299000783,"",909,03,37,48,36,27,63,0,0,0,1,0,1,1,0,1,0,0,0,1,3,4,9,7,16,85
20192020,056,JEFFERSON,275,Jefferson County,660,Coleridge-Taylor Montessori Elementary,275660,056275660,210299000783,"",909,05,38,45,34,33,67,0,0,0,0,0,0,1,0,1,0,0,0,2,3,5,8,2,10,83
20192020,056,JEFFERSON,275,Jefferson County,660,Coleridge-Taylor Montessori Elementary,275660,056275660,210299000783,"",909,All Students,211,221,158,152,310,0,0,0,2,0,2,3,6,9,0,0,0,13,19,32,45,34,79,432
20192020,056,JEFFERSON,275,Jefferson County,660,Coleridge-Taylor Montessori Elementary,275660,056275660,210299000783,"",909,PS,9,9,1,3,4,0,0,0,0,0,0,0,0,0,0,0,0,1,2,3,7,4,11,18
20192020,056,JEFFERSON,275,Jefferson County,660,Coleridge-Taylor Montessori Elementary,275660,056275660,210299000783,"",909,KG,40,40,27,22,49,0,0,0,0,0,0,1,2,3,0,0,0,5,4,9,7,12,19,80
20192020,056,JEFFERSON,275,Jefferson County,660,Coleridge-Taylor Montessori Elementary,275660,056275660,210299000783,"",909,01,40,28,19,30,49,0,0,0,0,0,0,0,1,1,0,0,0,2,6,8,7,3,10,68
20192020,056,JEFFERSON,275,Jefferson County,660,Coleridge-Taylor Montessori Elementary,275660,056275660,210299000783,"",909,02,19,25,18,14,32,0,0,0,0,0,0,0,1,1,0,0,0,1,1,2,6,3,9,44
20192020,056,JEFFERSON,275,Jefferson County,660,Coleridge-Taylor Montessori Elementary,275660,056275660,210299000783,"",909,04,37,35,24,26,50,0,0,0,1,0,1,0,2,2,0,0,0,2,2,4,8,7,15,72
20192020,056,JEFFERSON,275,Jefferson County,680,Carter Traditional Elementary,275680,056275680,210299000784,"",909,03,59,39,14,23,37,0,0,0,0,0,0,2,0,2,0,0,0,3,2,5,20,34,54,98
20192020,056,JEFFERSON,275,Jefferson County,680,Carter Traditional Elementary,275680,056275680,210299000784,"",909,05,51,60,23,26,49,0,0,0,1,0,1,3,1,4,0,0,0,4,3,7,29,21,50,111
20192020,056,JEFFERSON,275,Jefferson County,680,Carter Traditional Elementary,275680,056275680,210299000784,"",909,All Students,313,286,124,137,261,0,1,1,3,1,4,10,8,18,0,0,0,22,22,44,127,144,271,599
20192020,056,JEFFERSON,275,Jefferson County,680,Carter Traditional Elementary,275680,056275680,210299000784,"",909,KG,51,42,21,21,42,0,0,0,0,0,0,1,1,2,0,0,0,5,7,12,15,22,37,93
20192020,056,JEFFERSON,275,Jefferson County,680,Carter Traditional Elementary,275680,056275680,210299000784,"",909,01,51,41,18,24,42,0,0,0,1,1,2,1,1,2,0,0,0,3,3,6,18,22,40,92
20192020,056,JEFFERSON,275,Jefferson County,680,Carter Traditional Elementary,275680,056275680,210299000784,"",909,02,42,54,25,19,44,0,1,1,1,0,1,2,3,5,0,0,0,4,3,7,22,16,38,96
20192020,056,JEFFERSON,275,Jefferson County,680,Carter Traditional Elementary,275680,056275680,210299000784,"",909,04,59,50,23,24,47,0,0,0,0,0,0,1,2,3,0,0,0,3,4,7,23,29,52,109
20192020,056,JEFFERSON,275,Jefferson County,710,Western Middle School for the Arts,275710,056275710,210299000785,"",909,All Students,469,187,102,284,386,0,0,0,6,7,13,21,53,74,1,1,2,12,17,29,45,107,152,656
20192020,056,JEFFERSON,275,Jefferson County,710,Western Middle School for the Arts,275710,056275710,210299000785,"",909,08,137,68,43,90,133,0,0,0,3,1,4,5,19,24,1,0,1,4,4,8,12,23,35,205
20192020,056,JEFFERSON,275,Jefferson County,710,Western Middle School for the Arts,275710,056275710,210299000785,"",909,07,158,53,23,94,117,0,0,0,2,3,5,7,17,24,0,1,1,5,5,10,16,38,54,211
20192020,056,JEFFERSON,275,Jefferson County,710,Western Middle School for the Arts,275710,056275710,210299000785,"",909,06,174,66,36,100,136,0,0,0,1,3,4,9,17,26,0,0,0,3,8,11,17,46,63,240
20192020,056,JEFFERSON,275,Jefferson County,720,Kennedy Montessori Elementary,275720,056275720,210299000786,"",909,01,41,48,38,33,71,0,0,0,0,1,1,3,3,6,0,0,0,2,0,2,5,4,9,89
20192020,056,JEFFERSON,275,Jefferson County,720,Kennedy Montessori Elementary,275720,056275720,210299000786,"",909,All Students,263,271,226,207,433,0,0,0,2,3,5,18,22,40,0,0,0,6,9,15,19,22,41,534
20192020,056,JEFFERSON,275,Jefferson County,720,Kennedy Montessori Elementary,275720,056275720,210299000786,"",909,PS,9,1,1,9,10,0,0,0,0,0,0,0,0,0,0,0,0,0,0,0,0,0,0,10
20192020,056,JEFFERSON,275,Jefferson County,720,Kennedy Montessori Elementary,275720,056275720,210299000786,"",909,KG,38,50,39,33,72,0,0,0,0,0,0,5,3,8,0,0,0,2,1,3,4,1,5,88
20192020,056,JEFFERSON,275,Jefferson County,720,Kennedy Montessori Elementary,275720,056275720,210299000786,"",909,02,42,39,34,33,67,0,0,0,0,0,0,2,3,5,0,0,0,0,2,2,3,4,7,81
20192020,056,JEFFERSON,275,Jefferson County,720,Kennedy Montessori Elementary,275720,056275720,210299000786,"",909,03,47,53,42,35,77,0,0,0,1,1,2,6,3,9,0,0,0,2,2,4,2,6,8,100
20192020,056,JEFFERSON,275,Jefferson County,720,Kennedy Montessori Elementary,275720,056275720,210299000786,"",909,04,52,35,35,44,79,0,0,0,0,0,0,0,4,4,0,0,0,0,1,1,0,3,3,87
20192020,056,JEFFERSON,275,Jefferson County,720,Kennedy Montessori Elementary,275720,056275720,210299000786,"",909,05,43,46,38,29,67,0,0,0,1,1,2,2,6,8,0,0,0,0,3,3,5,4,9,89
20192020,056,JEFFERSON,275,Jefferson County,730,Frederick Law Olmsted Academy South,275730,056275730,210299001425,"",909,06,257,0,0,116,116,0,0,0,0,7,7,0,52,52,0,0,0,0,7,7,0,75,75,257
20192020,056,JEFFERSON,275,Jefferson County,730,Frederick Law Olmsted Academy South,275730,056275730,210299001425,"",909,07,275,0,0,120,120,0,0,0,0,9,9,0,43,43,0,0,0,0,10,10,0,93,93,275
20192020,056,JEFFERSON,275,Jefferson County,730,Frederick Law Olmsted Academy South,275730,056275730,210299001425,"",909,08,249,0,0,113,113,0,0,0,0,15,15,0,41,41,0,0,0,0,10,10,0,70,70,249
20192020,056,JEFFERSON,275,Jefferson County,730,Frederick Law Olmsted Academy South,275730,056275730,210299001425,"",909,All Students,781,0,0,349,349,0,0,0,0,31,31,0,136,136,0,0,0,0,27,27,0,238,238,781
20192020,056,JEFFERSON,275,Jefferson County,768,Home of the Innocents Discovery,275768,056275768,210299001943,"",909,PS,3,1,0,0,0,0,0,0,0,1,1,0,0,0,0,0,0,0,0,0,1,2,3,4
20192020,056,JEFFERSON,275,Jefferson County,768,Home of the Innocents Discovery,275768,056275768,210299001943,"",909,01,1,1,1,0,1,0,0,0,0,1,1,0,0,0,0,0,0,0,0,0,0,0,0,2
20192020,056,JEFFERSON,275,Jefferson County,768,Home of the Innocents Discovery,275768,056275768,210299001943,"",909,03,0,3,1,0,1,0,0,0,0,0,0,0,0,0,0,0,0,0,0,0,2,0,2,3
20192020,056,JEFFERSON,275,Jefferson County,768,Home of the Innocents Discovery,275768,056275768,210299001943,"",909,04,0,1,0,0,0,0,0,0,0,0,0,0,0,0,0,0,0,0,0,0,1,0,1,1
20192020,056,JEFFERSON,275,Jefferson County,768,Home of the Innocents Discovery,275768,056275768,210299001943,"",909,06,3,0,0,1,1,0,0,0,0,0,0,0,0,0,0,0,0,0,0,0,0,2,2,3
20192020,056,JEFFERSON,275,Jefferson County,768,Home of the Innocents Discovery,275768,056275768,210299001943,"",909,07,2,0,0,0,0,0,0,0,0,0,0,0,0,0,0,0,0,0,0,0,0,2,2,2
20192020,056,JEFFERSON,275,Jefferson County,768,Home of the Innocents Discovery,275768,056275768,210299001943,"",909,08,0,1,0,0,0,0,0,0,0,0,0,0,0,0,0,0,0,0,0,0,1,0,1,1
20192020,056,JEFFERSON,275,Jefferson County,768,Home of the Innocents Discovery,275768,056275768,210299001943,"",909,10,0,1,0,0,0,0,0,0,0,0,0,0,0,0,0,0,0,0,0,0,1,0,1,1
20192020,056,JEFFERSON,275,Jefferson County,768,Home of the Innocents Discovery,275768,056275768,210299001943,"",909,09,1,2,0,0,0,0,0,0,0,0,0,0,0,0,0,0,0,0,0,0,2,1,3,3
20192020,056,JEFFERSON,275,Jefferson County,768,Home of the Innocents Discovery,275768,056275768,210299001943,"",909,14,3,8,3,1,4,0,0,0,0,0,0,1,0,1,0,0,0,0,0,0,4,2,6,11
20192020,056,JEFFERSON,275,Jefferson County,768,Home of the Innocents Discovery,275768,056275768,210299001943,"",909,11,2,1,0,1,1,0,0,0,0,0,0,0,0,0,0,0,0,0,0,0,1,1,2,3
20192020,056,JEFFERSON,275,Jefferson County,768,Home of the Innocents Discovery,275768,056275768,210299001943,"",909,All Students,12,18,5,3,8,0,0,0,0,1,1,1,0,1,0,0,0,0,0,0,12,8,20,30
20192020,056,JEFFERSON,275,Jefferson County,769,Home of the Innocents School,275769,056275769,210299001946,"",909,07,3,7,2,1,3,0,0,0,0,0,0,0,1,1,0,0,0,0,0,0,5,1,6,10
20192020,056,JEFFERSON,275,Jefferson County,769,Home of the Innocents School,275769,056275769,210299001946,"",909,All Students,32,30,7,5,12,0,0,0,0,0,0,0,1,1,0,0,0,3,2,5,20,24,44,62
20192020,056,JEFFERSON,275,Jefferson County,769,Home of the Innocents School,275769,056275769,210299001946,"",909,KG,0,2,2,0,2,0,0,0,0,0,0,0,0,0,0,0,0,0,0,0,0,0,0,2
20192020,056,JEFFERSON,275,Jefferson County,769,Home of the Innocents School,275769,056275769,210299001946,"",909,01,1,0,0,0,0,0,0,0,0,0,0,0,0,0,0,0,0,0,0,0,0,1,1,1
20192020,056,JEFFERSON,275,Jefferson County,769,Home of the Innocents School,275769,056275769,210299001946,"",909,02,2,3,0,0,0,0,0,0,0,0,0,0,0,0,0,0,0,0,1,1,3,1,4,5
20192020,056,JEFFERSON,275,Jefferson County,769,Home of the Innocents School,275769,056275769,210299001946,"",909,03,2,3,0,0,0,0,0,0,0,0,0,0,0,0,0,0,0,0,0,0,3,2,5,5
20192020,056,JEFFERSON,275,Jefferson County,769,Home of the Innocents School,275769,056275769,210299001946,"",909,04,0,2,1,0,1,0,0,0,0,0,0,0,0,0,0,0,0,0,0,0,1,0,1,2
20192020,056,JEFFERSON,275,Jefferson County,769,Home of the Innocents School,275769,056275769,210299001946,"",909,05,1,0,0,1,1,0,0,0,0,0,0,0,0,0,0,0,0,0,0,0,0,0,0,1
20192020,056,JEFFERSON,275,Jefferson County,769,Home of the Innocents School,275769,056275769,210299001946,"",909,06,1,3,0,0,0,0,0,0,0,0,0,0,0,0,0,0,0,1,0,1,2,1,3,4
20192020,056,JEFFERSON,275,Jefferson County,769,Home of the Innocents School,275769,056275769,210299001946,"",909,08,5,1,0,1,1,0,0,0,0,0,0,0,0,0,0,0,0,0,0,0,1,4,5,6
20192020,056,JEFFERSON,275,Jefferson County,769,Home of the Innocents School,275769,056275769,210299001946,"",909,09,4,3,0,0,0,0,0,0,0,0,0,0,0,0,0,0,0,1,0,1,2,4,6,7
20192020,056,JEFFERSON,275,Jefferson County,769,Home of the Innocents School,275769,056275769,210299001946,"",909,10,8,3,2,1,3,0,0,0,0,0,0,0,0,0,0,0,0,0,1,1,1,6,7,11
20192020,056,JEFFERSON,275,Jefferson County,769,Home of the Innocents School,275769,056275769,210299001946,"",909,11,1,1,0,1,1,0,0,0,0,0,0,0,0,0,0,0,0,1,0,1,0,0,0,2
20192020,056,JEFFERSON,275,Jefferson County,769,Home of the Innocents School,275769,056275769,210299001946,"",909,12,4,2,0,0,0,0,0,0,0,0,0,0,0,0,0,0,0,0,0,0,2,4,6,6
20192020,056,JEFFERSON,275,Jefferson County,784,Peace Academy,275784,056275784,210299001613,"",909,04,1,6,2,1,3,0,0,0,0,0,0,0,0,0,0,0,0,0,0,0,4,0,4,7
20192020,056,JEFFERSON,275,Jefferson County,784,Peace Academy,275784,056275784,210299001613,"",909,10,4,3,0,2,2,0,0,0,0,0,0,0,0,0,0,0,0,0,1,1,3,1,4,7
20192020,056,JEFFERSON,275,Jefferson County,784,Peace Academy,275784,056275784,210299001613,"",909,07,3,3,2,0,2,0,0,0,0,0,0,0,1,1,0,0,0,0,0,0,1,2,3,6
20192020,056,JEFFERSON,275,Jefferson County,784,Peace Academy,275784,056275784,210299001613,"",909,08,6,2,1,4,5,0,0,0,0,0,0,0,0,0,0,0,0,0,0,0,1,2,3,8
20192020,056,JEFFERSON,275,Jefferson County,784,Peace Academy,275784,056275784,210299001613,"",909,05,4,5,2,1,3,0,0,0,0,0,0,1,0,1,0,0,0,0,0,0,2,3,5,9
20192020,056,JEFFERSON,275,Jefferson County,784,Peace Academy,275784,056275784,210299001613,"",909,All Students,43,37,14,11,25,0,0,0,0,0,0,2,2,4,0,0,0,0,1,1,21,29,50,80
20192020,056,JEFFERSON,275,Jefferson County,784,Peace Academy,275784,056275784,210299001613,"",909,KG,0,1,1,0,1,0,0,0,0,0,0,0,0,0,0,0,0,0,0,0,0,0,0,1
20192020,056,JEFFERSON,275,Jefferson County,784,Peace Academy,275784,056275784,210299001613,"",909,01,2,1,0,0,0,0,0,0,0,0,0,0,0,0,0,0,0,0,0,0,1,2,3,3
20192020,056,JEFFERSON,275,Jefferson County,784,Peace Academy,275784,056275784,210299001613,"",909,02,1,2,0,0,0,0,0,0,0,0,0,0,0,0,0,0,0,0,0,0,2,1,3,3
20192020,056,JEFFERSON,275,Jefferson County,784,Peace Academy,275784,056275784,210299001613,"",909,11,3,4,4,0,4,0,0,0,0,0,0,0,0,0,0,0,0,0,0,0,0,3,3,7
20192020,056,JEFFERSON,275,Jefferson County,784,Peace Academy,275784,056275784,210299001613,"",909,09,9,7,2,3,5,0,0,0,0,0,0,1,1,2,0,0,0,0,0,0,4,5,9,16
20192020,056,JEFFERSON,275,Jefferson County,784,Peace Academy,275784,056275784,210299001613,"",909,06,5,3,0,0,0,0,0,0,0,0,0,0,0,0,0,0,0,0,0,0,3,5,8,8
20192020,056,JEFFERSON,275,Jefferson County,784,Peace Academy,275784,056275784,210299001613,"",909,03,3,0,0,0,0,0,0,0,0,0,0,0,0,0,0,0,0,0,0,0,0,3,3,3
20192020,056,JEFFERSON,275,Jefferson County,784,Peace Academy,275784,056275784,210299001613,"",909,12,2,0,0,0,0,0,0,0,0,0,0,0,0,0,0,0,0,0,0,0,0,2,2,2
20192020,056,JEFFERSON,275,Jefferson County,917,Churchill Park School,275917,056275917,210299000789,"",909,KG,2,3,1,1,2,0,0,0,0,0,0,0,0,0,0,0,0,0,0,0,2,1,3,5
20192020,056,JEFFERSON,275,Jefferson County,917,Churchill Park School,275917,056275917,210299000789,"",909,03,0,2,0,0,0,0,0,0,1,0,1,0,0,0,0,0,0,0,0,0,1,0,1,2
20192020,056,JEFFERSON,275,Jefferson County,917,Churchill Park School,275917,056275917,210299000789,"",909,All Students,32,57,21,11,32,0,0,0,4,4,8,3,0,3,0,0,0,0,2,2,29,15,44,89
20192020,056,JEFFERSON,275,Jefferson County,917,Churchill Park School,275917,056275917,210299000789,"",909,PS,12,20,6,3,9,0,0,0,1,0,1,6,3,9,0,0,0,1,1,2,6,5,11,32
20192020,056,JEFFERSON,275,Jefferson County,917,Churchill Park School,275917,056275917,210299000789,"",909,01,2,1,0,0,0,0,0,0,0,0,0,0,0,0,0,0,0,0,0,0,1,2,3,3
20192020,056,JEFFERSON,275,Jefferson County,917,Churchill Park School,275917,056275917,210299000789,"",909,04,1,4,3,0,3,0,0,0,0,0,0,1,0,1,0,0,0,0,0,0,0,1,1,5
20192020,056,JEFFERSON,275,Jefferson County,917,Churchill Park School,275917,056275917,210299000789,"",909,05,3,5,1,1,2,0,0,0,1,1,2,0,0,0,0,0,0,0,0,0,3,1,4,8
20192020,056,JEFFERSON,275,Jefferson County,917,Churchill Park School,275917,056275917,210299000789,"",909,06,3,3,2,2,4,0,0,0,0,1,1,0,0,0,0,0,0,0,0,0,1,0,1,6
20192020,056,JEFFERSON,275,Jefferson County,917,Churchill Park School,275917,056275917,210299000789,"",909,07,4,2,1,0,1,0,0,0,0,0,0,0,0,0,0,0,0,0,1,1,1,3,4,6
20192020,056,JEFFERSON,275,Jefferson County,917,Churchill Park School,275917,056275917,210299000789,"",909,08,3,5,2,2,4,0,0,0,0,0,0,0,0,0,0,0,0,0,0,0,3,1,4,8
20192020,056,JEFFERSON,275,Jefferson County,917,Churchill Park School,275917,056275917,210299000789,"",909,09,1,3,1,0,1,0,0,0,1,0,1,1,0,1,0,0,0,0,0,0,0,1,1,4
20192020,056,JEFFERSON,275,Jefferson County,917,Churchill Park School,275917,056275917,210299000789,"",909,10,1,5,3,0,3,0,0,0,0,0,0,0,0,0,0,0,0,0,0,0,2,1,3,6
20192020,056,JEFFERSON,275,Jefferson County,917,Churchill Park School,275917,056275917,210299000789,"",909,11,1,8,3,0,3,0,0,0,1,1,2,1,0,1,0,0,0,0,0,0,3,0,3,9
20192020,056,JEFFERSON,275,Jefferson County,917,Churchill Park School,275917,056275917,210299000789,"",909,12,3,4,1,1,2,0,0,0,0,0,0,0,0,0,0,0,0,0,1,1,3,1,4,7
20192020,056,JEFFERSON,275,Jefferson County,917,Churchill Park School,275917,056275917,210299000789,"",909,14,7,10,3,3,6,0,0,0,0,1,1,0,0,0,0,0,0,0,0,0,7,3,10,17
20192020,056,JEFFERSON,275,Jefferson County,917,Churchill Park School,275917,056275917,210299000789,"",909,02,1,2,0,1,1,0,0,0,0,0,0,0,0,0,0,0,0,0,0,0,2,0,2,3
20192020,056,JEFFERSON,275,Jefferson County,919,George Unseld Early Childhood Center,275919,056275919,210299002376,"",909,All Students,0,0,0,0,0,0,0,0,0,0,0,0,0,0,0,0,0,0,0,0,0,0,0,0
20192020,056,JEFFERSON,275,Jefferson County,919,George Unseld Early Childhood Center,275919,056275919,210299002376,"",909,PS,169,206,88,69,157,0,0,0,26,29,55,43,45,88,0,0,0,11,5,16,38,21,59,375
20192020,056,JEFFERSON,275,Jefferson County,920,Ahrens Educational Resource Center,275920,056275920,210299001447,"",909,14,10,27,9,4,13,0,0,0,2,0,2,1,1,2,0,0,0,3,0,3,12,5,17,37
20192020,056,JEFFERSON,275,Jefferson County,920,Ahrens Educational Resource Center,275920,056275920,210299001447,"",909,All Students,10,28,9,4,13,0,0,0,2,0,2,1,1,2,0,0,0,3,0,3,13,5,18,38
20192020,056,JEFFERSON,275,Jefferson County,920,Ahrens Educational Resource Center,275920,056275920,210299001447,"",909,12,0,1,0,0,0,0,0,0,0,0,0,0,0,0,0,0,0,0,0,0,1,0,1,1
20192020,056,JEFFERSON,275,Jefferson County,951,Jefferson County High,275951,056275951,210299001947,"",909,12,333,289,90,99,189,0,1,1,5,4,9,32,13,45,0,0,0,9,10,19,153,206,359,622
20192020,056,JEFFERSON,275,Jefferson County,951,Jefferson County High,275951,056275951,210299001947,"",909,09,28,38,16,11,27,0,0,0,0,0,0,3,0,3,0,0,0,2,3,5,17,14,31,66
20192020,056,JEFFERSON,275,Jefferson County,951,Jefferson County High,275951,056275951,210299001947,"",909,All Students,577,518,158,179,337,1,2,3,5,5,10,50,25,75,0,1,1,22,18,40,282,347,629,1095
20192020,056,JEFFERSON,275,Jefferson County,951,Jefferson County High,275951,056275951,210299001947,"",909,10,86,76,25,25,50,0,0,0,0,1,1,6,5,11,0,0,0,3,2,5,42,53,95,162
20192020,056,JEFFERSON,275,Jefferson County,951,Jefferson County High,275951,056275951,210299001947,"",909,11,130,115,27,44,71,1,1,2,0,0,0,9,7,16,0,1,1,8,3,11,70,74,144,245
20192020,067,LETCHER,276,Jenkins Independent,"",---District Total---,276,"","",KVEC,904,07,20,17,0,0,0,0,0,0,0,0,0,1,0,1,0,0,0,0,0,0,16,20,36,37
20192020,067,LETCHER,276,Jenkins Independent,"",---District Total---,276,"","",KVEC,904,08,12,19,0,0,0,0,0,0,0,0,0,0,0,0,0,0,0,0,0,0,19,12,31,31
20192020,067,LETCHER,276,Jenkins Independent,"",---District Total---,276,"","",KVEC,904,09,15,18,0,1,1,0,0,0,0,0,0,0,0,0,0,0,0,0,0,0,18,14,32,33
20192020,067,LETCHER,276,Jenkins Independent,"",---District Total---,276,"","",KVEC,904,10,19,20,0,0,0,0,0,0,0,0,0,0,0,0,0,0,0,0,0,0,20,19,39,39
20192020,067,LETCHER,276,Jenkins Independent,"",---District Total---,276,"","",KVEC,904,12,11,17,0,0,0,0,0,0,0,0,0,0,0,0,0,0,0,0,0,0,17,11,28,28
20192020,067,LETCHER,276,Jenkins Independent,"",---District Total---,276,"","",KVEC,904,11,11,14,0,0,0,0,0,0,0,0,0,1,0,1,0,0,0,0,0,0,13,11,24,25
20192020,067,LETCHER,276,Jenkins Independent,"",---District Total---,276,"","",KVEC,904,All Students,174,223,0,1,1,0,0,0,1,0,1,4,1,5,0,0,0,1,0,1,217,172,389,397
20192020,067,LETCHER,276,Jenkins Independent,"",---District Total---,276,"","",KVEC,904,PS,10,13,0,0,0,0,0,0,0,0,0,0,0,0,0,0,0,0,0,0,13,10,23,23
20192020,067,LETCHER,276,Jenkins Independent,"",---District Total---,276,"","",KVEC,904,KG,18,22,0,0,0,0,0,0,0,0,0,0,0,0,0,0,0,0,0,0,22,18,40,40
20192020,067,LETCHER,276,Jenkins Independent,"",---District Total---,276,"","",KVEC,904,01,13,9,0,0,0,0,0,0,0,0,0,0,0,0,0,0,0,0,0,0,9,13,22,22
20192020,067,LETCHER,276,Jenkins Independent,"",---District Total---,276,"","",KVEC,904,02,10,12,0,0,0,0,0,0,0,0,0,1,0,1,0,0,0,0,0,0,11,10,21,22
20192020,067,LETCHER,276,Jenkins Independent,"",---District Total---,276,"","",KVEC,904,03,10,20,0,0,0,0,0,0,0,0,0,1,0,1,0,0,0,1,0,1,18,10,28,30
20192020,067,LETCHER,276,Jenkins Independent,"",---District Total---,276,"","",KVEC,904,04,14,17,0,0,0,0,0,0,0,0,0,0,0,0,0,0,0,0,0,0,17,14,31,31
20192020,067,LETCHER,276,Jenkins Independent,"",---District Total---,276,"","",KVEC,904,05,14,20,0,0,0,0,0,0,1,0,1,0,1,1,0,0,0,0,0,0,19,13,32,34
20192020,067,LETCHER,276,Jenkins Independent,"",---District Total---,276,"","",KVEC,904,06,7,18,0,0,0,0,0,0,0,0,0,0,0,0,0,0,0,0,0,0,18,7,25,25
20192020,067,LETCHER,276,Jenkins Independent,011,Jenkins Independent School,276011,067276011,210300001642,KVEC,904,11,11,14,0,0,0,0,0,0,0,0,0,1,0,1,0,0,0,0,0,0,13,11,24,25
20192020,067,LETCHER,276,Jenkins Independent,011,Jenkins Independent School,276011,067276011,210300001642,KVEC,904,All Students,174,223,0,1,1,0,0,0,1,0,1,4,1,5,0,0,0,1,0,1,217,172,389,397
20192020,067,LETCHER,276,Jenkins Independent,011,Jenkins Independent School,276011,067276011,210300001642,KVEC,904,PS,10,13,0,0,0,0,0,0,0,0,0,0,0,0,0,0,0,0,0,0,13,10,23,23
20192020,067,LETCHER,276,Jenkins Independent,011,Jenkins Independent School,276011,067276011,210300001642,KVEC,904,KG,18,22,0,0,0,0,0,0,0,0,0,0,0,0,0,0,0,0,0,0,22,18,40,40
20192020,067,LETCHER,276,Jenkins Independent,011,Jenkins Independent School,276011,067276011,210300001642,KVEC,904,01,13,9,0,0,0,0,0,0,0,0,0,0,0,0,0,0,0,0,0,0,9,13,22,22
20192020,067,LETCHER,276,Jenkins Independent,011,Jenkins Independent School,276011,067276011,210300001642,KVEC,904,02,10,12,0,0,0,0,0,0,0,0,0,1,0,1,0,0,0,0,0,0,11,10,21,22
20192020,067,LETCHER,276,Jenkins Independent,011,Jenkins Independent School,276011,067276011,210300001642,KVEC,904,03,10,20,0,0,0,0,0,0,0,0,0,1,0,1,0,0,0,1,0,1,18,10,28,30
20192020,067,LETCHER,276,Jenkins Independent,011,Jenkins Independent School,276011,067276011,210300001642,KVEC,904,04,14,17,0,0,0,0,0,0,0,0,0,0,0,0,0,0,0,0,0,0,17,14,31,31
20192020,067,LETCHER,276,Jenkins Independent,011,Jenkins Independent School,276011,067276011,210300001642,KVEC,904,05,14,20,0,0,0,0,0,0,1,0,1,0,1,1,0,0,0,0,0,0,19,13,32,34
20192020,067,LETCHER,276,Jenkins Independent,011,Jenkins Independent School,276011,067276011,210300001642,KVEC,904,06,7,18,0,0,0,0,0,0,0,0,0,0,0,0,0,0,0,0,0,0,18,7,25,25
20192020,067,LETCHER,276,Jenkins Independent,011,Jenkins Independent School,276011,067276011,210300001642,KVEC,904,07,20,17,0,0,0,0,0,0,0,0,0,1,0,1,0,0,0,0,0,0,16,20,36,37
20192020,067,LETCHER,276,Jenkins Independent,011,Jenkins Independent School,276011,067276011,210300001642,KVEC,904,08,12,19,0,0,0,0,0,0,0,0,0,0,0,0,0,0,0,0,0,0,19,12,31,31
20192020,067,LETCHER,276,Jenkins Independent,011,Jenkins Independent School,276011,067276011,210300001642,KVEC,904,09,15,18,0,1,1,0,0,0,0,0,0,0,0,0,0,0,0,0,0,0,18,14,32,33
20192020,067,LETCHER,276,Jenkins Independent,011,Jenkins Independent School,276011,067276011,210300001642,KVEC,904,10,19,20,0,0,0,0,0,0,0,0,0,0,0,0,0,0,0,0,0,0,20,19,39,39
20192020,067,LETCHER,276,Jenkins Independent,011,Jenkins Independent School,276011,067276011,210300001642,KVEC,904,12,11,17,0,0,0,0,0,0,0,0,0,0,0,0,0,0,0,0,0,0,17,11,28,28
20192020,057,JESSAMINE,281,Jessamine County,"",---District Total---,281,"","",CKEC,901,09,323,327,16,23,39,1,1,2,2,5,7,17,22,39,0,1,1,11,13,24,280,258,538,650
20192020,057,JESSAMINE,281,Jessamine County,"",---District Total---,281,"","",CKEC,901,All Students,3991,4222,269,252,521,7,14,21,23,52,75,313,301,614,3,3,6,187,192,379,3420,3177,6597,8213
20192020,057,JESSAMINE,281,Jessamine County,"",---District Total---,281,"","",CKEC,901,PS,125,223,16,10,26,0,0,0,3,0,3,16,12,28,0,0,0,14,13,27,174,90,264,348
20192020,057,JESSAMINE,281,Jessamine County,"",---District Total---,281,"","",CKEC,901,KG,292,355,22,18,40,1,0,1,1,5,6,32,17,49,0,0,0,20,21,41,279,231,510,647
20192020,057,JESSAMINE,281,Jessamine County,"",---District Total---,281,"","",CKEC,901,01,293,318,20,18,38,0,1,1,4,7,11,29,20,49,0,0,0,15,18,33,250,229,479,611
20192020,057,JESSAMINE,281,Jessamine County,"",---District Total---,281,"","",CKEC,901,02,299,303,20,20,40,0,0,0,0,4,4,22,27,49,0,0,0,23,16,39,238,232,470,602
20192020,057,JESSAMINE,281,Jessamine County,"",---District Total---,281,"","",CKEC,901,03,334,306,16,19,35,1,3,4,1,4,5,26,26,52,1,0,1,15,13,28,246,269,515,640
20192020,057,JESSAMINE,281,Jessamine County,"",---District Total---,281,"","",CKEC,901,04,268,297,16,22,38,0,1,1,2,1,3,20,22,42,0,0,0,18,21,39,241,201,442,565
20192020,057,JESSAMINE,281,Jessamine County,"",---District Total---,281,"","",CKEC,901,05,320,366,33,18,51,0,0,0,0,4,4,25,22,47,1,0,1,13,12,25,294,264,558,686
20192020,057,JESSAMINE,281,Jessamine County,"",---District Total---,281,"","",CKEC,901,06,324,361,26,24,50,1,2,3,4,3,7,28,35,63,0,0,0,15,8,23,287,252,539,685
20192020,057,JESSAMINE,281,Jessamine County,"",---District Total---,281,"","",CKEC,901,07,342,345,20,29,49,2,1,3,3,2,5,32,29,61,1,0,1,15,18,33,272,263,535,687
20192020,057,JESSAMINE,281,Jessamine County,"",---District Total---,281,"","",CKEC,901,08,332,342,24,15,39,1,0,1,2,6,8,24,25,49,0,0,0,14,13,27,277,273,550,674
20192020,057,JESSAMINE,281,Jessamine County,"",---District Total---,281,"","",CKEC,901,10,287,300,20,12,32,0,2,2,2,2,4,24,23,47,0,1,1,10,12,22,244,235,479,587
20192020,057,JESSAMINE,281,Jessamine County,"",---District Total---,281,"","",CKEC,901,11,286,305,20,16,36,0,2,2,1,7,8,19,13,32,0,0,0,9,10,19,256,238,494,591
20192020,057,JESSAMINE,281,Jessamine County,"",---District Total---,281,"","",CKEC,901,12,288,292,16,18,34,0,1,1,1,1,2,15,20,35,0,1,1,9,17,26,251,230,481,580
20192020,057,JESSAMINE,281,Jessamine County,"",---District Total---,281,"","",CKEC,901,14,3,5,0,0,0,0,0,0,0,1,1,0,0,0,0,0,0,0,0,0,5,2,7,8
20192020,057,JESSAMINE,281,Jessamine County,018,Hattie C. Warner Elementary School,281018,057281018,210303000795,CKEC,901,05,50,57,4,3,7,0,0,0,0,0,0,3,3,6,0,0,0,1,1,2,49,43,92,107
20192020,057,JESSAMINE,281,Jessamine County,018,Hattie C. Warner Elementary School,281018,057281018,210303000795,CKEC,901,All Students,262,268,20,16,36,0,1,1,1,0,1,19,19,38,1,0,1,12,15,27,215,211,426,530
20192020,057,JESSAMINE,281,Jessamine County,018,Hattie C. Warner Elementary School,281018,057281018,210303000795,CKEC,901,01,47,57,2,3,5,0,0,0,0,0,0,6,2,8,0,0,0,4,1,5,45,41,86,104
20192020,057,JESSAMINE,281,Jessamine County,018,Hattie C. Warner Elementary School,281018,057281018,210303000795,CKEC,901,02,54,59,7,4,11,0,0,0,0,0,0,1,6,7,0,0,0,4,6,10,47,38,85,113
20192020,057,JESSAMINE,281,Jessamine County,018,Hattie C. Warner Elementary School,281018,057281018,210303000795,CKEC,901,03,66,50,3,5,8,0,1,1,0,0,0,5,6,11,1,0,1,3,3,6,38,51,89,116
20192020,057,JESSAMINE,281,Jessamine County,018,Hattie C. Warner Elementary School,281018,057281018,210303000795,CKEC,901,04,45,45,4,1,5,0,0,0,1,0,1,4,2,6,0,0,0,0,4,4,36,38,74,90
20192020,057,JESSAMINE,281,Jessamine County,019,West Jessamine High School,281019,057281019,210303001640,CKEC,901,12,152,156,9,6,15,0,1,1,1,1,2,10,13,23,0,0,0,3,7,10,133,124,257,308
20192020,057,JESSAMINE,281,Jessamine County,019,West Jessamine High School,281019,057281019,210303001640,CKEC,901,All Students,622,601,29,30,59,0,5,5,4,11,15,33,44,77,0,1,1,16,22,38,519,509,1028,1223
20192020,057,JESSAMINE,281,Jessamine County,019,West Jessamine High School,281019,057281019,210303001640,CKEC,901,09,163,155,7,11,18,0,1,1,2,3,5,6,14,20,0,0,0,4,5,9,136,129,265,318
20192020,057,JESSAMINE,281,Jessamine County,019,West Jessamine High School,281019,057281019,210303001640,CKEC,901,10,148,146,7,3,10,0,1,1,1,2,3,8,11,19,0,1,1,7,6,13,123,124,247,294
20192020,057,JESSAMINE,281,Jessamine County,019,West Jessamine High School,281019,057281019,210303001640,CKEC,901,11,157,142,6,10,16,0,2,2,0,4,4,9,6,15,0,0,0,2,4,6,125,131,256,299
20192020,057,JESSAMINE,281,Jessamine County,019,West Jessamine High School,281019,057281019,210303001640,CKEC,901,14,2,2,0,0,0,0,0,0,0,1,1,0,0,0,0,0,0,0,0,0,2,1,3,4
20192020,057,JESSAMINE,281,Jessamine County,021,East Jessamine High School,281021,057281021,210303001641,CKEC,901,12,119,123,7,10,17,0,0,0,0,0,0,5,4,9,0,1,1,5,9,14,106,95,201,242
20192020,057,JESSAMINE,281,Jessamine County,021,East Jessamine High School,281021,057281021,210303001641,CKEC,901,All Students,501,559,42,35,77,1,1,2,2,5,7,42,30,72,0,2,2,21,26,47,451,402,853,1060
20192020,057,JESSAMINE,281,Jessamine County,021,East Jessamine High School,281021,057281021,210303001641,CKEC,901,09,143,152,9,10,19,1,0,1,0,2,2,11,8,19,0,1,1,7,8,15,124,114,238,295
20192020,057,JESSAMINE,281,Jessamine County,021,East Jessamine High School,281021,057281021,210303001641,CKEC,901,10,125,143,12,9,21,0,1,1,1,0,1,16,11,27,0,0,0,3,5,8,111,99,210,268
20192020,057,JESSAMINE,281,Jessamine County,021,East Jessamine High School,281021,057281021,210303001641,CKEC,901,11,113,138,14,6,20,0,0,0,1,3,4,10,7,17,0,0,0,6,4,10,107,93,200,251
20192020,057,JESSAMINE,281,Jessamine County,021,East Jessamine High School,281021,057281021,210303001641,CKEC,901,14,1,3,0,0,0,0,0,0,0,0,0,0,0,0,0,0,0,0,0,0,3,1,4,4
20192020,057,JESSAMINE,281,Jessamine County,022,Jessamine Early Learning Village,281022,057281022,210303001899,CKEC,901,PS,125,223,16,10,26,0,0,0,3,0,3,16,12,28,0,0,0,14,13,27,174,90,264,348
20192020,057,JESSAMINE,281,Jessamine County,022,Jessamine Early Learning Village,281022,057281022,210303001899,CKEC,901,All Students,292,355,22,18,40,1,0,1,1,5,6,32,17,49,0,0,0,20,21,41,279,231,510,647
20192020,057,JESSAMINE,281,Jessamine County,022,Jessamine Early Learning Village,281022,057281022,210303001899,CKEC,901,KG,292,355,22,18,40,1,0,1,1,5,6,32,17,49,0,0,0,20,21,41,279,231,510,647
20192020,057,JESSAMINE,281,Jessamine County,023,The Providence School,281023,057281023,210303001900,CKEC,901,10,13,9,0,0,0,0,0,0,0,0,0,0,1,1,0,0,0,0,1,1,9,11,20,22
20192020,057,JESSAMINE,281,Jessamine County,023,The Providence School,281023,057281023,210303001900,CKEC,901,All Students,65,87,3,5,8,1,0,1,0,0,0,2,3,5,0,0,0,3,4,7,78,53,131,152
20192020,057,JESSAMINE,281,Jessamine County,023,The Providence School,281023,057281023,210303001900,CKEC,901,06,2,7,0,0,0,1,0,1,0,0,0,1,0,1,0,0,0,1,0,1,4,2,6,9
20192020,057,JESSAMINE,281,Jessamine County,023,The Providence School,281023,057281023,210303001900,CKEC,901,07,2,8,1,1,2,0,0,0,0,0,0,0,0,0,0,0,0,0,0,0,7,1,8,10
20192020,057,JESSAMINE,281,Jessamine County,023,The Providence School,281023,057281023,210303001900,CKEC,901,12,13,11,0,1,1,0,0,0,0,0,0,0,2,2,0,0,0,1,1,2,10,9,19,24
20192020,057,JESSAMINE,281,Jessamine County,023,The Providence School,281023,057281023,210303001900,CKEC,901,08,5,9,2,2,4,0,0,0,0,0,0,1,0,1,0,0,0,0,0,0,6,3,9,14
20192020,057,JESSAMINE,281,Jessamine County,023,The Providence School,281023,057281023,210303001900,CKEC,901,09,16,18,0,1,1,0,0,0,0,0,0,0,0,0,0,0,0,0,0,0,18,15,33,34
20192020,057,JESSAMINE,281,Jessamine County,023,The Providence School,281023,057281023,210303001900,CKEC,901,11,14,25,0,0,0,0,0,0,0,0,0,0,0,0,0,0,0,1,2,3,24,12,36,39
20192020,057,JESSAMINE,281,Jessamine County,024,Jessamine Career and Technology Center,281024,057281024,210303002028,CKEC,901,11,0,0,0,0,0,0,0,0,0,0,0,0,0,0,0,0,0,0,0,0,0,0,0,0
20192020,057,JESSAMINE,281,Jessamine County,024,Jessamine Career and Technology Center,281024,057281024,210303002028,CKEC,901,All Students,0,0,0,0,0,0,0,0,0,0,0,0,0,0,0,0,0,0,0,0,0,0,0,0
20192020,057,JESSAMINE,281,Jessamine County,024,Jessamine Career and Technology Center,281024,057281024,210303002028,CKEC,901,09,0,0,0,0,0,0,0,0,0,0,0,0,0,0,0,0,0,0,0,0,0,0,0,0
20192020,057,JESSAMINE,281,Jessamine County,024,Jessamine Career and Technology Center,281024,057281024,210303002028,CKEC,901,10,0,0,0,0,0,0,0,0,0,0,0,0,0,0,0,0,0,0,0,0,0,0,0,0
20192020,057,JESSAMINE,281,Jessamine County,024,Jessamine Career and Technology Center,281024,057281024,210303002028,CKEC,901,12,0,0,0,0,0,0,0,0,0,0,0,0,0,0,0,0,0,0,0,0,0,0,0,0
20192020,057,JESSAMINE,281,Jessamine County,025,East Jessamine Middle School,281025,057281025,210303000797,CKEC,901,08,146,163,14,7,21,1,0,1,1,3,4,14,9,23,0,0,0,6,6,12,127,121,248,309
20192020,057,JESSAMINE,281,Jessamine County,025,East Jessamine Middle School,281025,057281025,210303000797,CKEC,901,All Students,474,506,39,34,73,1,1,2,3,4,7,44,43,87,0,0,0,25,22,47,394,370,764,980
20192020,057,JESSAMINE,281,Jessamine County,025,East Jessamine Middle School,281025,057281025,210303000797,CKEC,901,06,158,178,15,13,28,0,1,1,2,0,2,12,18,30,0,0,0,10,4,14,139,122,261,336
20192020,057,JESSAMINE,281,Jessamine County,025,East Jessamine Middle School,281025,057281025,210303000797,CKEC,901,07,170,165,10,14,24,0,0,0,0,1,1,18,16,34,0,0,0,9,12,21,128,127,255,335
20192020,057,JESSAMINE,281,Jessamine County,026,West Jessamine Middle School,281026,057281026,210303001110,CKEC,901,07,169,171,9,13,22,2,1,3,3,1,4,14,13,27,1,0,1,6,6,12,136,135,271,340
20192020,057,JESSAMINE,281,Jessamine County,026,West Jessamine Middle School,281026,057281026,210303001110,CKEC,901,All Students,513,517,28,30,58,2,2,4,6,7,13,38,46,84,1,0,1,18,17,35,424,411,835,1030
20192020,057,JESSAMINE,281,Jessamine County,026,West Jessamine Middle School,281026,057281026,210303001110,CKEC,901,06,164,176,11,11,22,0,1,1,2,3,5,15,17,32,0,0,0,4,4,8,144,128,272,340
20192020,057,JESSAMINE,281,Jessamine County,026,West Jessamine Middle School,281026,057281026,210303001110,CKEC,901,08,180,170,8,6,14,0,0,0,1,3,4,9,16,25,0,0,0,8,7,15,144,148,292,350
20192020,057,JESSAMINE,281,Jessamine County,030,Ashgrove Academy,281030,057281030,210303002442,CKEC,901,11,2,0,0,0,0,0,0,0,0,0,0,0,0,0,0,0,0,0,0,0,0,2,2,2
20192020,057,JESSAMINE,281,Jessamine County,030,Ashgrove Academy,281030,057281030,210303002442,CKEC,901,All Students,10,7,1,3,4,0,0,0,0,0,0,0,1,1,0,0,0,0,0,0,6,6,12,17
20192020,057,JESSAMINE,281,Jessamine County,030,Ashgrove Academy,281030,057281030,210303002442,CKEC,901,07,1,1,0,1,1,0,0,0,0,0,0,0,0,0,0,0,0,0,0,0,1,0,1,2
20192020,057,JESSAMINE,281,Jessamine County,030,Ashgrove Academy,281030,057281030,210303002442,CKEC,901,08,1,0,0,0,0,0,0,0,0,0,0,0,0,0,0,0,0,0,0,0,0,1,1,1
20192020,057,JESSAMINE,281,Jessamine County,030,Ashgrove Academy,281030,057281030,210303002442,CKEC,901,09,1,2,0,1,1,0,0,0,0,0,0,0,0,0,0,0,0,0,0,0,2,0,2,3
20192020,057,JESSAMINE,281,Jessamine County,030,Ashgrove Academy,281030,057281030,210303002442,CKEC,901,10,1,2,1,0,1,0,0,0,0,0,0,0,0,0,0,0,0,0,0,0,1,1,2,3
20192020,057,JESSAMINE,281,Jessamine County,030,Ashgrove Academy,281030,057281030,210303002442,CKEC,901,12,4,2,0,1,1,0,0,0,0,0,0,0,1,1,0,0,0,0,0,0,2,2,4,6
20192020,057,JESSAMINE,281,Jessamine County,040,Red Oak Elementary School,281040,057281040,210303002388,CKEC,901,04,46,42,4,8,12,0,0,0,0,0,0,1,3,4,0,0,0,6,1,7,31,34,65,88
20192020,057,JESSAMINE,281,Jessamine County,040,Red Oak Elementary School,281040,057281040,210303002388,CKEC,901,All Students,277,269,19,21,40,0,1,1,1,3,4,13,24,37,0,0,0,16,14,30,220,214,434,546
20192020,057,JESSAMINE,281,Jessamine County,040,Red Oak Elementary School,281040,057281040,210303002388,CKEC,901,01,48,58,6,2,8,0,0,0,1,1,2,3,9,12,0,0,0,2,3,5,46,33,79,106
20192020,057,JESSAMINE,281,Jessamine County,040,Red Oak Elementary School,281040,057281040,210303002388,CKEC,901,02,46,56,1,4,5,0,0,0,0,0,0,2,2,4,0,0,0,6,4,10,47,36,83,102
20192020,057,JESSAMINE,281,Jessamine County,040,Red Oak Elementary School,281040,057281040,210303002388,CKEC,901,03,63,46,2,4,6,0,1,1,0,2,2,4,4,8,0,0,0,1,3,4,39,49,88,109
20192020,057,JESSAMINE,281,Jessamine County,040,Red Oak Elementary School,281040,057281040,210303002388,CKEC,901,05,74,67,6,3,9,0,0,0,0,0,0,3,6,9,0,0,0,1,3,4,57,62,119,141
20192020,057,JESSAMINE,281,Jessamine County,050,Nicholasville Elementary School,281050,057281050,210303000798,CKEC,901,04,33,43,1,4,5,0,0,0,0,0,0,1,2,3,0,0,0,2,3,5,39,24,63,76
20192020,057,JESSAMINE,281,Jessamine County,050,Nicholasville Elementary School,281050,057281050,210303000798,CKEC,901,All Students,187,233,15,14,29,1,1,2,0,0,0,21,11,32,0,0,0,13,12,25,183,149,332,420
20192020,057,JESSAMINE,281,Jessamine County,050,Nicholasville Elementary School,281050,057281050,210303000798,CKEC,901,01,44,49,2,2,4,0,0,0,0,0,0,5,1,6,0,0,0,3,4,7,39,37,76,93
20192020,057,JESSAMINE,281,Jessamine County,050,Nicholasville Elementary School,281050,057281050,210303000798,CKEC,901,02,34,44,3,3,6,0,0,0,0,0,0,3,2,5,0,0,0,2,1,3,36,28,64,78
20192020,057,JESSAMINE,281,Jessamine County,050,Nicholasville Elementary School,281050,057281050,210303000798,CKEC,901,03,50,42,2,2,4,1,1,2,0,0,0,6,2,8,0,0,0,4,2,6,29,43,72,92
20192020,057,JESSAMINE,281,Jessamine County,050,Nicholasville Elementary School,281050,057281050,210303000798,CKEC,901,05,26,55,7,3,10,0,0,0,0,0,0,6,4,10,0,0,0,2,2,4,40,17,57,81
20192020,057,JESSAMINE,281,Jessamine County,060,Rosenwald Dunbar Elementary School,281060,057281060,210303000092,CKEC,901,04,49,56,2,2,4,0,1,1,0,0,0,5,7,12,0,0,0,3,3,6,46,36,82,105
20192020,057,JESSAMINE,281,Jessamine County,060,Rosenwald Dunbar Elementary School,281060,057281060,210303000092,CKEC,901,All Students,261,305,17,16,33,0,2,2,0,3,3,25,24,49,1,0,1,15,10,25,247,206,453,566
20192020,057,JESSAMINE,281,Jessamine County,060,Rosenwald Dunbar Elementary School,281060,057281060,210303000092,CKEC,901,01,52,60,3,5,8,0,1,1,0,2,2,5,3,8,0,0,0,2,3,5,50,38,88,112
20192020,057,JESSAMINE,281,Jessamine County,060,Rosenwald Dunbar Elementary School,281060,057281060,210303000092,CKEC,901,02,57,56,4,2,6,0,0,0,0,0,0,5,8,13,0,0,0,6,1,7,41,46,87,113
20192020,057,JESSAMINE,281,Jessamine County,060,Rosenwald Dunbar Elementary School,281060,057281060,210303000092,CKEC,901,03,44,67,2,4,6,0,0,0,0,0,0,4,3,7,0,0,0,2,1,3,59,36,95,111
20192020,057,JESSAMINE,281,Jessamine County,060,Rosenwald Dunbar Elementary School,281060,057281060,210303000092,CKEC,901,05,59,66,6,3,9,0,0,0,0,1,1,6,3,9,1,0,1,2,2,4,51,50,101,125
20192020,057,JESSAMINE,281,Jessamine County,070,Brookside Elementary School,281070,057281070,210303001429,CKEC,901,04,59,51,2,3,5,0,0,0,0,1,1,3,8,11,0,0,0,4,8,12,42,39,81,110
20192020,057,JESSAMINE,281,Jessamine County,070,Brookside Elementary School,281070,057281070,210303001429,CKEC,901,All Students,286,248,24,20,44,0,0,0,0,4,4,27,28,55,0,0,0,21,25,46,176,209,385,534
20192020,057,JESSAMINE,281,Jessamine County,070,Brookside Elementary School,281070,057281070,210303001429,CKEC,901,01,53,51,6,4,10,0,0,0,0,2,2,7,2,9,0,0,0,4,7,11,34,38,72,104
20192020,057,JESSAMINE,281,Jessamine County,070,Brookside Elementary School,281070,057281070,210303001429,CKEC,901,02,53,43,3,4,7,0,0,0,0,0,0,8,6,14,0,0,0,5,3,8,27,40,67,96
20192020,057,JESSAMINE,281,Jessamine County,070,Brookside Elementary School,281070,057281070,210303001429,CKEC,901,03,57,46,5,4,9,0,0,0,0,1,1,3,8,11,0,0,0,4,3,7,34,41,75,103
20192020,057,JESSAMINE,281,Jessamine County,070,Brookside Elementary School,281070,057281070,210303001429,CKEC,901,05,64,57,8,5,13,0,0,0,0,0,0,6,4,10,0,0,0,4,4,8,39,51,90,121
20192020,057,JESSAMINE,281,Jessamine County,090,Wilmore Elementary School,281090,057281090,210303000799,CKEC,901,04,36,60,3,4,7,0,0,0,1,0,1,6,0,6,0,0,0,3,2,5,47,30,77,96
20192020,057,JESSAMINE,281,Jessamine County,090,Wilmore Elementary School,281090,057281090,210303000799,CKEC,901,All Students,241,267,10,10,20,0,0,0,5,10,15,17,11,28,0,0,0,7,4,11,228,206,434,508
20192020,057,JESSAMINE,281,Jessamine County,090,Wilmore Elementary School,281090,057281090,210303000799,CKEC,901,01,49,43,1,2,3,0,0,0,3,2,5,3,3,6,0,0,0,0,0,0,36,42,78,92
20192020,057,JESSAMINE,281,Jessamine County,090,Wilmore Elementary School,281090,057281090,210303000799,CKEC,901,02,55,45,2,3,5,0,0,0,0,4,4,3,3,6,0,0,0,0,1,1,40,44,84,100
20192020,057,JESSAMINE,281,Jessamine County,090,Wilmore Elementary School,281090,057281090,210303000799,CKEC,901,03,54,55,2,0,2,0,0,0,1,1,2,4,3,7,0,0,0,1,1,2,47,49,96,109
20192020,057,JESSAMINE,281,Jessamine County,090,Wilmore Elementary School,281090,057281090,210303000799,CKEC,901,05,47,64,2,1,3,0,0,0,0,3,3,1,2,3,0,0,0,3,0,3,58,41,99,111
20192020,058,JOHNSON,285,Johnson County,"",---District Total---,285,"","",KEDC,903,14,1,1,0,0,0,0,0,0,0,0,0,0,0,0,0,0,0,0,0,0,1,1,2,2
20192020,058,JOHNSON,285,Johnson County,"",---District Total---,285,"","",KEDC,903,All Students,1656,1763,2,7,9,2,1,3,9,3,12,20,13,33,0,1,1,15,23,38,1715,1608,3323,3419
20192020,058,JOHNSON,285,Johnson County,"",---District Total---,285,"","",KEDC,903,PS,60,58,0,0,0,0,0,0,0,0,0,2,0,2,0,0,0,1,2,3,55,58,113,118
20192020,058,JOHNSON,285,Johnson County,"",---District Total---,285,"","",KEDC,903,KG,100,110,0,0,0,1,0,1,0,0,0,1,1,2,0,0,0,1,4,5,107,95,202,210
20192020,058,JOHNSON,285,Johnson County,"",---District Total---,285,"","",KEDC,903,01,153,143,0,0,0,0,0,0,0,0,0,4,0,4,0,1,1,1,3,4,138,149,287,296
20192020,058,JOHNSON,285,Johnson County,"",---District Total---,285,"","",KEDC,903,02,130,134,0,0,0,0,0,0,0,0,0,2,3,5,0,0,0,1,1,2,131,126,257,264
20192020,058,JOHNSON,285,Johnson County,"",---District Total---,285,"","",KEDC,903,03,100,111,0,0,0,0,0,0,1,0,1,1,2,3,0,0,0,2,2,4,107,96,203,211
20192020,058,JOHNSON,285,Johnson County,"",---District Total---,285,"","",KEDC,903,04,122,131,0,0,0,0,0,0,0,0,0,2,1,3,0,0,0,2,2,4,127,119,246,253
20192020,058,JOHNSON,285,Johnson County,"",---District Total---,285,"","",KEDC,903,05,112,136,0,2,2,0,0,0,0,0,0,3,0,3,0,0,0,2,0,2,131,110,241,248
20192020,058,JOHNSON,285,Johnson County,"",---District Total---,285,"","",KEDC,903,06,132,131,2,0,2,0,0,0,2,1,3,1,2,3,0,0,0,1,3,4,125,126,251,263
20192020,058,JOHNSON,285,Johnson County,"",---District Total---,285,"","",KEDC,903,07,140,124,0,1,1,0,0,0,0,0,0,1,0,1,0,0,0,1,1,2,122,138,260,264
20192020,058,JOHNSON,285,Johnson County,"",---District Total---,285,"","",KEDC,903,08,147,124,0,2,2,0,0,0,2,1,3,0,0,0,0,0,0,1,2,3,121,142,263,271
20192020,058,JOHNSON,285,Johnson County,"",---District Total---,285,"","",KEDC,903,09,126,153,0,0,0,1,0,1,0,0,0,2,1,3,0,0,0,2,2,4,148,123,271,279
20192020,058,JOHNSON,285,Johnson County,"",---District Total---,285,"","",KEDC,903,10,131,152,0,1,1,0,1,1,1,0,1,1,0,1,0,0,0,0,1,1,150,128,278,283
20192020,058,JOHNSON,285,Johnson County,"",---District Total---,285,"","",KEDC,903,11,136,167,0,0,0,0,0,0,2,0,2,0,2,2,0,0,0,1,1,2,164,133,297,303
20192020,058,JOHNSON,285,Johnson County,"",---District Total---,285,"","",KEDC,903,12,126,146,0,1,1,0,0,0,1,1,2,2,1,3,0,0,0,0,1,1,143,122,265,272
20192020,058,JOHNSON,285,Johnson County,050,Johnson County Alternative School,285050,058285050,210306001615,KEDC,903,11,22,19,0,0,0,0,0,0,0,0,0,0,0,0,0,0,0,0,0,0,19,22,41,41
20192020,058,JOHNSON,285,Johnson County,050,Johnson County Alternative School,285050,058285050,210306001615,KEDC,903,All Students,59,55,0,0,0,0,0,0,0,0,0,1,1,2,0,0,0,0,0,0,54,58,112,114
20192020,058,JOHNSON,285,Johnson County,050,Johnson County Alternative School,285050,058285050,210306001615,KEDC,903,07,0,1,0,0,0,0,0,0,0,0,0,0,0,0,0,0,0,0,0,0,1,0,1,1
20192020,058,JOHNSON,285,Johnson County,050,Johnson County Alternative School,285050,058285050,210306001615,KEDC,903,09,6,6,0,0,0,0,0,0,0,0,0,0,0,0,0,0,0,0,0,0,6,6,12,12
20192020,058,JOHNSON,285,Johnson County,050,Johnson County Alternative School,285050,058285050,210306001615,KEDC,903,10,9,10,0,0,0,0,0,0,0,0,0,0,0,0,0,0,0,0,0,0,10,9,19,19
20192020,058,JOHNSON,285,Johnson County,050,Johnson County Alternative School,285050,058285050,210306001615,KEDC,903,12,22,19,0,0,0,0,0,0,0,0,0,1,1,2,0,0,0,0,0,0,18,21,39,41
20192020,058,JOHNSON,285,Johnson County,060,Johnson County Middle School,285060,058285060,210306000800,KEDC,903,All Students,287,247,0,3,3,0,0,0,2,1,3,1,0,1,0,0,0,2,3,5,242,280,522,534
20192020,058,JOHNSON,285,Johnson County,060,Johnson County Middle School,285060,058285060,210306000800,KEDC,903,07,140,123,0,1,1,0,0,0,0,0,0,1,0,1,0,0,0,1,1,2,121,138,259,263
20192020,058,JOHNSON,285,Johnson County,060,Johnson County Middle School,285060,058285060,210306000800,KEDC,903,08,147,124,0,2,2,0,0,0,2,1,3,0,0,0,0,0,0,1,2,3,121,142,263,271
20192020,058,JOHNSON,285,Johnson County,075,Central Elementary School,285075,058285075,210306000692,KEDC,903,All Students,172,185,1,0,1,0,0,0,0,0,0,5,4,9,0,1,1,1,4,5,178,163,341,357
20192020,058,JOHNSON,285,Johnson County,075,Central Elementary School,285075,058285075,210306000692,KEDC,903,PS,15,21,0,0,0,0,0,0,0,0,0,0,0,0,0,0,0,0,0,0,21,15,36,36
20192020,058,JOHNSON,285,Johnson County,075,Central Elementary School,285075,058285075,210306000692,KEDC,903,KG,21,24,0,0,0,0,0,0,0,0,0,0,1,1,0,0,0,1,0,1,23,20,43,45
20192020,058,JOHNSON,285,Johnson County,075,Central Elementary School,285075,058285075,210306000692,KEDC,903,01,33,19,0,0,0,0,0,0,0,0,0,1,0,1,0,1,1,0,1,1,18,31,49,52
20192020,058,JOHNSON,285,Johnson County,075,Central Elementary School,285075,058285075,210306000692,KEDC,903,02,22,27,0,0,0,0,0,0,0,0,0,0,1,1,0,0,0,0,0,0,27,21,48,49
20192020,058,JOHNSON,285,Johnson County,075,Central Elementary School,285075,058285075,210306000692,KEDC,903,04,21,35,0,0,0,0,0,0,0,0,0,1,0,1,0,0,0,0,0,0,34,21,55,56
20192020,058,JOHNSON,285,Johnson County,075,Central Elementary School,285075,058285075,210306000692,KEDC,903,03,23,14,0,0,0,0,0,0,0,0,0,1,2,3,0,0,0,0,1,1,13,20,33,37
20192020,058,JOHNSON,285,Johnson County,075,Central Elementary School,285075,058285075,210306000692,KEDC,903,05,27,35,0,0,0,0,0,0,0,0,0,2,0,2,0,0,0,0,0,0,33,27,60,62
20192020,058,JOHNSON,285,Johnson County,075,Central Elementary School,285075,058285075,210306000692,KEDC,903,06,25,31,1,0,1,0,0,0,0,0,0,0,0,0,0,0,0,0,2,2,30,23,53,56
20192020,058,JOHNSON,285,Johnson County,100,Flat Gap Elementary School,285100,058285100,210306000801,KEDC,903,02,15,16,0,0,0,0,0,0,0,0,0,0,0,0,0,0,0,0,0,0,16,15,31,31
20192020,058,JOHNSON,285,Johnson County,100,Flat Gap Elementary School,285100,058285100,210306000801,KEDC,903,05,12,18,0,0,0,0,0,0,0,0,0,0,0,0,0,0,0,0,0,0,18,12,30,30
20192020,058,JOHNSON,285,Johnson County,100,Flat Gap Elementary School,285100,058285100,210306000801,KEDC,903,03,14,10,0,0,0,0,0,0,0,0,0,0,0,0,0,0,0,0,0,0,10,14,24,24
20192020,058,JOHNSON,285,Johnson County,100,Flat Gap Elementary School,285100,058285100,210306000801,KEDC,903,All Students,102,114,0,0,0,0,0,0,0,0,0,1,1,2,0,0,0,0,1,1,113,100,213,216
20192020,058,JOHNSON,285,Johnson County,100,Flat Gap Elementary School,285100,058285100,210306000801,KEDC,903,PS,11,8,0,0,0,0,0,0,0,0,0,0,0,0,0,0,0,1,0,1,7,11,18,19
20192020,058,JOHNSON,285,Johnson County,100,Flat Gap Elementary School,285100,058285100,210306000801,KEDC,903,06,23,19,0,0,0,0,0,0,0,0,0,0,1,1,0,0,0,0,0,0,19,22,41,42
20192020,058,JOHNSON,285,Johnson County,100,Flat Gap Elementary School,285100,058285100,210306000801,KEDC,903,04,12,11,0,0,0,0,0,0,0,0,0,0,0,0,0,0,0,0,0,0,11,12,23,23
20192020,058,JOHNSON,285,Johnson County,100,Flat Gap Elementary School,285100,058285100,210306000801,KEDC,903,KG,16,15,0,0,0,0,0,0,0,0,0,0,0,0,0,0,0,0,1,1,15,15,30,31
20192020,058,JOHNSON,285,Johnson County,100,Flat Gap Elementary School,285100,058285100,210306000801,KEDC,903,01,10,25,0,0,0,0,0,0,0,0,0,1,0,1,0,0,0,0,0,0,24,10,34,35
20192020,058,JOHNSON,285,Johnson County,115,Johnson Central High School,285115,058285115,210306000802,KEDC,903,10,122,142,0,1,1,0,1,1,1,0,1,1,0,1,0,0,0,0,1,1,140,119,259,264
20192020,058,JOHNSON,285,Johnson County,115,Johnson Central High School,285115,058285115,210306000802,KEDC,903,All Students,461,565,0,2,2,1,1,2,4,1,5,4,3,7,0,0,0,3,5,8,553,449,1002,1026
20192020,058,JOHNSON,285,Johnson County,115,Johnson Central High School,285115,058285115,210306000802,KEDC,903,09,120,147,0,0,0,1,0,1,0,0,0,2,1,3,0,0,0,2,2,4,142,117,259,267
20192020,058,JOHNSON,285,Johnson County,115,Johnson Central High School,285115,058285115,210306000802,KEDC,903,11,114,148,0,0,0,0,0,0,2,0,2,0,2,2,0,0,0,1,1,2,145,111,256,262
20192020,058,JOHNSON,285,Johnson County,115,Johnson Central High School,285115,058285115,210306000802,KEDC,903,12,104,127,0,1,1,0,0,0,1,1,2,1,0,1,0,0,0,0,1,1,125,101,226,231
20192020,058,JOHNSON,285,Johnson County,115,Johnson Central High School,285115,058285115,210306000802,KEDC,903,14,1,1,0,0,0,0,0,0,0,0,0,0,0,0,0,0,0,0,0,0,1,1,2,2
20192020,058,JOHNSON,285,Johnson County,250,Porter Elementary School,285250,058285250,210306000803,KEDC,903,06,30,27,1,0,1,0,0,0,2,0,2,0,0,0,0,0,0,0,0,0,24,30,54,57
20192020,058,JOHNSON,285,Johnson County,250,Porter Elementary School,285250,058285250,210306000803,KEDC,903,All Students,180,190,1,0,1,0,0,0,2,0,2,3,1,4,0,0,0,3,5,8,181,174,355,370
20192020,058,JOHNSON,285,Johnson County,250,Porter Elementary School,285250,058285250,210306000803,KEDC,903,PS,9,7,0,0,0,0,0,0,0,0,0,0,0,0,0,0,0,0,2,2,7,7,14,16
20192020,058,JOHNSON,285,Johnson County,250,Porter Elementary School,285250,058285250,210306000803,KEDC,903,KG,21,24,0,0,0,0,0,0,0,0,0,0,0,0,0,0,0,0,2,2,24,19,43,45
20192020,058,JOHNSON,285,Johnson County,250,Porter Elementary School,285250,058285250,210306000803,KEDC,903,01,38,36,0,0,0,0,0,0,0,0,0,1,0,1,0,0,0,0,1,1,35,37,72,74
20192020,058,JOHNSON,285,Johnson County,250,Porter Elementary School,285250,058285250,210306000803,KEDC,903,02,26,32,0,0,0,0,0,0,0,0,0,0,1,1,0,0,0,1,1,2,31,24,55,58
20192020,058,JOHNSON,285,Johnson County,250,Porter Elementary School,285250,058285250,210306000803,KEDC,903,03,17,25,0,0,0,0,0,0,0,0,0,0,0,0,0,0,0,0,0,0,25,17,42,42
20192020,058,JOHNSON,285,Johnson County,250,Porter Elementary School,285250,058285250,210306000803,KEDC,903,04,26,22,0,0,0,0,0,0,0,0,0,1,0,1,0,0,0,1,1,2,20,25,45,48
20192020,058,JOHNSON,285,Johnson County,250,Porter Elementary School,285250,058285250,210306000803,KEDC,903,05,22,24,0,0,0,0,0,0,0,0,0,1,0,1,0,0,0,1,0,1,22,22,44,46
20192020,058,JOHNSON,285,Johnson County,320,W R Castle Memorial Elementary School,285320,058285320,210306000805,KEDC,903,05,22,26,0,1,1,0,0,0,0,0,0,0,0,0,0,0,0,0,0,0,26,21,47,48
20192020,058,JOHNSON,285,Johnson County,320,W R Castle Memorial Elementary School,285320,058285320,210306000805,KEDC,903,All Students,182,181,0,1,1,1,0,1,0,1,1,3,2,5,0,0,0,3,2,5,174,176,350,363
20192020,058,JOHNSON,285,Johnson County,320,W R Castle Memorial Elementary School,285320,058285320,210306000805,KEDC,903,PS,9,9,0,0,0,0,0,0,0,0,0,1,0,1,0,0,0,0,0,0,8,9,17,18
20192020,058,JOHNSON,285,Johnson County,320,W R Castle Memorial Elementary School,285320,058285320,210306000805,KEDC,903,KG,14,21,0,0,0,1,0,1,0,0,0,1,0,1,0,0,0,0,0,0,19,14,33,35
20192020,058,JOHNSON,285,Johnson County,320,W R Castle Memorial Elementary School,285320,058285320,210306000805,KEDC,903,01,39,32,0,0,0,0,0,0,0,0,0,1,0,1,0,0,0,1,1,2,30,38,68,71
20192020,058,JOHNSON,285,Johnson County,320,W R Castle Memorial Elementary School,285320,058285320,210306000805,KEDC,903,02,39,25,0,0,0,0,0,0,0,0,0,1,1,2,0,0,0,0,0,0,24,38,62,64
20192020,058,JOHNSON,285,Johnson County,320,W R Castle Memorial Elementary School,285320,058285320,210306000805,KEDC,903,03,20,27,0,0,0,0,0,0,0,0,0,0,0,0,0,0,0,1,0,1,26,20,46,47
20192020,058,JOHNSON,285,Johnson County,320,W R Castle Memorial Elementary School,285320,058285320,210306000805,KEDC,903,04,25,28,0,0,0,0,0,0,0,0,0,0,0,0,0,0,0,1,0,1,27,25,52,53
20192020,058,JOHNSON,285,Johnson County,320,W R Castle Memorial Elementary School,285320,058285320,210306000805,KEDC,903,06,23,22,0,0,0,0,0,0,0,1,1,0,1,1,0,0,0,0,1,1,22,20,42,45
20192020,058,JOHNSON,285,Johnson County,340,Highland Elementary School,285340,058285340,210306000806,KEDC,903,05,29,33,0,1,1,0,0,0,0,0,0,0,0,0,0,0,0,1,0,1,32,28,60,62
20192020,058,JOHNSON,285,Johnson County,340,Highland Elementary School,285340,058285340,210306000806,KEDC,903,All Students,213,226,0,1,1,0,0,0,1,0,1,2,1,3,0,0,0,3,3,6,220,208,428,439
20192020,058,JOHNSON,285,Johnson County,340,Highland Elementary School,285340,058285340,210306000806,KEDC,903,PS,16,13,0,0,0,0,0,0,0,0,0,1,0,1,0,0,0,0,0,0,12,16,28,29
20192020,058,JOHNSON,285,Johnson County,340,Highland Elementary School,285340,058285340,210306000806,KEDC,903,KG,28,26,0,0,0,0,0,0,0,0,0,0,0,0,0,0,0,0,1,1,26,27,53,54
20192020,058,JOHNSON,285,Johnson County,340,Highland Elementary School,285340,058285340,210306000806,KEDC,903,01,33,31,0,0,0,0,0,0,0,0,0,0,0,0,0,0,0,0,0,0,31,33,64,64
20192020,058,JOHNSON,285,Johnson County,340,Highland Elementary School,285340,058285340,210306000806,KEDC,903,02,28,34,0,0,0,0,0,0,0,0,0,1,0,1,0,0,0,0,0,0,33,28,61,62
20192020,058,JOHNSON,285,Johnson County,340,Highland Elementary School,285340,058285340,210306000806,KEDC,903,03,26,35,0,0,0,0,0,0,1,0,1,0,0,0,0,0,0,1,1,2,33,25,58,61
20192020,058,JOHNSON,285,Johnson County,340,Highland Elementary School,285340,058285340,210306000806,KEDC,903,04,38,35,0,0,0,0,0,0,0,0,0,0,1,1,0,0,0,0,1,1,35,36,71,73
20192020,058,JOHNSON,285,Johnson County,340,Highland Elementary School,285340,058285340,210306000806,KEDC,903,06,31,32,0,0,0,0,0,0,0,0,0,1,0,1,0,0,0,1,0,1,30,31,61,63
20192020,059,KENTON,291,Kenton County,"",---District Total---,291,"","",NKCES,905,KG,502,588,13,8,21,0,0,0,18,8,26,38,41,79,0,1,1,35,23,58,484,421,905,1090
20192020,059,KENTON,291,Kenton County,"",---District Total---,291,"","",NKCES,905,All Students,6862,7163,192,194,386,2,7,9,102,113,215,397,405,802,9,17,26,365,385,750,6096,5741,11837,14025
20192020,059,KENTON,291,Kenton County,"",---District Total---,291,"","",NKCES,905,PS,131,249,9,4,13,0,1,1,8,4,12,13,14,27,0,0,0,12,6,18,207,102,309,380
20192020,059,KENTON,291,Kenton County,"",---District Total---,291,"","",NKCES,905,01,512,573,16,20,36,0,0,0,8,8,16,33,38,71,1,1,2,40,33,73,475,412,887,1085
20192020,059,KENTON,291,Kenton County,"",---District Total---,291,"","",NKCES,905,02,421,481,15,8,23,0,0,0,8,12,20,25,24,49,1,1,2,31,33,64,401,343,744,902
20192020,059,KENTON,291,Kenton County,"",---District Total---,291,"","",NKCES,905,03,532,543,16,17,33,0,0,0,9,11,20,28,33,61,0,3,3,34,33,67,456,435,891,1075
20192020,059,KENTON,291,Kenton County,"",---District Total---,291,"","",NKCES,905,04,500,618,21,13,34,0,0,0,10,8,18,33,36,69,1,2,3,22,31,53,531,410,941,1118
20192020,059,KENTON,291,Kenton County,"",---District Total---,291,"","",NKCES,905,05,594,549,15,16,31,0,1,1,3,10,13,41,29,70,0,4,4,30,39,69,460,495,955,1143
20192020,059,KENTON,291,Kenton County,"",---District Total---,291,"","",NKCES,905,06,551,555,18,14,32,1,1,2,10,7,17,26,38,64,0,2,2,28,29,57,472,460,932,1106
20192020,059,KENTON,291,Kenton County,"",---District Total---,291,"","",NKCES,905,07,570,569,16,16,32,0,0,0,9,3,12,35,38,73,1,0,1,37,43,80,471,470,941,1139
20192020,059,KENTON,291,Kenton County,"",---District Total---,291,"","",NKCES,905,08,545,521,13,19,32,0,1,1,5,6,11,32,30,62,1,3,4,22,26,48,448,460,908,1066
20192020,059,KENTON,291,Kenton County,"",---District Total---,291,"","",NKCES,905,09,579,575,19,21,40,1,0,1,4,10,14,26,30,56,1,0,1,33,18,51,491,500,991,1154
20192020,059,KENTON,291,Kenton County,"",---District Total---,291,"","",NKCES,905,10,543,566,14,17,31,0,1,1,5,9,14,29,26,55,0,0,0,20,28,48,498,462,960,1109
20192020,059,KENTON,291,Kenton County,"",---District Total---,291,"","",NKCES,905,11,502,489,4,13,17,0,1,1,6,9,15,27,26,53,1,0,1,17,28,45,434,425,859,991
20192020,059,KENTON,291,Kenton County,"",---District Total---,291,"","",NKCES,905,12,505,533,12,12,24,0,2,2,7,12,19,24,16,40,2,0,2,16,21,37,472,442,914,1038
20192020,059,KENTON,291,Kenton County,"",---District Total---,291,"","",NKCES,905,14,6,3,0,0,0,0,0,0,0,0,0,0,0,0,0,0,0,0,0,0,3,6,9,9
20192020,059,KENTON,291,Kenton County,005,Beechgrove Elementary School,291005,059291005,210309000807,NKCES,905,05,67,62,0,1,1,0,0,0,0,0,0,7,2,9,0,0,0,2,1,3,53,63,116,129
20192020,059,KENTON,291,Kenton County,005,Beechgrove Elementary School,291005,059291005,210309000807,NKCES,905,All Students,310,374,21,13,34,0,0,0,2,2,4,26,19,45,0,0,0,28,16,44,297,260,557,684
20192020,059,KENTON,291,Kenton County,005,Beechgrove Elementary School,291005,059291005,210309000807,NKCES,905,PS,11,16,1,0,1,0,0,0,0,0,0,2,3,5,0,0,0,2,0,2,11,8,19,27
20192020,059,KENTON,291,Kenton County,005,Beechgrove Elementary School,291005,059291005,210309000807,NKCES,905,KG,55,71,3,1,4,0,0,0,1,1,2,7,7,14,0,0,0,6,2,8,54,44,98,126
20192020,059,KENTON,291,Kenton County,005,Beechgrove Elementary School,291005,059291005,210309000807,NKCES,905,01,40,67,5,4,9,0,0,0,0,0,0,5,2,7,0,0,0,6,2,8,51,32,83,107
20192020,059,KENTON,291,Kenton County,005,Beechgrove Elementary School,291005,059291005,210309000807,NKCES,905,02,40,57,3,2,5,0,0,0,0,0,0,3,4,7,0,0,0,7,5,12,44,29,73,97
20192020,059,KENTON,291,Kenton County,005,Beechgrove Elementary School,291005,059291005,210309000807,NKCES,905,03,55,54,6,1,7,0,0,0,1,0,1,1,1,2,0,0,0,4,3,7,42,50,92,109
20192020,059,KENTON,291,Kenton County,005,Beechgrove Elementary School,291005,059291005,210309000807,NKCES,905,04,53,63,4,4,8,0,0,0,0,1,1,3,3,6,0,0,0,3,3,6,53,42,95,116
20192020,059,KENTON,291,Kenton County,006,River Ridge Elementary School,291006,059291006,210309001512,NKCES,905,01,86,80,2,3,5,0,0,0,8,6,14,6,11,17,1,0,1,7,5,12,56,61,117,166
20192020,059,KENTON,291,Kenton County,006,River Ridge Elementary School,291006,059291006,210309001512,NKCES,905,All Students,426,464,16,14,30,0,0,0,43,43,86,36,46,82,3,4,7,33,28,61,333,291,624,890
20192020,059,KENTON,291,Kenton County,006,River Ridge Elementary School,291006,059291006,210309001512,NKCES,905,PS,20,50,5,1,6,0,1,1,8,4,12,3,2,5,0,0,0,1,0,1,33,12,45,70
20192020,059,KENTON,291,Kenton County,006,River Ridge Elementary School,291006,059291006,210309001512,NKCES,905,KG,73,89,4,1,5,0,0,0,12,5,17,6,10,16,0,0,0,5,2,7,62,55,117,162
20192020,059,KENTON,291,Kenton County,006,River Ridge Elementary School,291006,059291006,210309001512,NKCES,905,02,58,75,2,2,4,0,0,0,6,11,17,8,4,12,1,0,1,6,8,14,52,33,85,133
20192020,059,KENTON,291,Kenton County,006,River Ridge Elementary School,291006,059291006,210309001512,NKCES,905,03,60,65,2,3,5,0,0,0,6,7,13,3,6,9,0,2,2,3,4,7,51,38,89,125
20192020,059,KENTON,291,Kenton County,006,River Ridge Elementary School,291006,059291006,210309001512,NKCES,905,04,76,75,3,2,5,0,0,0,8,7,15,6,10,16,1,0,1,4,2,6,53,55,108,151
20192020,059,KENTON,291,Kenton County,006,River Ridge Elementary School,291006,059291006,210309001512,NKCES,905,05,73,80,3,3,6,0,0,0,3,7,10,7,5,12,0,2,2,8,7,15,59,49,108,153
20192020,059,KENTON,291,Kenton County,020,James A Caywood Elementary School,291020,059291020,210309000809,NKCES,905,04,45,52,2,0,2,0,0,0,1,0,1,8,8,16,0,1,1,1,3,4,40,33,73,97
20192020,059,KENTON,291,Kenton County,020,James A Caywood Elementary School,291020,059291020,210309000809,NKCES,905,All Students,275,276,7,2,9,0,0,0,1,2,3,51,44,95,0,3,3,23,29,52,194,195,389,551
20192020,059,KENTON,291,Kenton County,020,James A Caywood Elementary School,291020,059291020,210309000809,NKCES,905,PS,20,27,0,0,0,0,0,0,0,0,0,0,7,7,0,0,0,2,0,2,25,13,38,47
20192020,059,KENTON,291,Kenton County,020,James A Caywood Elementary School,291020,059291020,210309000809,NKCES,905,KG,39,41,0,0,0,0,0,0,0,1,1,9,10,19,0,0,0,4,1,5,28,27,55,80
20192020,059,KENTON,291,Kenton County,020,James A Caywood Elementary School,291020,059291020,210309000809,NKCES,905,05,61,49,1,0,1,0,0,0,0,0,0,9,8,17,0,0,0,5,4,9,34,49,83,110
20192020,059,KENTON,291,Kenton County,020,James A Caywood Elementary School,291020,059291020,210309000809,NKCES,905,01,51,56,1,0,1,0,0,0,0,0,0,13,6,19,0,1,1,4,8,12,38,36,74,107
20192020,059,KENTON,291,Kenton County,020,James A Caywood Elementary School,291020,059291020,210309000809,NKCES,905,02,31,40,3,0,3,0,0,0,0,0,0,5,2,7,0,0,0,4,5,9,28,24,52,71
20192020,059,KENTON,291,Kenton County,020,James A Caywood Elementary School,291020,059291020,210309000809,NKCES,905,03,48,38,0,2,2,0,0,0,0,1,1,7,10,17,0,1,1,5,8,13,26,26,52,86
20192020,059,KENTON,291,Kenton County,040,Dixie Heights High School,291040,059291040,210309000811,NKCES,905,11,182,164,2,8,10,0,1,1,3,7,10,16,17,33,0,0,0,6,11,17,137,138,275,346
20192020,059,KENTON,291,Kenton County,040,Dixie Heights High School,291040,059291040,210309000811,NKCES,905,14,3,1,0,0,0,0,0,0,0,0,0,0,0,0,0,0,0,0,0,0,1,3,4,4
20192020,059,KENTON,291,Kenton County,040,Dixie Heights High School,291040,059291040,210309000811,NKCES,905,All Students,741,723,16,34,50,1,4,5,16,27,43,54,52,106,0,0,0,32,38,70,604,586,1190,1464
20192020,059,KENTON,291,Kenton County,040,Dixie Heights High School,291040,059291040,210309000811,NKCES,905,09,206,183,7,12,19,1,0,1,3,5,8,12,14,26,0,0,0,13,8,21,147,167,314,389
20192020,059,KENTON,291,Kenton County,040,Dixie Heights High School,291040,059291040,210309000811,NKCES,905,10,186,186,4,9,13,0,1,1,3,6,9,17,14,31,0,0,0,7,12,19,155,144,299,372
20192020,059,KENTON,291,Kenton County,040,Dixie Heights High School,291040,059291040,210309000811,NKCES,905,12,164,189,3,5,8,0,2,2,7,9,16,9,7,16,0,0,0,6,7,13,164,134,298,353
20192020,059,KENTON,291,Kenton County,045,R C Hinsdale Elementary School,291045,059291045,210309000812,NKCES,905,03,49,58,1,0,1,0,0,0,1,1,2,2,3,5,0,0,0,1,1,2,53,44,97,107
20192020,059,KENTON,291,Kenton County,045,R C Hinsdale Elementary School,291045,059291045,210309000812,NKCES,905,05,49,52,2,5,7,0,0,0,0,1,1,0,1,1,0,1,1,1,0,1,49,41,90,101
20192020,059,KENTON,291,Kenton County,045,R C Hinsdale Elementary School,291045,059291045,210309000812,NKCES,905,All Students,267,317,4,7,11,0,0,0,3,3,6,8,8,16,0,1,1,11,10,21,291,238,529,584
20192020,059,KENTON,291,Kenton County,045,R C Hinsdale Elementary School,291045,059291045,210309000812,NKCES,905,KG,46,56,0,1,1,0,0,0,2,0,2,2,1,3,0,0,0,2,3,5,50,41,91,102
20192020,059,KENTON,291,Kenton County,045,R C Hinsdale Elementary School,291045,059291045,210309000812,NKCES,905,01,45,57,0,0,0,0,0,0,0,1,1,1,2,3,0,0,0,3,2,5,53,40,93,102
20192020,059,KENTON,291,Kenton County,045,R C Hinsdale Elementary School,291045,059291045,210309000812,NKCES,905,02,41,40,1,0,1,0,0,0,0,0,0,1,1,2,0,0,0,3,2,5,35,38,73,81
20192020,059,KENTON,291,Kenton County,045,R C Hinsdale Elementary School,291045,059291045,210309000812,NKCES,905,04,37,54,0,1,1,0,0,0,0,0,0,2,0,2,0,0,0,1,2,3,51,34,85,91
20192020,059,KENTON,291,Kenton County,050,Kenton Elementary School,291050,059291050,210309000813,NKCES,905,01,42,52,1,2,3,0,0,0,0,0,0,1,1,2,0,0,0,0,3,3,50,36,86,94
20192020,059,KENTON,291,Kenton County,050,Kenton Elementary School,291050,059291050,210309000813,NKCES,905,All Students,255,330,5,4,9,0,0,0,3,1,4,11,10,21,0,0,0,9,15,24,302,225,527,585
20192020,059,KENTON,291,Kenton County,050,Kenton Elementary School,291050,059291050,210309000813,NKCES,905,PS,14,23,1,0,1,0,0,0,0,0,0,1,0,1,0,0,0,3,1,4,18,13,31,37
20192020,059,KENTON,291,Kenton County,050,Kenton Elementary School,291050,059291050,210309000813,NKCES,905,KG,45,61,1,0,1,0,0,0,1,0,1,2,2,4,0,0,0,4,1,5,53,42,95,106
20192020,059,KENTON,291,Kenton County,050,Kenton Elementary School,291050,059291050,210309000813,NKCES,905,02,36,50,3,0,3,0,0,0,1,0,1,1,3,4,0,0,0,1,3,4,44,30,74,86
20192020,059,KENTON,291,Kenton County,050,Kenton Elementary School,291050,059291050,210309000813,NKCES,905,03,43,51,0,1,1,0,0,0,0,0,0,3,0,3,0,0,0,1,2,3,47,40,87,94
20192020,059,KENTON,291,Kenton County,050,Kenton Elementary School,291050,059291050,210309000813,NKCES,905,04,47,61,0,0,0,0,0,0,1,0,1,1,2,3,0,0,0,2,4,6,57,41,98,108
20192020,059,KENTON,291,Kenton County,050,Kenton Elementary School,291050,059291050,210309000813,NKCES,905,05,42,55,0,1,1,0,0,0,0,1,1,3,2,5,0,0,0,1,2,3,51,36,87,97
20192020,059,KENTON,291,Kenton County,055,Northern Ky Youth Dev Center,291055,059291055,210309000814,NKCES,905,08,0,1,0,0,0,0,0,0,0,0,0,0,0,0,0,0,0,0,0,0,1,0,1,1
20192020,059,KENTON,291,Kenton County,055,Northern Ky Youth Dev Center,291055,059291055,210309000814,NKCES,905,09,0,1,0,0,0,0,0,0,0,0,0,0,0,0,0,0,0,0,0,0,1,0,1,1
20192020,059,KENTON,291,Kenton County,055,Northern Ky Youth Dev Center,291055,059291055,210309000814,NKCES,905,10,0,2,1,0,1,0,0,0,0,0,0,0,0,0,0,0,0,0,0,0,1,0,1,2
20192020,059,KENTON,291,Kenton County,055,Northern Ky Youth Dev Center,291055,059291055,210309000814,NKCES,905,11,0,2,0,0,0,0,0,0,0,0,0,1,0,1,0,0,0,0,0,0,1,0,1,2
20192020,059,KENTON,291,Kenton County,055,Northern Ky Youth Dev Center,291055,059291055,210309000814,NKCES,905,12,0,4,1,0,1,0,0,0,0,0,0,0,0,0,0,0,0,0,0,0,3,0,3,4
20192020,059,KENTON,291,Kenton County,055,Northern Ky Youth Dev Center,291055,059291055,210309000814,NKCES,905,All Students,0,10,2,0,2,0,0,0,0,0,0,1,0,1,0,0,0,0,0,0,7,0,7,10
20192020,059,KENTON,291,Kenton County,060,Ft Wright Elementary School,291060,059291060,210309000815,NKCES,905,03,42,48,4,4,8,0,0,0,0,1,1,4,3,7,0,0,0,4,5,9,36,29,65,90
20192020,059,KENTON,291,Kenton County,060,Ft Wright Elementary School,291060,059291060,210309000815,NKCES,905,05,44,32,2,0,2,0,0,0,0,1,1,7,2,9,0,0,0,3,10,13,20,31,51,76
20192020,059,KENTON,291,Kenton County,060,Ft Wright Elementary School,291060,059291060,210309000815,NKCES,905,04,41,50,3,2,5,0,0,0,0,0,0,4,6,10,0,1,1,4,5,9,39,27,66,91
20192020,059,KENTON,291,Kenton County,060,Ft Wright Elementary School,291060,059291060,210309000815,NKCES,905,All Students,251,242,18,13,31,0,0,0,0,2,2,26,22,48,0,2,2,24,37,61,174,175,349,493
20192020,059,KENTON,291,Kenton County,060,Ft Wright Elementary School,291060,059291060,210309000815,NKCES,905,PS,17,22,2,2,4,0,0,0,0,0,0,2,2,4,0,0,0,1,3,4,17,10,27,39
20192020,059,KENTON,291,Kenton County,060,Ft Wright Elementary School,291060,059291060,210309000815,NKCES,905,KG,45,48,2,1,3,0,0,0,0,0,0,6,5,11,0,1,1,5,8,13,35,30,65,93
20192020,059,KENTON,291,Kenton County,060,Ft Wright Elementary School,291060,059291060,210309000815,NKCES,905,01,41,34,4,5,9,0,0,0,0,0,0,3,0,3,0,0,0,5,4,9,22,32,54,75
20192020,059,KENTON,291,Kenton County,060,Ft Wright Elementary School,291060,059291060,210309000815,NKCES,905,02,38,30,3,1,4,0,0,0,0,0,0,2,6,8,0,0,0,3,5,8,22,26,48,68
20192020,059,KENTON,291,Kenton County,070,Piner Elementary School,291070,059291070,210309000816,NKCES,905,04,26,25,0,0,0,0,0,0,0,0,0,0,0,0,0,0,0,0,0,0,25,26,51,51
20192020,059,KENTON,291,Kenton County,070,Piner Elementary School,291070,059291070,210309000816,NKCES,905,All Students,165,138,0,1,1,0,0,0,0,0,0,4,4,8,0,0,0,1,2,3,133,158,291,303
20192020,059,KENTON,291,Kenton County,070,Piner Elementary School,291070,059291070,210309000816,NKCES,905,PS,7,11,0,0,0,0,0,0,0,0,0,0,0,0,0,0,0,0,0,0,11,7,18,18
20192020,059,KENTON,291,Kenton County,070,Piner Elementary School,291070,059291070,210309000816,NKCES,905,KG,28,17,0,0,0,0,0,0,0,0,0,0,3,3,0,0,0,0,0,0,17,25,42,45
20192020,059,KENTON,291,Kenton County,070,Piner Elementary School,291070,059291070,210309000816,NKCES,905,01,26,22,0,0,0,0,0,0,0,0,0,0,0,0,0,0,0,0,0,0,22,26,48,48
20192020,059,KENTON,291,Kenton County,070,Piner Elementary School,291070,059291070,210309000816,NKCES,905,02,22,20,0,0,0,0,0,0,0,0,0,1,0,1,0,0,0,0,1,1,19,21,40,42
20192020,059,KENTON,291,Kenton County,070,Piner Elementary School,291070,059291070,210309000816,NKCES,905,03,32,26,0,1,1,0,0,0,0,0,0,2,1,3,0,0,0,1,0,1,23,30,53,58
20192020,059,KENTON,291,Kenton County,070,Piner Elementary School,291070,059291070,210309000816,NKCES,905,05,31,28,0,0,0,0,0,0,0,0,0,1,0,1,0,0,0,0,1,1,27,30,57,59
20192020,059,KENTON,291,Kenton County,080,Ryland Heights Elementary School,291080,059291080,210309000817,NKCES,905,04,41,46,0,1,1,0,0,0,0,0,0,1,0,1,0,0,0,2,1,3,43,39,82,87
20192020,059,KENTON,291,Kenton County,080,Ryland Heights Elementary School,291080,059291080,210309000817,NKCES,905,All Students,234,237,1,6,7,0,0,0,0,2,2,3,12,15,0,2,2,6,10,16,227,202,429,471
20192020,059,KENTON,291,Kenton County,080,Ryland Heights Elementary School,291080,059291080,210309000817,NKCES,905,PS,7,15,0,0,0,0,0,0,0,0,0,1,0,1,0,0,0,1,1,2,13,6,19,22
20192020,059,KENTON,291,Kenton County,080,Ryland Heights Elementary School,291080,059291080,210309000817,NKCES,905,KG,38,33,0,2,2,0,0,0,0,1,1,0,1,1,0,0,0,0,1,1,33,33,66,71
20192020,059,KENTON,291,Kenton County,080,Ryland Heights Elementary School,291080,059291080,210309000817,NKCES,905,01,39,41,0,2,2,0,0,0,0,0,0,0,5,5,0,0,0,2,3,5,39,29,68,80
20192020,059,KENTON,291,Kenton County,080,Ryland Heights Elementary School,291080,059291080,210309000817,NKCES,905,02,38,39,0,0,0,0,0,0,0,0,0,0,1,1,0,1,1,1,1,2,38,35,73,77
20192020,059,KENTON,291,Kenton County,080,Ryland Heights Elementary School,291080,059291080,210309000817,NKCES,905,03,42,45,0,1,1,0,0,0,0,1,1,0,4,4,0,0,0,1,1,2,44,35,79,87
20192020,059,KENTON,291,Kenton County,080,Ryland Heights Elementary School,291080,059291080,210309000817,NKCES,905,05,36,33,1,0,1,0,0,0,0,0,0,2,1,3,0,1,1,0,3,3,30,31,61,69
20192020,059,KENTON,291,Kenton County,090,Simon Kenton High School,291090,059291090,210309000818,NKCES,905,12,224,215,5,6,11,0,0,0,0,2,2,7,6,13,1,0,1,6,9,15,196,201,397,439
20192020,059,KENTON,291,Kenton County,090,Simon Kenton High School,291090,059291090,210309000818,NKCES,905,All Students,876,874,11,12,23,0,0,0,5,7,12,24,28,52,1,0,1,23,35,58,810,794,1604,1750
20192020,059,KENTON,291,Kenton County,090,Simon Kenton High School,291090,059291090,210309000818,NKCES,905,09,225,214,3,2,5,0,0,0,1,2,3,6,11,17,0,0,0,6,7,13,198,203,401,439
20192020,059,KENTON,291,Kenton County,090,Simon Kenton High School,291090,059291090,210309000818,NKCES,905,10,222,224,2,3,5,0,0,0,2,2,4,7,5,12,0,0,0,6,10,16,207,202,409,446
20192020,059,KENTON,291,Kenton County,090,Simon Kenton High School,291090,059291090,210309000818,NKCES,905,11,203,220,1,1,2,0,0,0,2,1,3,4,6,10,0,0,0,5,9,14,208,186,394,423
20192020,059,KENTON,291,Kenton County,090,Simon Kenton High School,291090,059291090,210309000818,NKCES,905,14,2,1,0,0,0,0,0,0,0,0,0,0,0,0,0,0,0,0,0,0,1,2,3,3
20192020,059,KENTON,291,Kenton County,100,Taylor Mill Elementary School,291100,059291100,210309000819,NKCES,905,01,42,30,0,1,1,0,0,0,0,0,0,0,4,4,0,0,0,4,4,8,26,33,59,72
20192020,059,KENTON,291,Kenton County,100,Taylor Mill Elementary School,291100,059291100,210309000819,NKCES,905,All Students,238,278,8,7,15,0,1,1,1,0,1,10,17,27,0,0,0,15,17,32,244,196,440,516
20192020,059,KENTON,291,Kenton County,100,Taylor Mill Elementary School,291100,059291100,210309000819,NKCES,905,PS,5,20,0,0,0,0,0,0,0,0,0,1,0,1,0,0,0,1,0,1,18,5,23,25
20192020,059,KENTON,291,Kenton County,100,Taylor Mill Elementary School,291100,059291100,210309000819,NKCES,905,KG,38,46,0,2,2,0,0,0,0,0,0,2,2,4,0,0,0,1,0,1,43,34,77,84
20192020,059,KENTON,291,Kenton County,100,Taylor Mill Elementary School,291100,059291100,210309000819,NKCES,905,02,30,44,0,1,1,0,0,0,0,0,0,0,0,0,0,0,0,1,2,3,43,27,70,74
20192020,059,KENTON,291,Kenton County,100,Taylor Mill Elementary School,291100,059291100,210309000819,NKCES,905,03,38,47,1,1,2,0,0,0,1,0,1,5,3,8,0,0,0,4,3,7,36,31,67,85
20192020,059,KENTON,291,Kenton County,100,Taylor Mill Elementary School,291100,059291100,210309000819,NKCES,905,04,39,67,5,0,5,0,0,0,0,0,0,3,3,6,0,0,0,3,5,8,56,31,87,106
20192020,059,KENTON,291,Kenton County,100,Taylor Mill Elementary School,291100,059291100,210309000819,NKCES,905,05,51,44,2,2,4,0,1,1,0,0,0,0,5,5,0,0,0,2,3,5,40,40,80,95
20192020,059,KENTON,291,Kenton County,103,Turkey Foot Middle School,291103,059291103,210309000820,NKCES,905,08,173,168,8,5,13,0,0,0,3,4,7,18,13,31,0,2,2,6,12,18,133,137,270,341
20192020,059,KENTON,291,Kenton County,103,Turkey Foot Middle School,291103,059291103,210309000820,NKCES,905,All Students,561,513,16,20,36,0,0,0,16,10,26,51,59,110,1,4,5,29,39,68,400,429,829,1074
20192020,059,KENTON,291,Kenton County,103,Turkey Foot Middle School,291103,059291103,210309000820,NKCES,905,06,188,173,7,6,13,0,0,0,5,4,9,16,22,38,0,2,2,10,9,19,135,145,280,361
20192020,059,KENTON,291,Kenton County,103,Turkey Foot Middle School,291103,059291103,210309000820,NKCES,905,07,200,172,1,9,10,0,0,0,8,2,10,17,24,41,1,0,1,13,18,31,132,147,279,372
20192020,059,KENTON,291,Kenton County,105,Twenhofel Middle School,291105,059291105,210309000821,NKCES,905,07,153,157,2,3,5,0,0,0,0,0,0,5,4,9,0,0,0,6,5,11,144,141,285,310
20192020,059,KENTON,291,Kenton County,105,Twenhofel Middle School,291105,059291105,210309000821,NKCES,905,All Students,440,419,6,6,12,0,1,1,2,3,5,11,12,23,0,0,0,14,17,31,386,401,787,859
20192020,059,KENTON,291,Kenton County,105,Twenhofel Middle School,291105,059291105,210309000821,NKCES,905,06,142,139,2,2,4,0,0,0,1,2,3,3,5,8,0,0,0,3,9,12,130,124,254,281
20192020,059,KENTON,291,Kenton County,105,Twenhofel Middle School,291105,059291105,210309000821,NKCES,905,08,145,123,2,1,3,0,1,1,1,1,2,3,3,6,0,0,0,5,3,8,112,136,248,268
20192020,059,KENTON,291,Kenton County,108,Woodland Middle School,291108,059291108,210309001588,NKCES,905,07,108,116,8,1,9,0,0,0,0,1,1,6,4,10,0,0,0,5,7,12,97,95,192,224
20192020,059,KENTON,291,Kenton County,108,Woodland Middle School,291108,059291108,210309001588,NKCES,905,All Students,323,349,17,10,27,1,0,1,3,3,6,17,15,32,1,0,1,20,18,38,290,277,567,672
20192020,059,KENTON,291,Kenton County,108,Woodland Middle School,291108,059291108,210309001588,NKCES,905,06,102,129,6,3,9,1,0,1,2,1,3,4,5,9,0,0,0,10,5,15,106,88,194,231
20192020,059,KENTON,291,Kenton County,108,Woodland Middle School,291108,059291108,210309001588,NKCES,905,08,113,104,3,6,9,0,0,0,1,1,2,7,6,13,1,0,1,5,6,11,87,94,181,217
20192020,059,KENTON,291,Kenton County,120,Scott High School,291120,059291120,210309000823,NKCES,905,12,117,125,3,1,4,0,0,0,0,1,1,8,3,11,1,0,1,4,5,9,109,107,216,242
20192020,059,KENTON,291,Kenton County,120,Scott High School,291120,059291120,210309000823,NKCES,905,All Students,518,560,20,17,37,0,0,0,1,6,7,27,18,45,3,0,3,31,22,53,478,455,933,1078
20192020,059,KENTON,291,Kenton County,120,Scott High School,291120,059291120,210309000823,NKCES,905,09,148,177,9,7,16,0,0,0,0,3,3,8,5,13,1,0,1,14,3,17,145,130,275,325
20192020,059,KENTON,291,Kenton County,120,Scott High School,291120,059291120,210309000823,NKCES,905,10,135,154,7,5,12,0,0,0,0,1,1,5,7,12,0,0,0,7,6,13,135,116,251,289
20192020,059,KENTON,291,Kenton County,120,Scott High School,291120,059291120,210309000823,NKCES,905,11,117,103,1,4,5,0,0,0,1,1,2,6,3,9,1,0,1,6,8,14,88,101,189,220
20192020,059,KENTON,291,Kenton County,120,Scott High School,291120,059291120,210309000823,NKCES,905,14,1,1,0,0,0,0,0,0,0,0,0,0,0,0,0,0,0,0,0,0,1,1,2,2
20192020,059,KENTON,291,Kenton County,475,Summit View Academy,291475,059291475,210309002420,NKCES,905,07,109,124,5,3,8,0,0,0,1,0,1,7,6,13,0,0,0,13,13,26,98,87,185,233
20192020,059,KENTON,291,Kenton County,475,Summit View Academy,291475,059291475,210309002420,NKCES,905,All Students,662,745,19,23,42,0,1,1,4,0,4,30,35,65,0,1,1,50,42,92,642,560,1202,1407
20192020,059,KENTON,291,Kenton County,475,Summit View Academy,291475,059291475,210309002420,NKCES,905,PS,16,39,0,0,0,0,0,0,0,0,0,3,0,3,0,0,0,1,0,1,35,16,51,55
20192020,059,KENTON,291,Kenton County,475,Summit View Academy,291475,059291475,210309002420,NKCES,905,KG,39,53,2,0,2,0,0,0,0,0,0,2,0,2,0,0,0,3,3,6,46,36,82,92
20192020,059,KENTON,291,Kenton County,475,Summit View Academy,291475,059291475,210309002420,NKCES,905,01,47,81,1,3,4,0,0,0,0,0,0,3,5,8,0,0,0,6,1,7,71,38,109,128
20192020,059,KENTON,291,Kenton County,475,Summit View Academy,291475,059291475,210309002420,NKCES,905,02,42,48,0,1,1,0,0,0,1,0,1,2,3,5,0,0,0,3,0,3,42,38,80,90
20192020,059,KENTON,291,Kenton County,475,Summit View Academy,291475,059291475,210309002420,NKCES,905,03,60,64,2,2,4,0,0,0,0,0,0,1,2,3,0,0,0,7,5,12,54,51,105,124
20192020,059,KENTON,291,Kenton County,475,Summit View Academy,291475,059291475,210309002420,NKCES,905,04,50,65,3,2,5,0,0,0,0,0,0,5,2,7,0,0,0,1,4,5,56,42,98,115
20192020,059,KENTON,291,Kenton County,475,Summit View Academy,291475,059291475,210309002420,NKCES,905,05,82,71,3,2,5,0,0,0,0,0,0,3,3,6,0,0,0,6,5,11,59,72,131,153
20192020,059,KENTON,291,Kenton County,475,Summit View Academy,291475,059291475,210309002420,NKCES,905,06,119,114,3,3,6,0,1,1,2,0,2,3,6,9,0,0,0,5,6,11,101,103,204,233
20192020,059,KENTON,291,Kenton County,475,Summit View Academy,291475,059291475,210309002420,NKCES,905,08,114,125,0,7,7,0,0,0,0,0,0,4,8,12,0,1,1,6,5,11,115,93,208,239
20192020,059,KENTON,291,Kenton County,495,White's Tower Elementary School,291495,059291495,210309000824,NKCES,905,02,45,38,0,1,1,0,0,0,0,1,1,2,0,2,0,0,0,2,1,3,34,42,76,83
20192020,059,KENTON,291,Kenton County,495,White's Tower Elementary School,291495,059291495,210309000824,NKCES,905,All Students,320,314,5,5,10,0,0,0,2,2,4,7,4,11,0,0,0,16,10,26,284,299,583,634
20192020,059,KENTON,291,Kenton County,495,White's Tower Elementary School,291495,059291495,210309000824,NKCES,905,PS,14,26,0,1,1,0,0,0,0,0,0,0,0,0,0,0,0,0,1,1,26,12,38,40
20192020,059,KENTON,291,Kenton County,495,White's Tower Elementary School,291495,059291495,210309000824,NKCES,905,KG,56,73,1,0,1,0,0,0,2,0,2,2,0,2,0,0,0,5,2,7,63,54,117,129
20192020,059,KENTON,291,Kenton County,495,White's Tower Elementary School,291495,059291495,210309000824,NKCES,905,04,45,60,1,1,2,0,0,0,0,0,0,0,2,2,0,0,0,1,2,3,58,40,98,105
20192020,059,KENTON,291,Kenton County,495,White's Tower Elementary School,291495,059291495,210309000824,NKCES,905,05,58,43,1,2,3,0,0,0,0,0,0,2,0,2,0,0,0,2,3,5,38,53,91,101
20192020,059,KENTON,291,Kenton County,495,White's Tower Elementary School,291495,059291495,210309000824,NKCES,905,01,53,53,2,0,2,0,0,0,0,1,1,1,2,3,0,0,0,3,1,4,47,49,96,106
20192020,059,KENTON,291,Kenton County,495,White's Tower Elementary School,291495,059291495,210309000824,NKCES,905,03,63,47,0,1,1,0,0,0,0,0,0,0,0,0,0,0,0,3,1,4,44,61,105,110
20192020,060,KNOTT,295,Knott County,"",---District Total---,295,"","",KVEC,904,12,57,66,3,1,4,0,0,0,0,0,0,2,0,2,0,0,0,0,0,0,61,56,117,123
20192020,060,KNOTT,295,Knott County,"",---District Total---,295,"","",KVEC,904,All Students,1047,1114,22,5,27,1,0,1,0,0,0,18,9,27,0,0,0,2,1,3,1071,1032,2103,2161
20192020,060,KNOTT,295,Knott County,"",---District Total---,295,"","",KVEC,904,PS,31,48,1,0,1,0,0,0,0,0,0,0,0,0,1,0,1,1,0,1,45,31,76,79
20192020,060,KNOTT,295,Knott County,"",---District Total---,295,"","",KVEC,904,KG,102,108,2,0,2,0,0,0,0,0,0,1,2,3,0,0,0,0,0,0,105,100,205,210
20192020,060,KNOTT,295,Knott County,"",---District Total---,295,"","",KVEC,904,01,79,95,0,0,0,0,0,0,0,0,0,0,0,0,0,0,0,0,0,0,95,79,174,174
20192020,060,KNOTT,295,Knott County,"",---District Total---,295,"","",KVEC,904,02,71,70,2,1,3,0,0,0,0,0,0,1,1,2,0,0,0,1,0,1,66,69,135,141
20192020,060,KNOTT,295,Knott County,"",---District Total---,295,"","",KVEC,904,03,73,89,0,0,0,1,0,1,0,0,0,1,0,1,0,0,0,0,0,0,87,73,160,162
20192020,060,KNOTT,295,Knott County,"",---District Total---,295,"","",KVEC,904,04,62,83,1,0,1,0,0,0,0,0,0,3,0,3,0,0,0,0,1,1,79,61,140,145
20192020,060,KNOTT,295,Knott County,"",---District Total---,295,"","",KVEC,904,05,79,89,0,1,1,0,0,0,0,0,0,3,1,4,0,0,0,1,0,1,85,77,162,168
20192020,060,KNOTT,295,Knott County,"",---District Total---,295,"","",KVEC,904,06,107,90,3,0,3,0,0,0,0,0,0,1,1,2,0,0,0,0,0,0,86,106,192,197
20192020,060,KNOTT,295,Knott County,"",---District Total---,295,"","",KVEC,904,07,95,80,2,0,2,0,0,0,0,0,0,1,0,1,0,0,0,0,0,0,77,95,172,175
20192020,060,KNOTT,295,Knott County,"",---District Total---,295,"","",KVEC,904,08,84,87,4,0,4,0,0,0,0,0,0,1,0,1,0,0,0,0,0,0,82,84,166,171
20192020,060,KNOTT,295,Knott County,"",---District Total---,295,"","",KVEC,904,09,78,88,2,0,2,0,0,0,0,0,0,1,1,2,0,0,0,0,0,0,85,77,162,166
20192020,060,KNOTT,295,Knott County,"",---District Total---,295,"","",KVEC,904,10,88,76,1,2,3,0,0,0,0,0,0,1,1,2,0,0,0,0,0,0,74,85,159,164
20192020,060,KNOTT,295,Knott County,"",---District Total---,295,"","",KVEC,904,11,71,91,2,0,2,0,0,0,0,0,0,2,2,4,0,0,0,0,0,0,87,69,156,162
20192020,060,KNOTT,295,Knott County,"",---District Total---,295,"","",KVEC,904,14,1,2,0,0,0,0,0,0,0,0,0,0,0,0,0,0,0,0,0,0,2,1,3,3
20192020,060,KNOTT,295,Knott County,035,Beaver Creek Elementary School,295035,060295035,210312000826,KVEC,904,08,12,11,0,0,0,0,0,0,0,0,0,0,0,0,0,0,0,0,0,0,11,12,23,23
20192020,060,KNOTT,295,Knott County,035,Beaver Creek Elementary School,295035,060295035,210312000826,KVEC,904,All Students,109,110,0,0,0,0,0,0,0,0,0,1,0,1,0,0,0,0,0,0,109,109,218,219
20192020,060,KNOTT,295,Knott County,035,Beaver Creek Elementary School,295035,060295035,210312000826,KVEC,904,PS,0,1,0,0,0,0,0,0,0,0,0,0,0,0,0,0,0,0,0,0,1,0,1,1
20192020,060,KNOTT,295,Knott County,035,Beaver Creek Elementary School,295035,060295035,210312000826,KVEC,904,KG,7,13,0,0,0,0,0,0,0,0,0,0,0,0,0,0,0,0,0,0,13,7,20,20
20192020,060,KNOTT,295,Knott County,035,Beaver Creek Elementary School,295035,060295035,210312000826,KVEC,904,01,8,18,0,0,0,0,0,0,0,0,0,0,0,0,0,0,0,0,0,0,18,8,26,26
20192020,060,KNOTT,295,Knott County,035,Beaver Creek Elementary School,295035,060295035,210312000826,KVEC,904,02,13,12,0,0,0,0,0,0,0,0,0,0,0,0,0,0,0,0,0,0,12,13,25,25
20192020,060,KNOTT,295,Knott County,035,Beaver Creek Elementary School,295035,060295035,210312000826,KVEC,904,03,5,14,0,0,0,0,0,0,0,0,0,0,0,0,0,0,0,0,0,0,14,5,19,19
20192020,060,KNOTT,295,Knott County,035,Beaver Creek Elementary School,295035,060295035,210312000826,KVEC,904,04,13,6,0,0,0,0,0,0,0,0,0,0,0,0,0,0,0,0,0,0,6,13,19,19
20192020,060,KNOTT,295,Knott County,035,Beaver Creek Elementary School,295035,060295035,210312000826,KVEC,904,05,18,13,0,0,0,0,0,0,0,0,0,0,0,0,0,0,0,0,0,0,13,18,31,31
20192020,060,KNOTT,295,Knott County,035,Beaver Creek Elementary School,295035,060295035,210312000826,KVEC,904,06,16,13,0,0,0,0,0,0,0,0,0,0,0,0,0,0,0,0,0,0,13,16,29,29
20192020,060,KNOTT,295,Knott County,035,Beaver Creek Elementary School,295035,060295035,210312000826,KVEC,904,07,17,10,0,0,0,0,0,0,0,0,0,1,0,1,0,0,0,0,0,0,9,17,26,27
20192020,060,KNOTT,295,Knott County,100,Carr Creek Elementary School,295100,060295100,210312000830,KVEC,904,07,11,21,1,0,1,0,0,0,0,0,0,0,0,0,0,0,0,0,0,0,20,11,31,32
20192020,060,KNOTT,295,Knott County,100,Carr Creek Elementary School,295100,060295100,210312000830,KVEC,904,All Students,166,199,6,1,7,1,0,1,0,0,0,1,2,3,0,0,0,1,0,1,190,163,353,365
20192020,060,KNOTT,295,Knott County,100,Carr Creek Elementary School,295100,060295100,210312000830,KVEC,904,KG,32,35,1,0,1,0,0,0,0,0,0,0,2,2,0,0,0,0,0,0,34,30,64,67
20192020,060,KNOTT,295,Knott County,100,Carr Creek Elementary School,295100,060295100,210312000830,KVEC,904,01,15,27,0,0,0,0,0,0,0,0,0,0,0,0,0,0,0,0,0,0,27,15,42,42
20192020,060,KNOTT,295,Knott County,100,Carr Creek Elementary School,295100,060295100,210312000830,KVEC,904,02,14,14,1,1,2,0,0,0,0,0,0,0,0,0,0,0,0,1,0,1,12,13,25,28
20192020,060,KNOTT,295,Knott County,100,Carr Creek Elementary School,295100,060295100,210312000830,KVEC,904,03,13,27,0,0,0,1,0,1,0,0,0,0,0,0,0,0,0,0,0,0,26,13,39,40
20192020,060,KNOTT,295,Knott County,100,Carr Creek Elementary School,295100,060295100,210312000830,KVEC,904,04,21,19,1,0,1,0,0,0,0,0,0,0,0,0,0,0,0,0,0,0,18,21,39,40
20192020,060,KNOTT,295,Knott County,100,Carr Creek Elementary School,295100,060295100,210312000830,KVEC,904,05,26,20,0,0,0,0,0,0,0,0,0,1,0,1,0,0,0,0,0,0,19,26,45,46
20192020,060,KNOTT,295,Knott County,100,Carr Creek Elementary School,295100,060295100,210312000830,KVEC,904,06,22,21,1,0,1,0,0,0,0,0,0,0,0,0,0,0,0,0,0,0,20,22,42,43
20192020,060,KNOTT,295,Knott County,100,Carr Creek Elementary School,295100,060295100,210312000830,KVEC,904,08,12,15,1,0,1,0,0,0,0,0,0,0,0,0,0,0,0,0,0,0,14,12,26,27
20192020,060,KNOTT,295,Knott County,150,Cordia School,295150,060295150,210312002233,KVEC,904,11,5,10,1,0,1,0,0,0,0,0,0,0,0,0,0,0,0,0,0,0,9,5,14,15
20192020,060,KNOTT,295,Knott County,150,Cordia School,295150,060295150,210312002233,KVEC,904,All Students,72,94,4,0,4,0,0,0,0,0,0,4,0,4,0,0,0,0,0,0,86,72,158,166
20192020,060,KNOTT,295,Knott County,150,Cordia School,295150,060295150,210312002233,KVEC,904,KG,4,9,0,0,0,0,0,0,0,0,0,0,0,0,0,0,0,0,0,0,9,4,13,13
20192020,060,KNOTT,295,Knott County,150,Cordia School,295150,060295150,210312002233,KVEC,904,01,5,6,0,0,0,0,0,0,0,0,0,0,0,0,0,0,0,0,0,0,6,5,11,11
20192020,060,KNOTT,295,Knott County,150,Cordia School,295150,060295150,210312002233,KVEC,904,02,3,5,0,0,0,0,0,0,0,0,0,0,0,0,0,0,0,0,0,0,5,3,8,8
20192020,060,KNOTT,295,Knott County,150,Cordia School,295150,060295150,210312002233,KVEC,904,03,7,4,0,0,0,0,0,0,0,0,0,0,0,0,0,0,0,0,0,0,4,7,11,11
20192020,060,KNOTT,295,Knott County,150,Cordia School,295150,060295150,210312002233,KVEC,904,04,2,6,0,0,0,0,0,0,0,0,0,0,0,0,0,0,0,0,0,0,6,2,8,8
20192020,060,KNOTT,295,Knott County,150,Cordia School,295150,060295150,210312002233,KVEC,904,05,5,6,0,0,0,0,0,0,0,0,0,2,0,2,0,0,0,0,0,0,4,5,9,11
20192020,060,KNOTT,295,Knott County,150,Cordia School,295150,060295150,210312002233,KVEC,904,06,2,10,0,0,0,0,0,0,0,0,0,0,0,0,0,0,0,0,0,0,10,2,12,12
20192020,060,KNOTT,295,Knott County,150,Cordia School,295150,060295150,210312002233,KVEC,904,07,10,2,0,0,0,0,0,0,0,0,0,0,0,0,0,0,0,0,0,0,2,10,12,12
20192020,060,KNOTT,295,Knott County,150,Cordia School,295150,060295150,210312002233,KVEC,904,08,11,9,0,0,0,0,0,0,0,0,0,0,0,0,0,0,0,0,0,0,9,11,20,20
20192020,060,KNOTT,295,Knott County,150,Cordia School,295150,060295150,210312002233,KVEC,904,09,9,10,0,0,0,0,0,0,0,0,0,0,0,0,0,0,0,0,0,0,10,9,19,19
20192020,060,KNOTT,295,Knott County,150,Cordia School,295150,060295150,210312002233,KVEC,904,10,7,6,0,0,0,0,0,0,0,0,0,0,0,0,0,0,0,0,0,0,6,7,13,13
20192020,060,KNOTT,295,Knott County,150,Cordia School,295150,060295150,210312002233,KVEC,904,12,2,11,3,0,3,0,0,0,0,0,0,2,0,2,0,0,0,0,0,0,6,2,8,13
20192020,060,KNOTT,295,Knott County,210,Emmalena Elementary School,295210,060295210,210312000834,KVEC,904,KG,19,12,0,0,0,0,0,0,0,0,0,1,0,1,0,0,0,0,0,0,11,19,30,31
20192020,060,KNOTT,295,Knott County,210,Emmalena Elementary School,295210,060295210,210312000834,KVEC,904,All Students,107,88,1,0,1,0,0,0,0,0,0,2,1,3,0,0,0,0,0,0,85,106,191,195
20192020,060,KNOTT,295,Knott County,210,Emmalena Elementary School,295210,060295210,210312000834,KVEC,904,PS,8,14,0,0,0,0,0,0,0,0,0,0,0,0,0,0,0,1,0,1,13,8,21,22
20192020,060,KNOTT,295,Knott County,210,Emmalena Elementary School,295210,060295210,210312000834,KVEC,904,01,11,11,0,0,0,0,0,0,0,0,0,0,0,0,0,0,0,0,0,0,11,11,22,22
20192020,060,KNOTT,295,Knott County,210,Emmalena Elementary School,295210,060295210,210312000834,KVEC,904,02,12,8,0,0,0,0,0,0,0,0,0,0,1,1,0,0,0,0,0,0,8,11,19,20
20192020,060,KNOTT,295,Knott County,210,Emmalena Elementary School,295210,060295210,210312000834,KVEC,904,03,19,6,0,0,0,0,0,0,0,0,0,0,0,0,0,0,0,0,0,0,6,19,25,25
20192020,060,KNOTT,295,Knott County,210,Emmalena Elementary School,295210,060295210,210312000834,KVEC,904,04,8,15,0,0,0,0,0,0,0,0,0,0,0,0,0,0,0,0,0,0,15,8,23,23
20192020,060,KNOTT,295,Knott County,210,Emmalena Elementary School,295210,060295210,210312000834,KVEC,904,05,5,8,0,0,0,0,0,0,0,0,0,0,0,0,0,0,0,0,0,0,8,5,13,13
20192020,060,KNOTT,295,Knott County,210,Emmalena Elementary School,295210,060295210,210312000834,KVEC,904,06,11,8,1,0,1,0,0,0,0,0,0,1,0,1,0,0,0,0,0,0,6,11,17,19
20192020,060,KNOTT,295,Knott County,210,Emmalena Elementary School,295210,060295210,210312000834,KVEC,904,07,13,15,0,0,0,0,0,0,0,0,0,0,0,0,0,0,0,0,0,0,15,13,28,28
20192020,060,KNOTT,295,Knott County,210,Emmalena Elementary School,295210,060295210,210312000834,KVEC,904,08,9,5,0,0,0,0,0,0,0,0,0,0,0,0,0,0,0,0,0,0,5,9,14,14
20192020,060,KNOTT,295,Knott County,230,Hindman Elementary School,295230,060295230,210312000835,KVEC,904,08,15,28,1,0,1,0,0,0,0,0,0,1,0,1,0,0,0,0,0,0,26,15,41,43
20192020,060,KNOTT,295,Knott County,230,Hindman Elementary School,295230,060295230,210312000835,KVEC,904,All Students,213,228,4,0,4,0,0,0,0,0,0,3,1,4,0,0,0,1,1,2,220,211,431,441
20192020,060,KNOTT,295,Knott County,230,Hindman Elementary School,295230,060295230,210312000835,KVEC,904,PS,16,25,1,0,1,0,0,0,0,0,0,0,0,0,1,0,1,0,0,0,23,16,39,41
20192020,060,KNOTT,295,Knott County,230,Hindman Elementary School,295230,060295230,210312000835,KVEC,904,KG,33,28,1,0,1,0,0,0,0,0,0,0,0,0,0,0,0,0,0,0,27,33,60,61
20192020,060,KNOTT,295,Knott County,230,Hindman Elementary School,295230,060295230,210312000835,KVEC,904,01,28,19,0,0,0,0,0,0,0,0,0,0,0,0,0,0,0,0,0,0,19,28,47,47
20192020,060,KNOTT,295,Knott County,230,Hindman Elementary School,295230,060295230,210312000835,KVEC,904,02,23,20,0,0,0,0,0,0,0,0,0,0,0,0,0,0,0,0,0,0,20,23,43,43
20192020,060,KNOTT,295,Knott County,230,Hindman Elementary School,295230,060295230,210312000835,KVEC,904,03,22,29,0,0,0,0,0,0,0,0,0,1,0,1,0,0,0,0,0,0,28,22,50,51
20192020,060,KNOTT,295,Knott County,230,Hindman Elementary School,295230,060295230,210312000835,KVEC,904,04,12,23,0,0,0,0,0,0,0,0,0,1,0,1,0,0,0,0,1,1,22,11,33,35
20192020,060,KNOTT,295,Knott County,230,Hindman Elementary School,295230,060295230,210312000835,KVEC,904,05,19,35,0,0,0,0,0,0,0,0,0,0,1,1,0,0,0,1,0,1,34,18,52,54
20192020,060,KNOTT,295,Knott County,230,Hindman Elementary School,295230,060295230,210312000835,KVEC,904,06,33,26,1,0,1,0,0,0,0,0,0,0,0,0,0,0,0,0,0,0,25,33,58,59
20192020,060,KNOTT,295,Knott County,230,Hindman Elementary School,295230,060295230,210312000835,KVEC,904,07,28,20,1,0,1,0,0,0,0,0,0,0,0,0,0,0,0,0,0,0,19,28,47,48
20192020,060,KNOTT,295,Knott County,255,Jones Fork Elementary School,295255,060295255,210312000836,KVEC,904,07,6,6,0,0,0,0,0,0,0,0,0,0,0,0,0,0,0,0,0,0,6,6,12,12
20192020,060,KNOTT,295,Knott County,255,Jones Fork Elementary School,295255,060295255,210312000836,KVEC,904,All Students,63,86,2,1,3,0,0,0,0,0,0,3,0,3,0,0,0,0,0,0,81,62,143,149
20192020,060,KNOTT,295,Knott County,255,Jones Fork Elementary School,295255,060295255,210312000836,KVEC,904,PS,7,8,0,0,0,0,0,0,0,0,0,0,0,0,0,0,0,0,0,0,8,7,15,15
20192020,060,KNOTT,295,Knott County,255,Jones Fork Elementary School,295255,060295255,210312000836,KVEC,904,KG,7,11,0,0,0,0,0,0,0,0,0,0,0,0,0,0,0,0,0,0,11,7,18,18
20192020,060,KNOTT,295,Knott County,255,Jones Fork Elementary School,295255,060295255,210312000836,KVEC,904,01,12,14,0,0,0,0,0,0,0,0,0,0,0,0,0,0,0,0,0,0,14,12,26,26
20192020,060,KNOTT,295,Knott County,255,Jones Fork Elementary School,295255,060295255,210312000836,KVEC,904,02,6,11,1,0,1,0,0,0,0,0,0,1,0,1,0,0,0,0,0,0,9,6,15,17
20192020,060,KNOTT,295,Knott County,255,Jones Fork Elementary School,295255,060295255,210312000836,KVEC,904,03,7,9,0,0,0,0,0,0,0,0,0,0,0,0,0,0,0,0,0,0,9,7,16,16
20192020,060,KNOTT,295,Knott County,255,Jones Fork Elementary School,295255,060295255,210312000836,KVEC,904,04,6,14,0,0,0,0,0,0,0,0,0,2,0,2,0,0,0,0,0,0,12,6,18,20
20192020,060,KNOTT,295,Knott County,255,Jones Fork Elementary School,295255,060295255,210312000836,KVEC,904,05,6,7,0,1,1,0,0,0,0,0,0,0,0,0,0,0,0,0,0,0,7,5,12,13
20192020,060,KNOTT,295,Knott County,255,Jones Fork Elementary School,295255,060295255,210312000836,KVEC,904,06,8,7,0,0,0,0,0,0,0,0,0,0,0,0,0,0,0,0,0,0,7,8,15,15
20192020,060,KNOTT,295,Knott County,255,Jones Fork Elementary School,295255,060295255,210312000836,KVEC,904,08,5,7,1,0,1,0,0,0,0,0,0,0,0,0,0,0,0,0,0,0,6,5,11,12
20192020,060,KNOTT,295,Knott County,265,Knott County Central High School,295265,060295265,210312000837,KVEC,904,11,66,81,1,0,1,0,0,0,0,0,0,2,2,4,0,0,0,0,0,0,78,64,142,147
20192020,060,KNOTT,295,Knott County,265,Knott County Central High School,295265,060295265,210312000837,KVEC,904,14,1,2,0,0,0,0,0,0,0,0,0,0,0,0,0,0,0,0,0,0,2,1,3,3
20192020,060,KNOTT,295,Knott County,265,Knott County Central High School,295265,060295265,210312000837,KVEC,904,All Students,317,309,5,3,8,0,0,0,0,0,0,4,5,9,0,0,0,0,0,0,300,309,609,626
20192020,060,KNOTT,295,Knott County,265,Knott County Central High School,295265,060295265,210312000837,KVEC,904,06,15,5,0,0,0,0,0,0,0,0,0,0,1,1,0,0,0,0,0,0,5,14,19,20
20192020,060,KNOTT,295,Knott County,265,Knott County Central High School,295265,060295265,210312000837,KVEC,904,07,10,6,0,0,0,0,0,0,0,0,0,0,0,0,0,0,0,0,0,0,6,10,16,16
20192020,060,KNOTT,295,Knott County,265,Knott County Central High School,295265,060295265,210312000837,KVEC,904,08,20,12,1,0,1,0,0,0,0,0,0,0,0,0,0,0,0,0,0,0,11,20,31,32
20192020,060,KNOTT,295,Knott County,265,Knott County Central High School,295265,060295265,210312000837,KVEC,904,09,69,78,2,0,2,0,0,0,0,0,0,1,1,2,0,0,0,0,0,0,75,68,143,147
20192020,060,KNOTT,295,Knott County,265,Knott County Central High School,295265,060295265,210312000837,KVEC,904,10,81,70,1,2,3,0,0,0,0,0,0,1,1,2,0,0,0,0,0,0,68,78,146,151
20192020,060,KNOTT,295,Knott County,265,Knott County Central High School,295265,060295265,210312000837,KVEC,904,12,55,55,0,1,1,0,0,0,0,0,0,0,0,0,0,0,0,0,0,0,55,54,109,110
20192020,061,KNOX,301,Knox County,"",---District Total---,301,"","",SESC,907,11,133,157,3,3,6,0,0,0,2,0,2,0,3,3,0,0,0,2,1,3,150,126,276,290
20192020,061,KNOX,301,Knox County,"",---District Total---,301,"","",SESC,907,All Students,1961,2094,26,25,51,2,2,4,5,5,10,22,21,43,1,0,1,15,29,44,2023,1879,3902,4055
20192020,061,KNOX,301,Knox County,"",---District Total---,301,"","",SESC,907,PS,94,117,0,1,1,0,0,0,1,1,2,1,0,1,0,0,0,2,1,3,113,91,204,211
20192020,061,KNOX,301,Knox County,"",---District Total---,301,"","",SESC,907,KG,160,182,1,3,4,0,0,0,1,0,1,1,2,3,0,0,0,4,4,8,175,151,326,342
20192020,061,KNOX,301,Knox County,"",---District Total---,301,"","",SESC,907,01,170,182,4,1,5,0,0,0,0,0,0,1,1,2,0,0,0,1,4,5,176,164,340,352
20192020,061,KNOX,301,Knox County,"",---District Total---,301,"","",SESC,907,02,138,151,2,1,3,0,0,0,1,0,1,4,0,4,0,0,0,1,1,2,143,136,279,289
20192020,061,KNOX,301,Knox County,"",---District Total---,301,"","",SESC,907,03,135,132,3,1,4,0,0,0,0,0,0,1,4,5,0,0,0,0,4,4,128,126,254,267
20192020,061,KNOX,301,Knox County,"",---District Total---,301,"","",SESC,907,04,147,180,2,1,3,0,0,0,1,2,3,3,1,4,0,0,0,3,3,6,171,140,311,327
20192020,061,KNOX,301,Knox County,"",---District Total---,301,"","",SESC,907,05,172,177,1,1,2,0,0,0,0,0,0,2,3,5,0,0,0,0,1,1,174,167,341,349
20192020,061,KNOX,301,Knox County,"",---District Total---,301,"","",SESC,907,06,155,175,2,1,3,1,0,1,0,0,0,2,1,3,0,0,0,1,2,3,169,151,320,330
20192020,061,KNOX,301,Knox County,"",---District Total---,301,"","",SESC,907,07,158,153,1,3,4,1,0,1,0,1,1,1,0,1,0,0,0,2,0,2,148,154,302,311
20192020,061,KNOX,301,Knox County,"",---District Total---,301,"","",SESC,907,08,141,153,0,1,1,0,1,1,0,0,0,5,1,6,0,0,0,0,2,2,148,136,284,294
20192020,061,KNOX,301,Knox County,"",---District Total---,301,"","",SESC,907,09,187,146,2,5,7,0,1,1,0,2,2,0,3,3,1,0,1,1,5,6,142,171,313,333
20192020,061,KNOX,301,Knox County,"",---District Total---,301,"","",SESC,907,10,127,159,1,2,3,0,0,0,0,0,0,0,0,0,0,0,0,0,2,2,158,123,281,286
20192020,061,KNOX,301,Knox County,"",---District Total---,301,"","",SESC,907,12,137,146,4,2,6,0,0,0,0,0,0,2,2,4,0,0,0,0,0,0,140,133,273,283
20192020,061,KNOX,301,Knox County,"",---District Total---,301,"","",SESC,907,14,1,1,0,0,0,0,0,0,0,0,0,0,0,0,0,0,0,0,0,0,1,1,2,2
20192020,061,KNOX,301,Knox County,022,Knox Appalachian School,301022,061301022,210315001997,SESC,907,12,0,0,0,0,0,0,0,0,0,0,0,0,0,0,0,0,0,0,0,0,0,0,0,0
20192020,061,KNOX,301,Knox County,022,Knox Appalachian School,301022,061301022,210315001997,SESC,907,All Students,0,0,0,0,0,0,0,0,0,0,0,0,0,0,0,0,0,0,0,0,0,0,0,0
20192020,061,KNOX,301,Knox County,022,Knox Appalachian School,301022,061301022,210315001997,SESC,907,05,0,0,0,0,0,0,0,0,0,0,0,0,0,0,0,0,0,0,0,0,0,0,0,0
20192020,061,KNOX,301,Knox County,022,Knox Appalachian School,301022,061301022,210315001997,SESC,907,06,0,0,0,0,0,0,0,0,0,0,0,0,0,0,0,0,0,0,0,0,0,0,0,0
20192020,061,KNOX,301,Knox County,022,Knox Appalachian School,301022,061301022,210315001997,SESC,907,07,0,0,0,0,0,0,0,0,0,0,0,0,0,0,0,0,0,0,0,0,0,0,0,0
20192020,061,KNOX,301,Knox County,022,Knox Appalachian School,301022,061301022,210315001997,SESC,907,08,0,0,0,0,0,0,0,0,0,0,0,0,0,0,0,0,0,0,0,0,0,0,0,0
20192020,061,KNOX,301,Knox County,022,Knox Appalachian School,301022,061301022,210315001997,SESC,907,09,0,0,0,0,0,0,0,0,0,0,0,0,0,0,0,0,0,0,0,0,0,0,0,0
20192020,061,KNOX,301,Knox County,022,Knox Appalachian School,301022,061301022,210315001997,SESC,907,10,0,0,0,0,0,0,0,0,0,0,0,0,0,0,0,0,0,0,0,0,0,0,0,0
20192020,061,KNOX,301,Knox County,022,Knox Appalachian School,301022,061301022,210315001997,SESC,907,11,0,0,0,0,0,0,0,0,0,0,0,0,0,0,0,0,0,0,0,0,0,0,0,0
20192020,061,KNOX,301,Knox County,023,Knox County Middle School,301023,061301023,210315002029,SESC,907,07,124,103,0,3,3,0,0,0,0,1,1,1,0,1,0,0,0,2,0,2,100,120,220,227
20192020,061,KNOX,301,Knox County,023,Knox County Middle School,301023,061301023,210315002029,SESC,907,All Students,222,203,0,4,4,0,1,1,0,1,1,2,1,3,0,0,0,2,1,3,199,214,413,425
20192020,061,KNOX,301,Knox County,023,Knox County Middle School,301023,061301023,210315002029,SESC,907,08,98,100,0,1,1,0,1,1,0,0,0,1,1,2,0,0,0,0,1,1,99,94,193,198
20192020,061,KNOX,301,Knox County,071,Central Elementary School,301071,061301071,210315002235,SESC,907,05,31,38,1,1,2,0,0,0,0,0,0,0,1,1,0,0,0,0,0,0,37,29,66,69
20192020,061,KNOX,301,Knox County,071,Central Elementary School,301071,061301071,210315002235,SESC,907,All Students,201,218,7,5,12,0,0,0,2,1,3,1,3,4,0,0,0,4,7,11,204,185,389,419
20192020,061,KNOX,301,Knox County,071,Central Elementary School,301071,061301071,210315002235,SESC,907,PS,12,13,0,1,1,0,0,0,0,0,0,0,0,0,0,0,0,1,0,1,12,11,23,25
20192020,061,KNOX,301,Knox County,071,Central Elementary School,301071,061301071,210315002235,SESC,907,KG,29,35,0,1,1,0,0,0,1,0,1,0,0,0,0,0,0,3,1,4,31,27,58,64
20192020,061,KNOX,301,Knox County,071,Central Elementary School,301071,061301071,210315002235,SESC,907,01,30,33,1,0,1,0,0,0,0,0,0,0,0,0,0,0,0,1,1,2,31,29,60,63
20192020,061,KNOX,301,Knox County,071,Central Elementary School,301071,061301071,210315002235,SESC,907,02,26,24,1,1,2,0,0,0,0,0,0,1,0,1,0,0,0,0,1,1,22,24,46,50
20192020,061,KNOX,301,Knox County,071,Central Elementary School,301071,061301071,210315002235,SESC,907,03,26,22,2,1,3,0,0,0,0,0,0,0,2,2,0,0,0,0,3,3,20,20,40,48
20192020,061,KNOX,301,Knox County,071,Central Elementary School,301071,061301071,210315002235,SESC,907,04,21,33,2,0,2,0,0,0,1,1,2,0,0,0,0,0,0,0,0,0,30,20,50,54
20192020,061,KNOX,301,Knox County,071,Central Elementary School,301071,061301071,210315002235,SESC,907,06,38,33,0,1,1,0,0,0,0,0,0,0,0,0,0,0,0,0,1,1,33,36,69,71
20192020,061,KNOX,301,Knox County,140,Knox County Day Treatment,301140,061301140,210315002357,SESC,907,11,1,0,0,0,0,0,0,0,0,0,0,0,0,0,0,0,0,0,0,0,0,1,1,1
20192020,061,KNOX,301,Knox County,140,Knox County Day Treatment,301140,061301140,210315002357,SESC,907,All Students,7,23,1,0,1,0,0,0,0,0,0,0,0,0,0,0,0,0,0,0,22,7,29,30
20192020,061,KNOX,301,Knox County,140,Knox County Day Treatment,301140,061301140,210315002357,SESC,907,07,0,8,0,0,0,0,0,0,0,0,0,0,0,0,0,0,0,0,0,0,8,0,8,8
20192020,061,KNOX,301,Knox County,140,Knox County Day Treatment,301140,061301140,210315002357,SESC,907,08,1,4,0,0,0,0,0,0,0,0,0,0,0,0,0,0,0,0,0,0,4,1,5,5
20192020,061,KNOX,301,Knox County,140,Knox County Day Treatment,301140,061301140,210315002357,SESC,907,09,3,7,1,0,1,0,0,0,0,0,0,0,0,0,0,0,0,0,0,0,6,3,9,10
20192020,061,KNOX,301,Knox County,140,Knox County Day Treatment,301140,061301140,210315002357,SESC,907,10,1,4,0,0,0,0,0,0,0,0,0,0,0,0,0,0,0,0,0,0,4,1,5,5
20192020,061,KNOX,301,Knox County,140,Knox County Day Treatment,301140,061301140,210315002357,SESC,907,12,1,0,0,0,0,0,0,0,0,0,0,0,0,0,0,0,0,0,0,0,0,1,1,1
20192020,061,KNOX,301,Knox County,150,Knox County Learning Academy,301150,061301150,210315000709,SESC,907,11,9,7,0,0,0,0,0,0,0,0,0,0,0,0,0,0,0,0,0,0,7,9,16,16
20192020,061,KNOX,301,Knox County,150,Knox County Learning Academy,301150,061301150,210315000709,SESC,907,All Students,32,41,0,1,1,0,0,0,0,0,0,0,0,0,0,0,0,0,0,0,41,31,72,73
20192020,061,KNOX,301,Knox County,150,Knox County Learning Academy,301150,061301150,210315000709,SESC,907,09,2,6,0,0,0,0,0,0,0,0,0,0,0,0,0,0,0,0,0,0,6,2,8,8
20192020,061,KNOX,301,Knox County,150,Knox County Learning Academy,301150,061301150,210315000709,SESC,907,10,4,13,0,0,0,0,0,0,0,0,0,0,0,0,0,0,0,0,0,0,13,4,17,17
20192020,061,KNOX,301,Knox County,150,Knox County Learning Academy,301150,061301150,210315000709,SESC,907,12,17,15,0,1,1,0,0,0,0,0,0,0,0,0,0,0,0,0,0,0,15,16,31,32
20192020,061,KNOX,301,Knox County,155,Knox Inspire Academy,301155,061301155,210315002449,SESC,907,11,5,2,0,0,0,0,0,0,0,0,0,0,0,0,0,0,0,0,0,0,2,5,7,7
20192020,061,KNOX,301,Knox County,155,Knox Inspire Academy,301155,061301155,210315002449,SESC,907,All Students,13,14,0,0,0,0,0,0,0,0,0,0,0,0,0,0,0,0,0,0,14,13,27,27
20192020,061,KNOX,301,Knox County,155,Knox Inspire Academy,301155,061301155,210315002449,SESC,907,07,1,0,0,0,0,0,0,0,0,0,0,0,0,0,0,0,0,0,0,0,0,1,1,1
20192020,061,KNOX,301,Knox County,155,Knox Inspire Academy,301155,061301155,210315002449,SESC,907,08,1,1,0,0,0,0,0,0,0,0,0,0,0,0,0,0,0,0,0,0,1,1,2,2
20192020,061,KNOX,301,Knox County,155,Knox Inspire Academy,301155,061301155,210315002449,SESC,907,09,4,1,0,0,0,0,0,0,0,0,0,0,0,0,0,0,0,0,0,0,1,4,5,5
20192020,061,KNOX,301,Knox County,155,Knox Inspire Academy,301155,061301155,210315002449,SESC,907,10,1,6,0,0,0,0,0,0,0,0,0,0,0,0,0,0,0,0,0,0,6,1,7,7
20192020,061,KNOX,301,Knox County,155,Knox Inspire Academy,301155,061301155,210315002449,SESC,907,12,1,4,0,0,0,0,0,0,0,0,0,0,0,0,0,0,0,0,0,0,4,1,5,5
20192020,061,KNOX,301,Knox County,170,Dewitt Elementary School,301170,061301170,210315000842,SESC,907,03,13,8,1,0,1,0,0,0,0,0,0,0,1,1,0,0,0,0,0,0,7,12,19,21
20192020,061,KNOX,301,Knox County,170,Dewitt Elementary School,301170,061301170,210315000842,SESC,907,All Students,58,78,4,0,4,0,0,0,0,0,0,1,1,2,0,0,0,0,0,0,73,57,130,136
20192020,061,KNOX,301,Knox County,170,Dewitt Elementary School,301170,061301170,210315000842,SESC,907,KG,8,14,0,0,0,0,0,0,0,0,0,0,0,0,0,0,0,0,0,0,14,8,22,22
20192020,061,KNOX,301,Knox County,170,Dewitt Elementary School,301170,061301170,210315000842,SESC,907,01,6,13,2,0,2,0,0,0,0,0,0,0,0,0,0,0,0,0,0,0,11,6,17,19
20192020,061,KNOX,301,Knox County,170,Dewitt Elementary School,301170,061301170,210315000842,SESC,907,02,3,14,0,0,0,0,0,0,0,0,0,0,0,0,0,0,0,0,0,0,14,3,17,17
20192020,061,KNOX,301,Knox County,170,Dewitt Elementary School,301170,061301170,210315000842,SESC,907,04,9,7,0,0,0,0,0,0,0,0,0,0,0,0,0,0,0,0,0,0,7,9,16,16
20192020,061,KNOX,301,Knox County,170,Dewitt Elementary School,301170,061301170,210315000842,SESC,907,05,13,12,0,0,0,0,0,0,0,0,0,0,0,0,0,0,0,0,0,0,12,13,25,25
20192020,061,KNOX,301,Knox County,170,Dewitt Elementary School,301170,061301170,210315000842,SESC,907,06,6,10,1,0,1,0,0,0,0,0,0,1,0,1,0,0,0,0,0,0,8,6,14,16
20192020,061,KNOX,301,Knox County,240,Flat Lick Elementary School,301240,061301240,210315000843,SESC,907,06,10,7,0,0,0,0,0,0,0,0,0,0,0,0,0,0,0,0,0,0,7,10,17,17
20192020,061,KNOX,301,Knox County,240,Flat Lick Elementary School,301240,061301240,210315000843,SESC,907,All Students,84,88,0,0,0,0,0,0,0,0,0,1,0,1,0,0,0,1,1,2,86,83,169,172
20192020,061,KNOX,301,Knox County,240,Flat Lick Elementary School,301240,061301240,210315000843,SESC,907,PS,9,10,0,0,0,0,0,0,0,0,0,0,0,0,0,0,0,0,1,1,10,8,18,19
20192020,061,KNOX,301,Knox County,240,Flat Lick Elementary School,301240,061301240,210315000843,SESC,907,KG,12,13,0,0,0,0,0,0,0,0,0,0,0,0,0,0,0,0,0,0,13,12,25,25
20192020,061,KNOX,301,Knox County,240,Flat Lick Elementary School,301240,061301240,210315000843,SESC,907,01,16,15,0,0,0,0,0,0,0,0,0,0,0,0,0,0,0,0,1,1,15,15,30,31
20192020,061,KNOX,301,Knox County,240,Flat Lick Elementary School,301240,061301240,210315000843,SESC,907,02,9,10,0,0,0,0,0,0,0,0,0,0,0,0,0,0,0,1,0,1,9,9,18,19
20192020,061,KNOX,301,Knox County,240,Flat Lick Elementary School,301240,061301240,210315000843,SESC,907,03,11,11,0,0,0,0,0,0,0,0,0,0,0,0,0,0,0,0,0,0,11,11,22,22
20192020,061,KNOX,301,Knox County,240,Flat Lick Elementary School,301240,061301240,210315000843,SESC,907,04,13,20,0,0,0,0,0,0,0,0,0,0,0,0,0,0,0,0,0,0,20,13,33,33
20192020,061,KNOX,301,Knox County,240,Flat Lick Elementary School,301240,061301240,210315000843,SESC,907,05,13,12,0,0,0,0,0,0,0,0,0,1,0,1,0,0,0,0,0,0,11,13,24,25
20192020,061,KNOX,301,Knox County,260,Girdler Elementary School,301260,061301260,210315000844,SESC,907,05,29,22,0,0,0,0,0,0,0,0,0,0,0,0,0,0,0,0,0,0,22,29,51,51
20192020,061,KNOX,301,Knox County,260,Girdler Elementary School,301260,061301260,210315000844,SESC,907,All Students,173,173,2,1,3,0,0,0,0,0,0,0,1,1,0,0,0,0,5,5,171,166,337,346
20192020,061,KNOX,301,Knox County,260,Girdler Elementary School,301260,061301260,210315000844,SESC,907,PS,16,15,0,0,0,0,0,0,1,0,1,0,0,0,0,0,0,0,0,0,14,16,30,31
20192020,061,KNOX,301,Knox County,260,Girdler Elementary School,301260,061301260,210315000844,SESC,907,KG,20,23,1,0,1,0,0,0,0,0,0,0,0,0,0,0,0,0,0,0,22,20,42,43
20192020,061,KNOX,301,Knox County,260,Girdler Elementary School,301260,061301260,210315000844,SESC,907,01,28,24,0,1,1,0,0,0,0,0,0,0,0,0,0,0,0,0,2,2,24,25,49,52
20192020,061,KNOX,301,Knox County,260,Girdler Elementary School,301260,061301260,210315000844,SESC,907,02,26,25,0,0,0,0,0,0,0,0,0,0,0,0,0,0,0,0,0,0,25,26,51,51
20192020,061,KNOX,301,Knox County,260,Girdler Elementary School,301260,061301260,210315000844,SESC,907,03,13,12,0,0,0,0,0,0,0,0,0,0,0,0,0,0,0,0,1,1,12,12,24,25
20192020,061,KNOX,301,Knox County,260,Girdler Elementary School,301260,061301260,210315000844,SESC,907,04,28,30,0,0,0,0,0,0,0,0,0,0,1,1,0,0,0,0,1,1,30,26,56,58
20192020,061,KNOX,301,Knox County,260,Girdler Elementary School,301260,061301260,210315000844,SESC,907,06,29,37,1,0,1,0,0,0,0,0,0,0,0,0,0,0,0,0,1,1,36,28,64,66
20192020,061,KNOX,301,Knox County,320,G R Hampton Elementary School,301320,061301320,210315000846,SESC,907,05,19,17,0,0,0,0,0,0,0,0,0,0,0,0,0,0,0,0,1,1,17,18,35,36
20192020,061,KNOX,301,Knox County,320,G R Hampton Elementary School,301320,061301320,210315000846,SESC,907,All Students,95,117,0,0,0,0,0,0,1,1,2,1,0,1,0,0,0,1,2,3,114,92,206,212
20192020,061,KNOX,301,Knox County,320,G R Hampton Elementary School,301320,061301320,210315000846,SESC,907,PS,13,20,0,0,0,0,0,0,0,0,0,0,0,0,0,0,0,1,0,1,19,13,32,33
20192020,061,KNOX,301,Knox County,320,G R Hampton Elementary School,301320,061301320,210315000846,SESC,907,KG,14,12,0,0,0,0,0,0,0,0,0,0,0,0,0,0,0,0,1,1,12,13,25,26
20192020,061,KNOX,301,Knox County,320,G R Hampton Elementary School,301320,061301320,210315000846,SESC,907,01,17,17,0,0,0,0,0,0,0,0,0,0,0,0,0,0,0,0,0,0,17,17,34,34
20192020,061,KNOX,301,Knox County,320,G R Hampton Elementary School,301320,061301320,210315000846,SESC,907,02,11,16,0,0,0,0,0,0,1,0,1,1,0,1,0,0,0,0,0,0,14,11,25,27
20192020,061,KNOX,301,Knox County,320,G R Hampton Elementary School,301320,061301320,210315000846,SESC,907,03,13,8,0,0,0,0,0,0,0,0,0,0,0,0,0,0,0,0,0,0,8,13,21,21
20192020,061,KNOX,301,Knox County,320,G R Hampton Elementary School,301320,061301320,210315000846,SESC,907,04,12,26,0,0,0,0,0,0,0,1,1,0,0,0,0,0,0,1,0,1,25,11,36,38
20192020,061,KNOX,301,Knox County,320,G R Hampton Elementary School,301320,061301320,210315000846,SESC,907,06,9,21,0,0,0,0,0,0,0,0,0,0,0,0,0,0,0,0,0,0,21,9,30,30
20192020,061,KNOX,301,Knox County,410,Knox Central High School,301410,061301410,210315000847,SESC,907,10,78,103,1,2,3,0,0,0,0,0,0,0,0,0,0,0,0,0,2,2,102,74,176,181
20192020,061,KNOX,301,Knox County,410,Knox Central High School,301410,061301410,210315000847,SESC,907,11,85,110,3,2,5,0,0,0,2,0,2,0,2,2,0,0,0,2,1,3,103,80,183,195
20192020,061,KNOX,301,Knox County,410,Knox Central High School,301410,061301410,210315000847,SESC,907,12,84,101,3,0,3,0,0,0,0,0,0,1,0,1,0,0,0,0,0,0,97,84,181,185
20192020,061,KNOX,301,Knox County,410,Knox Central High School,301410,061301410,210315000847,SESC,907,14,0,1,0,0,0,0,0,0,0,0,0,0,0,0,0,0,0,0,0,0,1,0,1,1
20192020,061,KNOX,301,Knox County,410,Knox Central High School,301410,061301410,210315000847,SESC,907,All Students,383,402,8,8,16,0,0,0,2,2,4,1,5,6,0,0,0,2,8,10,389,360,749,785
20192020,061,KNOX,301,Knox County,410,Knox Central High School,301410,061301410,210315000847,SESC,907,09,136,87,1,4,5,0,0,0,0,2,2,0,3,3,0,0,0,0,5,5,86,122,208,223
20192020,061,KNOX,301,Knox County,430,Jesse D Lay Elementary School,301430,061301430,210315000848,SESC,907,06,19,24,0,0,0,0,0,0,0,0,0,1,0,1,0,0,0,0,0,0,23,19,42,43
20192020,061,KNOX,301,Knox County,430,Jesse D Lay Elementary School,301430,061301430,210315000848,SESC,907,03,17,25,0,0,0,0,0,0,0,0,0,0,0,0,0,0,0,0,0,0,25,17,42,42
20192020,061,KNOX,301,Knox County,430,Jesse D Lay Elementary School,301430,061301430,210315000848,SESC,907,05,21,22,0,0,0,0,0,0,0,0,0,0,0,0,0,0,0,0,0,0,22,21,43,43
20192020,061,KNOX,301,Knox County,430,Jesse D Lay Elementary School,301430,061301430,210315000848,SESC,907,04,25,29,0,1,1,0,0,0,0,0,0,1,0,1,0,0,0,1,0,1,27,24,51,54
20192020,061,KNOX,301,Knox County,430,Jesse D Lay Elementary School,301430,061301430,210315000848,SESC,907,All Students,156,180,2,3,5,0,0,0,0,0,0,3,0,3,0,0,0,1,1,2,174,152,326,336
20192020,061,KNOX,301,Knox County,430,Jesse D Lay Elementary School,301430,061301430,210315000848,SESC,907,PS,18,24,0,0,0,0,0,0,0,0,0,0,0,0,0,0,0,0,0,0,24,18,42,42
20192020,061,KNOX,301,Knox County,430,Jesse D Lay Elementary School,301430,061301430,210315000848,SESC,907,KG,30,38,0,2,2,0,0,0,0,0,0,0,0,0,0,0,0,0,1,1,38,27,65,68
20192020,061,KNOX,301,Knox County,430,Jesse D Lay Elementary School,301430,061301430,210315000848,SESC,907,01,23,26,1,0,1,0,0,0,0,0,0,0,0,0,0,0,0,0,0,0,25,23,48,49
20192020,061,KNOX,301,Knox County,430,Jesse D Lay Elementary School,301430,061301430,210315000848,SESC,907,02,21,16,1,0,1,0,0,0,0,0,0,1,0,1,0,0,0,0,0,0,14,21,35,37
20192020,061,KNOX,301,Knox County,450,Lynn Camp Schools,301450,061301450,210315000850,SESC,907,07,33,42,1,0,1,1,0,1,0,0,0,0,0,0,0,0,0,0,0,0,40,33,73,75
20192020,061,KNOX,301,Knox County,450,Lynn Camp Schools,301450,061301450,210315000850,SESC,907,All Students,537,557,2,3,5,2,1,3,0,0,0,12,10,22,1,0,1,4,4,8,536,519,1055,1094
20192020,061,KNOX,301,Knox County,450,Lynn Camp Schools,301450,061301450,210315000850,SESC,907,PS,26,35,0,0,0,0,0,0,0,1,1,1,0,1,0,0,0,0,0,0,34,25,59,61
20192020,061,KNOX,301,Knox County,450,Lynn Camp Schools,301450,061301450,210315000850,SESC,907,KG,47,47,0,0,0,0,0,0,0,0,0,1,2,3,0,0,0,1,1,2,45,44,89,94
20192020,061,KNOX,301,Knox County,450,Lynn Camp Schools,301450,061301450,210315000850,SESC,907,01,50,54,0,0,0,0,0,0,0,0,0,1,1,2,0,0,0,0,0,0,53,49,102,104
20192020,061,KNOX,301,Knox County,450,Lynn Camp Schools,301450,061301450,210315000850,SESC,907,02,42,46,0,0,0,0,0,0,0,0,0,1,0,1,0,0,0,0,0,0,45,42,87,88
20192020,061,KNOX,301,Knox County,450,Lynn Camp Schools,301450,061301450,210315000850,SESC,907,03,42,46,0,0,0,0,0,0,0,0,0,1,1,2,0,0,0,0,0,0,45,41,86,88
20192020,061,KNOX,301,Knox County,450,Lynn Camp Schools,301450,061301450,210315000850,SESC,907,04,39,35,0,0,0,0,0,0,0,0,0,2,0,2,0,0,0,1,2,3,32,37,69,74
20192020,061,KNOX,301,Knox County,450,Lynn Camp Schools,301450,061301450,210315000850,SESC,907,05,46,54,0,0,0,0,0,0,0,0,0,1,2,3,0,0,0,0,0,0,53,44,97,100
20192020,061,KNOX,301,Knox County,450,Lynn Camp Schools,301450,061301450,210315000850,SESC,907,06,44,43,0,0,0,1,0,1,0,0,0,0,1,1,0,0,0,1,0,1,41,43,84,87
20192020,061,KNOX,301,Knox County,450,Lynn Camp Schools,301450,061301450,210315000850,SESC,907,08,41,48,0,0,0,0,0,0,0,0,0,4,0,4,0,0,0,0,1,1,44,40,84,89
20192020,061,KNOX,301,Knox County,450,Lynn Camp Schools,301450,061301450,210315000850,SESC,907,09,42,45,0,1,1,0,1,1,0,0,0,0,0,0,1,0,1,1,0,1,43,40,83,87
20192020,061,KNOX,301,Knox County,450,Lynn Camp Schools,301450,061301450,210315000850,SESC,907,10,43,33,0,0,0,0,0,0,0,0,0,0,0,0,0,0,0,0,0,0,33,43,76,76
20192020,061,KNOX,301,Knox County,450,Lynn Camp Schools,301450,061301450,210315000850,SESC,907,11,33,38,0,1,1,0,0,0,0,0,0,0,1,1,0,0,0,0,0,0,38,31,69,71
20192020,061,KNOX,301,Knox County,450,Lynn Camp Schools,301450,061301450,210315000850,SESC,907,12,34,26,1,1,2,0,0,0,0,0,0,1,2,3,0,0,0,0,0,0,24,31,55,60
20192020,061,KNOX,301,Knox County,450,Lynn Camp Schools,301450,061301450,210315000850,SESC,907,14,1,0,0,0,0,0,0,0,0,0,0,0,0,0,0,0,0,0,0,0,0,1,1,1
20192020,062,LARUE,305,LaRue County,"",---District Total---,305,"","",GRREC,902,14,1,1,0,0,0,0,0,0,0,0,0,0,0,0,0,0,0,0,0,0,1,1,2,2
20192020,062,LARUE,305,LaRue County,"",---District Total---,305,"","",GRREC,902,All Students,1118,1206,25,20,45,1,5,6,3,3,6,65,82,147,0,2,2,47,36,83,1065,970,2035,2324
20192020,062,LARUE,305,LaRue County,"",---District Total---,305,"","",GRREC,902,PS,30,40,0,0,0,1,0,1,0,0,0,2,2,4,0,0,0,3,3,6,34,25,59,70
20192020,062,LARUE,305,LaRue County,"",---District Total---,305,"","",GRREC,902,KG,83,87,2,0,2,0,0,0,1,0,1,3,2,5,0,0,0,3,2,5,78,79,157,170
20192020,062,LARUE,305,LaRue County,"",---District Total---,305,"","",GRREC,902,01,111,84,0,2,2,0,0,0,0,0,0,4,7,11,0,0,0,1,1,2,79,101,180,195
20192020,062,LARUE,305,LaRue County,"",---District Total---,305,"","",GRREC,902,02,81,81,0,2,2,0,0,0,0,1,1,3,8,11,0,0,0,5,4,9,73,66,139,162
20192020,062,LARUE,305,LaRue County,"",---District Total---,305,"","",GRREC,902,03,68,84,2,1,3,0,0,0,0,1,1,5,7,12,0,0,0,3,5,8,74,54,128,152
20192020,062,LARUE,305,LaRue County,"",---District Total---,305,"","",GRREC,902,04,68,93,0,1,1,0,0,0,0,0,0,5,4,9,0,0,0,4,3,7,84,60,144,161
20192020,062,LARUE,305,LaRue County,"",---District Total---,305,"","",GRREC,902,05,89,102,2,3,5,0,0,0,0,0,0,9,5,14,0,0,0,6,3,9,85,78,163,191
20192020,062,LARUE,305,LaRue County,"",---District Total---,305,"","",GRREC,902,06,90,89,2,1,3,1,0,1,0,0,0,5,8,13,0,0,0,3,1,4,78,80,158,179
20192020,062,LARUE,305,LaRue County,"",---District Total---,305,"","",GRREC,902,07,105,100,2,3,5,0,0,0,0,0,0,4,11,15,0,0,0,2,6,8,92,85,177,205
20192020,062,LARUE,305,LaRue County,"",---District Total---,305,"","",GRREC,902,08,101,99,4,0,4,0,2,2,0,0,0,4,8,12,0,0,0,4,2,6,87,89,176,200
20192020,062,LARUE,305,LaRue County,"",---District Total---,305,"","",GRREC,902,09,74,127,0,2,2,0,0,0,1,0,1,8,3,11,0,0,0,7,2,9,111,67,178,201
20192020,062,LARUE,305,LaRue County,"",---District Total---,305,"","",GRREC,902,10,89,86,3,1,4,0,3,3,1,1,2,8,5,13,0,1,1,3,3,6,71,75,146,175
20192020,062,LARUE,305,LaRue County,"",---District Total---,305,"","",GRREC,902,11,79,89,4,3,7,0,0,0,0,0,0,3,6,9,0,1,1,5,3,8,77,66,143,168
20192020,062,LARUE,305,LaRue County,"",---District Total---,305,"","",GRREC,902,12,79,84,4,1,5,0,0,0,0,0,0,4,8,12,0,0,0,1,1,2,75,69,144,163
20192020,062,LARUE,305,LaRue County,015,Abraham Lincoln Elementary School,305015,062305015,210318002044,GRREC,902,02,36,38,0,1,1,0,0,0,0,0,0,3,3,6,0,0,0,4,1,5,31,31,62,74
20192020,062,LARUE,305,LaRue County,015,Abraham Lincoln Elementary School,305015,062305015,210318002044,GRREC,902,All Students,218,254,1,1,2,0,0,0,1,0,1,10,13,23,0,0,0,10,7,17,232,197,429,472
20192020,062,LARUE,305,LaRue County,015,Abraham Lincoln Elementary School,305015,062305015,210318002044,GRREC,902,PS,15,20,0,0,0,0,0,0,0,0,0,1,1,2,0,0,0,2,2,4,17,12,29,35
20192020,062,LARUE,305,LaRue County,015,Abraham Lincoln Elementary School,305015,062305015,210318002044,GRREC,902,KG,35,38,0,0,0,0,0,0,1,0,1,1,0,1,0,0,0,0,1,1,36,34,70,73
20192020,062,LARUE,305,LaRue County,015,Abraham Lincoln Elementary School,305015,062305015,210318002044,GRREC,902,01,52,43,0,0,0,0,0,0,0,0,0,1,3,4,0,0,0,0,1,1,42,48,90,95
20192020,062,LARUE,305,LaRue County,015,Abraham Lincoln Elementary School,305015,062305015,210318002044,GRREC,902,03,28,31,1,0,1,0,0,0,0,0,0,2,5,7,0,0,0,2,1,3,26,22,48,59
20192020,062,LARUE,305,LaRue County,015,Abraham Lincoln Elementary School,305015,062305015,210318002044,GRREC,902,04,30,54,0,0,0,0,0,0,0,0,0,2,1,3,0,0,0,2,2,4,50,27,77,84
20192020,062,LARUE,305,LaRue County,015,Abraham Lincoln Elementary School,305015,062305015,210318002044,GRREC,902,05,37,50,0,0,0,0,0,0,0,0,0,1,1,2,0,0,0,2,1,3,47,35,82,87
20192020,062,LARUE,305,LaRue County,030,Hodgenville Elementary School,305030,062305030,210318000852,GRREC,902,05,52,47,1,3,4,0,0,0,0,0,0,8,4,12,0,0,0,3,2,5,35,43,78,99
20192020,062,LARUE,305,LaRue County,030,Hodgenville Elementary School,305030,062305030,210318000852,GRREC,902,All Students,282,272,4,8,12,0,0,0,0,2,2,19,20,39,0,0,0,11,11,22,238,241,479,554
20192020,062,LARUE,305,LaRue County,030,Hodgenville Elementary School,305030,062305030,210318000852,GRREC,902,PS,15,20,0,0,0,1,0,1,0,0,0,1,1,2,0,0,0,1,1,2,17,13,30,35
20192020,062,LARUE,305,LaRue County,030,Hodgenville Elementary School,305030,062305030,210318000852,GRREC,902,KG,48,49,2,0,2,0,0,0,0,0,0,2,2,4,0,0,0,3,1,4,42,45,87,97
20192020,062,LARUE,305,LaRue County,030,Hodgenville Elementary School,305030,062305030,210318000852,GRREC,902,01,59,41,0,2,2,0,0,0,0,0,0,3,4,7,0,0,0,1,0,1,37,53,90,100
20192020,062,LARUE,305,LaRue County,030,Hodgenville Elementary School,305030,062305030,210318000852,GRREC,902,02,45,43,0,1,1,0,0,0,0,1,1,0,5,5,0,0,0,1,3,4,42,35,77,88
20192020,062,LARUE,305,LaRue County,030,Hodgenville Elementary School,305030,062305030,210318000852,GRREC,902,03,40,53,1,1,2,0,0,0,0,1,1,3,2,5,0,0,0,1,4,5,48,32,80,93
20192020,062,LARUE,305,LaRue County,030,Hodgenville Elementary School,305030,062305030,210318000852,GRREC,902,04,38,39,0,1,1,0,0,0,0,0,0,3,3,6,0,0,0,2,1,3,34,33,67,77
20192020,062,LARUE,305,LaRue County,040,LaRue County High School,305040,062305040,210318000853,GRREC,902,12,79,82,4,1,5,0,0,0,0,0,0,4,8,12,0,0,0,1,1,2,73,69,142,161
20192020,062,LARUE,305,LaRue County,040,LaRue County High School,305040,062305040,210318000853,GRREC,902,All Students,322,370,10,7,17,0,3,3,2,1,3,22,22,44,0,2,2,15,9,24,321,278,599,692
20192020,062,LARUE,305,LaRue County,040,LaRue County High School,305040,062305040,210318000853,GRREC,902,09,74,123,0,2,2,0,0,0,1,0,1,8,3,11,0,0,0,7,2,9,107,67,174,197
20192020,062,LARUE,305,LaRue County,040,LaRue County High School,305040,062305040,210318000853,GRREC,902,10,89,78,2,1,3,0,3,3,1,1,2,7,5,12,0,1,1,2,3,5,66,75,141,167
20192020,062,LARUE,305,LaRue County,040,LaRue County High School,305040,062305040,210318000853,GRREC,902,11,79,86,4,3,7,0,0,0,0,0,0,3,6,9,0,1,1,5,3,8,74,66,140,165
20192020,062,LARUE,305,LaRue County,040,LaRue County High School,305040,062305040,210318000853,GRREC,902,14,1,1,0,0,0,0,0,0,0,0,0,0,0,0,0,0,0,0,0,0,1,1,2,2
20192020,062,LARUE,305,LaRue County,045,LaRue County Middle School,305045,062305045,210318000854,GRREC,902,06,90,86,2,1,3,1,0,1,0,0,0,5,8,13,0,0,0,3,1,4,75,80,155,176
20192020,062,LARUE,305,LaRue County,045,LaRue County Middle School,305045,062305045,210318000854,GRREC,902,All Students,296,269,4,4,8,1,2,3,0,0,0,13,27,40,0,0,0,9,9,18,242,254,496,565
20192020,062,LARUE,305,LaRue County,045,LaRue County Middle School,305045,062305045,210318000854,GRREC,902,08,101,89,1,0,1,0,2,2,0,0,0,4,8,12,0,0,0,4,2,6,80,89,169,190
20192020,062,LARUE,305,LaRue County,045,LaRue County Middle School,305045,062305045,210318000854,GRREC,902,05,0,1,0,0,0,0,0,0,0,0,0,0,0,0,0,0,0,0,0,0,1,0,1,1
20192020,062,LARUE,305,LaRue County,045,LaRue County Middle School,305045,062305045,210318000854,GRREC,902,07,105,93,1,3,4,0,0,0,0,0,0,4,11,15,0,0,0,2,6,8,86,85,171,198
20192020,062,LARUE,305,LaRue County,100,The Life Connection,305100,062305100,210318002216,GRREC,902,All Students,0,41,6,0,6,0,0,0,0,0,0,1,0,1,0,0,0,2,0,2,32,0,32,41
20192020,062,LARUE,305,LaRue County,100,The Life Connection,305100,062305100,210318002216,GRREC,902,05,0,4,1,0,1,0,0,0,0,0,0,0,0,0,0,0,0,1,0,1,2,0,2,4
20192020,062,LARUE,305,LaRue County,100,The Life Connection,305100,062305100,210318002216,GRREC,902,06,0,3,0,0,0,0,0,0,0,0,0,0,0,0,0,0,0,0,0,0,3,0,3,3
20192020,062,LARUE,305,LaRue County,100,The Life Connection,305100,062305100,210318002216,GRREC,902,07,0,7,1,0,1,0,0,0,0,0,0,0,0,0,0,0,0,0,0,0,6,0,6,7
20192020,062,LARUE,305,LaRue County,100,The Life Connection,305100,062305100,210318002216,GRREC,902,08,0,10,3,0,3,0,0,0,0,0,0,0,0,0,0,0,0,0,0,0,7,0,7,10
20192020,062,LARUE,305,LaRue County,100,The Life Connection,305100,062305100,210318002216,GRREC,902,09,0,4,0,0,0,0,0,0,0,0,0,0,0,0,0,0,0,0,0,0,4,0,4,4
20192020,062,LARUE,305,LaRue County,100,The Life Connection,305100,062305100,210318002216,GRREC,902,10,0,8,1,0,1,0,0,0,0,0,0,1,0,1,0,0,0,1,0,1,5,0,5,8
20192020,062,LARUE,305,LaRue County,100,The Life Connection,305100,062305100,210318002216,GRREC,902,11,0,3,0,0,0,0,0,0,0,0,0,0,0,0,0,0,0,0,0,0,3,0,3,3
20192020,062,LARUE,305,LaRue County,100,The Life Connection,305100,062305100,210318002216,GRREC,902,12,0,2,0,0,0,0,0,0,0,0,0,0,0,0,0,0,0,0,0,0,2,0,2,2
20192020,063,LAUREL,311,Laurel County,"",---District Total---,311,"","",SESC,907,All Students,4235,4644,52,29,81,7,4,11,42,34,76,113,95,208,7,6,13,51,62,113,4372,4005,8377,8879
20192020,063,LAUREL,311,Laurel County,"",---District Total---,311,"","",SESC,907,01,321,366,1,0,1,0,0,0,1,2,3,9,8,17,1,0,1,4,6,10,350,305,655,687
20192020,063,LAUREL,311,Laurel County,"",---District Total---,311,"","",SESC,907,02,319,340,2,1,3,0,0,0,5,3,8,11,8,19,0,0,0,5,4,9,317,303,620,659
20192020,063,LAUREL,311,Laurel County,"",---District Total---,311,"","",SESC,907,03,308,358,4,1,5,0,0,0,2,5,7,12,9,21,0,0,0,6,7,13,334,286,620,666
20192020,063,LAUREL,311,Laurel County,"",---District Total---,311,"","",SESC,907,04,309,352,1,2,3,0,0,0,3,2,5,9,7,16,0,0,0,8,3,11,331,295,626,661
20192020,063,LAUREL,311,Laurel County,"",---District Total---,311,"","",SESC,907,05,339,359,3,2,5,0,0,0,1,0,1,6,9,15,0,1,1,3,4,7,346,323,669,698
20192020,063,LAUREL,311,Laurel County,"",---District Total---,311,"","",SESC,907,06,343,374,3,2,5,1,0,1,5,3,8,7,8,15,1,0,1,2,5,7,355,325,680,717
20192020,063,LAUREL,311,Laurel County,"",---District Total---,311,"","",SESC,907,07,322,335,5,2,7,0,0,0,3,1,4,10,7,17,1,2,3,4,9,13,312,301,613,657
20192020,063,LAUREL,311,Laurel County,"",---District Total---,311,"","",SESC,907,08,334,360,4,0,4,1,1,2,4,1,5,8,7,15,0,0,0,2,2,4,341,323,664,694
20192020,063,LAUREL,311,Laurel County,"",---District Total---,311,"","",SESC,907,09,352,397,4,4,8,1,1,2,4,7,11,6,5,11,4,1,5,1,4,5,377,330,707,749
20192020,063,LAUREL,311,Laurel County,"",---District Total---,311,"","",SESC,907,10,331,352,6,6,12,1,1,2,4,4,8,9,8,17,0,1,1,3,1,4,329,310,639,683
20192020,063,LAUREL,311,Laurel County,"",---District Total---,311,"","",SESC,907,11,320,333,5,3,8,0,1,1,3,2,5,5,3,8,0,1,1,5,3,8,315,307,622,653
20192020,063,LAUREL,311,Laurel County,"",---District Total---,311,"","",SESC,907,12,311,330,10,4,14,2,0,2,4,1,5,7,6,13,0,0,0,0,4,4,307,296,603,641
20192020,063,LAUREL,311,Laurel County,"",---District Total---,311,"","",SESC,907,14,2,7,0,0,0,0,0,0,0,0,0,0,0,0,0,0,0,0,0,0,7,2,9,9
20192020,063,LAUREL,311,Laurel County,"",---District Total---,311,"","",SESC,907,PS,177,169,1,0,1,0,0,0,2,1,3,4,6,10,0,0,0,2,3,5,160,167,327,346
20192020,063,LAUREL,311,Laurel County,"",---District Total---,311,"","",SESC,907,KG,324,381,4,2,6,1,0,1,3,3,6,14,10,24,0,0,0,8,10,18,351,299,650,705
20192020,063,LAUREL,311,Laurel County,010,London Elementary School,311010,063311010,210321000856,SESC,907,02,39,49,0,1,1,0,0,0,0,1,1,2,1,3,0,0,0,1,2,3,46,34,80,88
20192020,063,LAUREL,311,Laurel County,010,London Elementary School,311010,063311010,210321000856,SESC,907,03,44,45,0,0,0,0,0,0,0,0,0,4,2,6,0,0,0,1,1,2,40,41,81,89
20192020,063,LAUREL,311,Laurel County,010,London Elementary School,311010,063311010,210321000856,SESC,907,04,33,55,0,0,0,0,0,0,0,1,1,3,2,5,0,0,0,3,0,3,49,30,79,88
20192020,063,LAUREL,311,Laurel County,010,London Elementary School,311010,063311010,210321000856,SESC,907,05,46,45,0,1,1,0,0,0,1,0,1,1,2,3,0,1,1,1,1,2,42,41,83,91
20192020,063,LAUREL,311,Laurel County,010,London Elementary School,311010,063311010,210321000856,SESC,907,All Students,250,301,0,2,2,0,0,0,1,2,3,15,10,25,0,1,1,9,8,17,276,227,503,551
20192020,063,LAUREL,311,Laurel County,010,London Elementary School,311010,063311010,210321000856,SESC,907,PS,29,29,0,0,0,0,0,0,0,0,0,1,0,1,0,0,0,0,1,1,28,28,56,58
20192020,063,LAUREL,311,Laurel County,010,London Elementary School,311010,063311010,210321000856,SESC,907,KG,56,56,0,0,0,0,0,0,0,0,0,3,3,6,0,0,0,2,3,5,51,50,101,112
20192020,063,LAUREL,311,Laurel County,010,London Elementary School,311010,063311010,210321000856,SESC,907,01,32,51,0,0,0,0,0,0,0,0,0,2,0,2,0,0,0,1,1,2,48,31,79,83
20192020,063,LAUREL,311,Laurel County,016,McDaniel Learning Center,311016,063311016,210321002224,SESC,907,All Students,22,27,1,2,3,0,0,0,0,0,0,0,0,0,0,0,0,0,0,0,26,20,46,49
20192020,063,LAUREL,311,Laurel County,016,McDaniel Learning Center,311016,063311016,210321002224,SESC,907,09,1,3,0,0,0,0,0,0,0,0,0,0,0,0,0,0,0,0,0,0,3,1,4,4
20192020,063,LAUREL,311,Laurel County,016,McDaniel Learning Center,311016,063311016,210321002224,SESC,907,10,5,2,0,1,1,0,0,0,0,0,0,0,0,0,0,0,0,0,0,0,2,4,6,7
20192020,063,LAUREL,311,Laurel County,016,McDaniel Learning Center,311016,063311016,210321002224,SESC,907,11,11,9,0,0,0,0,0,0,0,0,0,0,0,0,0,0,0,0,0,0,9,11,20,20
20192020,063,LAUREL,311,Laurel County,016,McDaniel Learning Center,311016,063311016,210321002224,SESC,907,12,5,13,1,1,2,0,0,0,0,0,0,0,0,0,0,0,0,0,0,0,12,4,16,18
20192020,063,LAUREL,311,Laurel County,018,Wyan-Pine Grove Elementary,311018,063311018,210321002030,SESC,907,03,31,36,1,0,1,0,0,0,1,4,5,3,3,6,0,0,0,2,1,3,29,23,52,67
20192020,063,LAUREL,311,Laurel County,018,Wyan-Pine Grove Elementary,311018,063311018,210321002030,SESC,907,05,36,39,0,0,0,0,0,0,0,0,0,2,3,5,0,0,0,1,1,2,36,32,68,75
20192020,063,LAUREL,311,Laurel County,018,Wyan-Pine Grove Elementary,311018,063311018,210321002030,SESC,907,All Students,217,221,3,0,3,0,0,0,4,6,10,13,16,29,0,0,0,4,5,9,197,190,387,438
20192020,063,LAUREL,311,Laurel County,018,Wyan-Pine Grove Elementary,311018,063311018,210321002030,SESC,907,PS,26,14,0,0,0,0,0,0,0,0,0,0,3,3,0,0,0,0,0,0,14,23,37,40
20192020,063,LAUREL,311,Laurel County,018,Wyan-Pine Grove Elementary,311018,063311018,210321002030,SESC,907,KG,37,39,1,0,1,0,0,0,0,2,2,3,2,5,0,0,0,1,0,1,34,33,67,76
20192020,063,LAUREL,311,Laurel County,018,Wyan-Pine Grove Elementary,311018,063311018,210321002030,SESC,907,01,28,37,1,0,1,0,0,0,0,0,0,1,4,5,0,0,0,0,0,0,35,24,59,65
20192020,063,LAUREL,311,Laurel County,018,Wyan-Pine Grove Elementary,311018,063311018,210321002030,SESC,907,02,43,40,0,0,0,0,0,0,3,0,3,4,1,5,0,0,0,0,1,1,33,41,74,83
20192020,063,LAUREL,311,Laurel County,018,Wyan-Pine Grove Elementary,311018,063311018,210321002030,SESC,907,04,42,30,0,0,0,0,0,0,0,0,0,0,3,3,0,0,0,0,2,2,30,37,67,72
20192020,063,LAUREL,311,Laurel County,019,Laurel County Virtual Academy,311019,063311019,210321002436,SESC,907,08,3,0,0,0,0,0,0,0,0,0,0,0,0,0,0,0,0,0,0,0,0,3,3,3
20192020,063,LAUREL,311,Laurel County,019,Laurel County Virtual Academy,311019,063311019,210321002436,SESC,907,All Students,51,17,0,0,0,0,0,0,0,0,0,0,1,1,0,0,0,0,1,1,17,49,66,68
20192020,063,LAUREL,311,Laurel County,019,Laurel County Virtual Academy,311019,063311019,210321002436,SESC,907,07,5,3,0,0,0,0,0,0,0,0,0,0,0,0,0,0,0,0,1,1,3,4,7,8
20192020,063,LAUREL,311,Laurel County,019,Laurel County Virtual Academy,311019,063311019,210321002436,SESC,907,09,6,1,0,0,0,0,0,0,0,0,0,0,0,0,0,0,0,0,0,0,1,6,7,7
20192020,063,LAUREL,311,Laurel County,019,Laurel County Virtual Academy,311019,063311019,210321002436,SESC,907,10,9,3,0,0,0,0,0,0,0,0,0,0,0,0,0,0,0,0,0,0,3,9,12,12
20192020,063,LAUREL,311,Laurel County,019,Laurel County Virtual Academy,311019,063311019,210321002436,SESC,907,11,13,3,0,0,0,0,0,0,0,0,0,0,1,1,0,0,0,0,0,0,3,12,15,16
20192020,063,LAUREL,311,Laurel County,019,Laurel County Virtual Academy,311019,063311019,210321002436,SESC,907,12,15,7,0,0,0,0,0,0,0,0,0,0,0,0,0,0,0,0,0,0,7,15,22,22
20192020,063,LAUREL,311,Laurel County,030,Bush Elementary School,311030,063311030,210321000857,SESC,907,05,48,35,0,0,0,0,0,0,0,0,0,0,0,0,0,0,0,0,0,0,35,48,83,83
20192020,063,LAUREL,311,Laurel County,030,Bush Elementary School,311030,063311030,210321000857,SESC,907,All Students,235,262,1,0,1,0,0,0,4,5,9,3,2,5,0,0,0,1,1,2,253,227,480,497
20192020,063,LAUREL,311,Laurel County,030,Bush Elementary School,311030,063311030,210321000857,SESC,907,PS,14,25,0,0,0,0,0,0,1,0,1,1,0,1,0,0,0,0,0,0,23,14,37,39
20192020,063,LAUREL,311,Laurel County,030,Bush Elementary School,311030,063311030,210321000857,SESC,907,KG,38,40,1,0,1,0,0,0,1,1,2,0,2,2,0,0,0,0,0,0,38,35,73,78
20192020,063,LAUREL,311,Laurel County,030,Bush Elementary School,311030,063311030,210321000857,SESC,907,01,43,52,0,0,0,0,0,0,0,1,1,2,0,2,0,0,0,1,1,2,49,41,90,95
20192020,063,LAUREL,311,Laurel County,030,Bush Elementary School,311030,063311030,210321000857,SESC,907,02,37,55,0,0,0,0,0,0,1,1,2,0,0,0,0,0,0,0,0,0,54,36,90,92
20192020,063,LAUREL,311,Laurel County,030,Bush Elementary School,311030,063311030,210321000857,SESC,907,03,31,34,0,0,0,0,0,0,0,1,1,0,0,0,0,0,0,0,0,0,34,30,64,65
20192020,063,LAUREL,311,Laurel County,030,Bush Elementary School,311030,063311030,210321000857,SESC,907,04,38,46,0,0,0,0,0,0,2,1,3,1,0,1,0,0,0,0,0,0,43,37,80,84
20192020,063,LAUREL,311,Laurel County,040,South Laurel Middle School,311040,063311040,210321000858,SESC,907,07,158,170,1,0,1,0,0,0,0,0,0,6,1,7,1,2,3,2,5,7,160,150,310,328
20192020,063,LAUREL,311,Laurel County,040,South Laurel Middle School,311040,063311040,210321000858,SESC,907,All Students,485,545,5,2,7,2,0,2,4,1,5,11,9,20,1,2,3,5,8,13,517,463,980,1030
20192020,063,LAUREL,311,Laurel County,040,South Laurel Middle School,311040,063311040,210321000858,SESC,907,06,166,201,2,2,4,1,0,1,2,1,3,4,4,8,0,0,0,2,2,4,190,157,347,367
20192020,063,LAUREL,311,Laurel County,040,South Laurel Middle School,311040,063311040,210321000858,SESC,907,08,161,174,2,0,2,1,0,1,2,0,2,1,4,5,0,0,0,1,1,2,167,156,323,335
20192020,063,LAUREL,311,Laurel County,050,Laurel County Day Treatment,311050,063311050,210321001677,SESC,907,11,1,4,1,0,1,0,0,0,0,0,0,0,0,0,0,0,0,0,0,0,3,1,4,5
20192020,063,LAUREL,311,Laurel County,050,Laurel County Day Treatment,311050,063311050,210321001677,SESC,907,All Students,10,44,6,0,6,0,0,0,0,0,0,1,1,2,0,0,0,0,0,0,37,9,46,54
20192020,063,LAUREL,311,Laurel County,050,Laurel County Day Treatment,311050,063311050,210321001677,SESC,907,06,0,1,0,0,0,0,0,0,0,0,0,0,0,0,0,0,0,0,0,0,1,0,1,1
20192020,063,LAUREL,311,Laurel County,050,Laurel County Day Treatment,311050,063311050,210321001677,SESC,907,07,0,2,2,0,2,0,0,0,0,0,0,0,0,0,0,0,0,0,0,0,0,0,0,2
20192020,063,LAUREL,311,Laurel County,050,Laurel County Day Treatment,311050,063311050,210321001677,SESC,907,08,0,9,0,0,0,0,0,0,0,0,0,1,0,1,0,0,0,0,0,0,8,0,8,9
20192020,063,LAUREL,311,Laurel County,050,Laurel County Day Treatment,311050,063311050,210321001677,SESC,907,09,6,16,1,0,1,0,0,0,0,0,0,0,1,1,0,0,0,0,0,0,15,5,20,22
20192020,063,LAUREL,311,Laurel County,050,Laurel County Day Treatment,311050,063311050,210321001677,SESC,907,10,3,8,2,0,2,0,0,0,0,0,0,0,0,0,0,0,0,0,0,0,6,3,9,11
20192020,063,LAUREL,311,Laurel County,050,Laurel County Day Treatment,311050,063311050,210321001677,SESC,907,12,0,4,0,0,0,0,0,0,0,0,0,0,0,0,0,0,0,0,0,0,4,0,4,4
20192020,063,LAUREL,311,Laurel County,055,Camp Ground Elementary School,311055,063311055,210321000859,SESC,907,04,27,21,1,0,1,0,0,0,0,0,0,1,0,1,0,0,0,1,0,1,18,27,45,48
20192020,063,LAUREL,311,Laurel County,055,Camp Ground Elementary School,311055,063311055,210321000859,SESC,907,All Students,149,145,5,0,5,0,0,0,0,0,0,1,1,2,0,0,0,2,1,3,137,147,284,294
20192020,063,LAUREL,311,Laurel County,055,Camp Ground Elementary School,311055,063311055,210321000859,SESC,907,PS,10,10,0,0,0,0,0,0,0,0,0,0,0,0,0,0,0,0,0,0,10,10,20,20
20192020,063,LAUREL,311,Laurel County,055,Camp Ground Elementary School,311055,063311055,210321000859,SESC,907,KG,21,26,1,0,1,0,0,0,0,0,0,0,1,1,0,0,0,0,0,0,25,20,45,47
20192020,063,LAUREL,311,Laurel County,055,Camp Ground Elementary School,311055,063311055,210321000859,SESC,907,01,31,27,0,0,0,0,0,0,0,0,0,0,0,0,0,0,0,0,0,0,27,31,58,58
20192020,063,LAUREL,311,Laurel County,055,Camp Ground Elementary School,311055,063311055,210321000859,SESC,907,02,17,19,0,0,0,0,0,0,0,0,0,0,0,0,0,0,0,1,0,1,18,17,35,36
20192020,063,LAUREL,311,Laurel County,055,Camp Ground Elementary School,311055,063311055,210321000859,SESC,907,03,27,29,2,0,2,0,0,0,0,0,0,0,0,0,0,0,0,0,0,0,27,27,54,56
20192020,063,LAUREL,311,Laurel County,055,Camp Ground Elementary School,311055,063311055,210321000859,SESC,907,05,26,23,1,0,1,0,0,0,0,0,0,0,0,0,0,0,0,0,1,1,22,25,47,49
20192020,063,LAUREL,311,Laurel County,060,Laurel Co Schools Center for Innovation,311060,063311060,210321002400,SESC,907,11,73,79,1,0,1,0,0,0,1,0,1,0,1,1,0,0,0,0,0,0,77,72,149,152
20192020,063,LAUREL,311,Laurel County,060,Laurel Co Schools Center for Innovation,311060,063311060,210321002400,SESC,907,All Students,203,226,2,3,5,0,0,0,3,4,7,2,4,6,0,0,0,0,0,0,219,192,411,429
20192020,063,LAUREL,311,Laurel County,060,Laurel Co Schools Center for Innovation,311060,063311060,210321002400,SESC,907,10,75,74,0,2,2,0,0,0,1,3,4,1,2,3,0,0,0,0,0,0,72,68,140,149
20192020,063,LAUREL,311,Laurel County,060,Laurel Co Schools Center for Innovation,311060,063311060,210321002400,SESC,907,12,55,73,1,1,2,0,0,0,1,1,2,1,1,2,0,0,0,0,0,0,70,52,122,128
20192020,063,LAUREL,311,Laurel County,070,Colony Elementary School,311070,063311070,210321000860,SESC,907,04,30,30,0,0,0,0,0,0,0,0,0,1,0,1,0,0,0,0,0,0,29,30,59,60
20192020,063,LAUREL,311,Laurel County,070,Colony Elementary School,311070,063311070,210321000860,SESC,907,All Students,166,160,0,0,0,1,0,1,0,0,0,5,1,6,0,0,0,1,7,8,153,158,311,326
20192020,063,LAUREL,311,Laurel County,070,Colony Elementary School,311070,063311070,210321000860,SESC,907,PS,12,8,0,0,0,0,0,0,0,0,0,0,0,0,0,0,0,1,0,1,7,12,19,20
20192020,063,LAUREL,311,Laurel County,070,Colony Elementary School,311070,063311070,210321000860,SESC,907,KG,20,21,0,0,0,1,0,1,0,0,0,1,0,1,0,0,0,0,1,1,19,19,38,41
20192020,063,LAUREL,311,Laurel County,070,Colony Elementary School,311070,063311070,210321000860,SESC,907,01,32,26,0,0,0,0,0,0,0,0,0,0,1,1,0,0,0,0,1,1,26,30,56,58
20192020,063,LAUREL,311,Laurel County,070,Colony Elementary School,311070,063311070,210321000860,SESC,907,02,30,31,0,0,0,0,0,0,0,0,0,0,0,0,0,0,0,0,1,1,31,29,60,61
20192020,063,LAUREL,311,Laurel County,070,Colony Elementary School,311070,063311070,210321000860,SESC,907,03,29,25,0,0,0,0,0,0,0,0,0,1,0,1,0,0,0,1,3,4,23,26,49,54
20192020,063,LAUREL,311,Laurel County,070,Colony Elementary School,311070,063311070,210321000860,SESC,907,05,25,27,0,0,0,0,0,0,0,0,0,2,0,2,0,0,0,0,1,1,25,24,49,52
20192020,063,LAUREL,311,Laurel County,130,Hazel Green Elementary School,311130,063311130,210321000862,SESC,907,01,28,23,0,0,0,0,0,0,0,0,0,0,0,0,0,0,0,0,0,0,23,28,51,51
20192020,063,LAUREL,311,Laurel County,130,Hazel Green Elementary School,311130,063311130,210321000862,SESC,907,All Students,146,142,0,0,0,0,0,0,0,0,0,3,3,6,0,0,0,0,1,1,139,142,281,288
20192020,063,LAUREL,311,Laurel County,130,Hazel Green Elementary School,311130,063311130,210321000862,SESC,907,PS,10,10,0,0,0,0,0,0,0,0,0,1,1,2,0,0,0,0,0,0,9,9,18,20
20192020,063,LAUREL,311,Laurel County,130,Hazel Green Elementary School,311130,063311130,210321000862,SESC,907,KG,25,25,0,0,0,0,0,0,0,0,0,1,1,2,0,0,0,0,0,0,24,24,48,50
20192020,063,LAUREL,311,Laurel County,130,Hazel Green Elementary School,311130,063311130,210321000862,SESC,907,02,23,22,0,0,0,0,0,0,0,0,0,1,0,1,0,0,0,0,0,0,21,23,44,45
20192020,063,LAUREL,311,Laurel County,130,Hazel Green Elementary School,311130,063311130,210321000862,SESC,907,03,27,22,0,0,0,0,0,0,0,0,0,1,1,2,0,0,0,0,1,1,21,25,46,49
20192020,063,LAUREL,311,Laurel County,130,Hazel Green Elementary School,311130,063311130,210321000862,SESC,907,04,24,18,0,0,0,0,0,0,0,0,0,0,0,0,0,0,0,0,0,0,18,24,42,42
20192020,063,LAUREL,311,Laurel County,130,Hazel Green Elementary School,311130,063311130,210321000862,SESC,907,05,19,32,0,0,0,0,0,0,0,0,0,0,1,1,0,0,0,0,0,0,32,18,50,51
20192020,063,LAUREL,311,Laurel County,165,Johnson Elementary School,311165,063311165,210321000863,SESC,907,05,21,34,0,0,0,0,0,0,0,0,0,0,0,0,0,0,0,0,0,0,34,21,55,55
20192020,063,LAUREL,311,Laurel County,165,Johnson Elementary School,311165,063311165,210321000863,SESC,907,All Students,124,169,1,0,1,0,0,0,3,1,4,2,2,4,0,0,0,2,2,4,161,119,280,293
20192020,063,LAUREL,311,Laurel County,165,Johnson Elementary School,311165,063311165,210321000863,SESC,907,PS,7,14,0,0,0,0,0,0,1,0,1,0,0,0,0,0,0,0,0,0,13,7,20,21
20192020,063,LAUREL,311,Laurel County,165,Johnson Elementary School,311165,063311165,210321000863,SESC,907,KG,17,23,0,0,0,0,0,0,2,0,2,1,0,1,0,0,0,0,1,1,20,16,36,40
20192020,063,LAUREL,311,Laurel County,165,Johnson Elementary School,311165,063311165,210321000863,SESC,907,01,26,32,0,0,0,0,0,0,0,0,0,1,0,1,0,0,0,0,1,1,31,25,56,58
20192020,063,LAUREL,311,Laurel County,165,Johnson Elementary School,311165,063311165,210321000863,SESC,907,02,22,22,1,0,1,0,0,0,1,1,2,0,2,2,0,0,0,0,0,0,20,19,39,44
20192020,063,LAUREL,311,Laurel County,165,Johnson Elementary School,311165,063311165,210321000863,SESC,907,03,19,36,0,0,0,0,0,0,0,0,0,0,0,0,0,0,0,1,0,1,35,19,54,55
20192020,063,LAUREL,311,Laurel County,165,Johnson Elementary School,311165,063311165,210321000863,SESC,907,04,19,22,0,0,0,0,0,0,0,0,0,0,0,0,0,0,0,1,0,1,21,19,40,41
20192020,063,LAUREL,311,Laurel County,175,Hunter Hills Elementary School,311175,063311175,210321000715,SESC,907,04,42,54,0,1,1,0,0,0,0,0,0,2,2,4,0,0,0,2,0,2,50,39,89,96
20192020,063,LAUREL,311,Laurel County,175,Hunter Hills Elementary School,311175,063311175,210321000715,SESC,907,All Students,272,306,3,3,6,0,0,0,0,0,0,11,11,22,0,0,0,9,3,12,283,255,538,578
20192020,063,LAUREL,311,Laurel County,175,Hunter Hills Elementary School,311175,063311175,210321000715,SESC,907,PS,29,29,1,0,1,0,0,0,0,1,1,1,0,1,0,0,0,1,0,1,26,28,54,58
20192020,063,LAUREL,311,Laurel County,175,Hunter Hills Elementary School,311175,063311175,210321000715,SESC,907,KG,47,71,0,2,2,0,0,0,0,0,0,3,0,3,0,0,0,4,2,6,64,43,107,118
20192020,063,LAUREL,311,Laurel County,175,Hunter Hills Elementary School,311175,063311175,210321000715,SESC,907,01,48,41,0,0,0,0,0,0,0,0,0,1,2,3,0,0,0,0,0,0,40,46,86,89
20192020,063,LAUREL,311,Laurel County,175,Hunter Hills Elementary School,311175,063311175,210321000715,SESC,907,02,46,39,1,0,1,0,0,0,0,0,0,2,4,6,0,0,0,2,0,2,34,42,76,85
20192020,063,LAUREL,311,Laurel County,175,Hunter Hills Elementary School,311175,063311175,210321000715,SESC,907,03,43,45,1,0,1,0,0,0,0,0,0,2,1,3,0,0,0,0,1,1,42,41,83,88
20192020,063,LAUREL,311,Laurel County,175,Hunter Hills Elementary School,311175,063311175,210321000715,SESC,907,05,46,56,1,0,1,0,0,0,0,0,0,1,2,3,0,0,0,1,0,1,53,44,97,102
20192020,063,LAUREL,311,Laurel County,180,Keavy Elementary School,311180,063311180,210321000864,SESC,907,04,15,16,0,1,1,0,0,0,0,0,0,0,0,0,0,0,0,0,1,1,16,13,29,31
20192020,063,LAUREL,311,Laurel County,180,Keavy Elementary School,311180,063311180,210321000864,SESC,907,All Students,124,126,0,1,1,0,0,0,0,0,0,1,1,2,0,0,0,1,1,2,124,121,245,250
20192020,063,LAUREL,311,Laurel County,180,Keavy Elementary School,311180,063311180,210321000864,SESC,907,PS,10,10,0,0,0,0,0,0,0,0,0,0,1,1,0,0,0,0,0,0,10,9,19,20
20192020,063,LAUREL,311,Laurel County,180,Keavy Elementary School,311180,063311180,210321000864,SESC,907,KG,26,22,0,0,0,0,0,0,0,0,0,0,1,1,0,0,0,0,0,0,22,25,47,48
20192020,063,LAUREL,311,Laurel County,180,Keavy Elementary School,311180,063311180,210321000864,SESC,907,01,18,20,0,0,0,0,0,0,0,0,0,0,0,0,0,0,0,1,0,1,19,18,37,38
20192020,063,LAUREL,311,Laurel County,180,Keavy Elementary School,311180,063311180,210321000864,SESC,907,02,23,18,0,0,0,0,0,0,0,0,0,0,0,0,0,0,0,0,0,0,18,23,41,41
20192020,063,LAUREL,311,Laurel County,180,Keavy Elementary School,311180,063311180,210321000864,SESC,907,03,18,28,0,0,0,0,0,0,0,0,0,1,0,1,0,0,0,0,0,0,27,18,45,46
20192020,063,LAUREL,311,Laurel County,180,Keavy Elementary School,311180,063311180,210321000864,SESC,907,05,24,22,0,0,0,0,0,0,0,0,0,0,0,0,0,0,0,0,0,0,22,24,46,46
20192020,063,LAUREL,311,Laurel County,200,North Laurel Middle School,311200,063311200,210321001589,SESC,907,07,159,160,2,2,4,0,0,0,3,1,4,4,6,10,0,0,0,2,3,5,149,147,296,319
20192020,063,LAUREL,311,Laurel County,200,North Laurel Middle School,311200,063311200,210321001589,SESC,907,All Students,506,509,5,2,7,0,1,1,8,4,12,13,13,26,1,0,1,3,7,10,479,479,958,1015
20192020,063,LAUREL,311,Laurel County,200,North Laurel Middle School,311200,063311200,210321001589,SESC,907,06,177,172,1,0,1,0,0,0,3,2,5,3,4,7,1,0,1,0,3,3,164,168,332,349
20192020,063,LAUREL,311,Laurel County,200,North Laurel Middle School,311200,063311200,210321001589,SESC,907,08,170,177,2,0,2,0,1,1,2,1,3,6,3,9,0,0,0,1,1,2,166,164,330,347
20192020,063,LAUREL,311,Laurel County,205,North Laurel High School,311205,063311205,210321000215,SESC,907,12,129,116,6,1,7,1,0,1,2,0,2,3,2,5,0,0,0,0,2,2,104,124,228,245
20192020,063,LAUREL,311,Laurel County,205,North Laurel High School,311205,063311205,210321000215,SESC,907,All Students,568,627,9,4,13,2,1,3,5,8,13,12,7,19,1,2,3,2,7,9,596,539,1135,1195
20192020,063,LAUREL,311,Laurel County,205,North Laurel High School,311205,063311205,210321000215,SESC,907,09,186,213,3,2,5,1,1,2,1,5,6,2,2,4,1,1,2,0,2,2,205,173,378,399
20192020,063,LAUREL,311,Laurel County,205,North Laurel High School,311205,063311205,210321000215,SESC,907,10,125,150,0,1,1,0,0,0,1,1,2,3,2,5,0,0,0,2,1,3,144,120,264,275
20192020,063,LAUREL,311,Laurel County,205,North Laurel High School,311205,063311205,210321000215,SESC,907,11,127,145,0,0,0,0,0,0,1,2,3,4,1,5,0,1,1,0,2,2,140,121,261,272
20192020,063,LAUREL,311,Laurel County,205,North Laurel High School,311205,063311205,210321000215,SESC,907,14,1,3,0,0,0,0,0,0,0,0,0,0,0,0,0,0,0,0,0,0,3,1,4,4
20192020,063,LAUREL,311,Laurel County,210,South Laurel High School,311210,063311210,210321000865,SESC,907,10,114,115,4,2,6,1,1,2,2,0,2,5,4,9,0,1,1,1,0,1,102,106,208,229
20192020,063,LAUREL,311,Laurel County,210,South Laurel High School,311210,063311210,210321000865,SESC,907,All Students,470,493,9,8,17,2,2,4,7,2,9,13,9,22,3,1,4,7,5,12,452,443,895,963
20192020,063,LAUREL,311,Laurel County,210,South Laurel High School,311210,063311210,210321000865,SESC,907,12,107,117,2,1,3,1,0,1,1,0,1,3,3,6,0,0,0,0,2,2,110,101,211,224
20192020,063,LAUREL,311,Laurel County,210,South Laurel High School,311210,063311210,210321000865,SESC,907,14,1,4,0,0,0,0,0,0,0,0,0,0,0,0,0,0,0,0,0,0,4,1,5,5
20192020,063,LAUREL,311,Laurel County,210,South Laurel High School,311210,063311210,210321000865,SESC,907,09,153,164,0,2,2,0,0,0,3,2,5,4,2,6,3,0,3,1,2,3,153,145,298,317
20192020,063,LAUREL,311,Laurel County,210,South Laurel High School,311210,063311210,210321000865,SESC,907,11,95,93,3,3,6,0,1,1,1,0,1,1,0,1,0,0,0,5,1,6,83,90,173,188
20192020,063,LAUREL,311,Laurel County,420,Sublimity Elementary School,311420,063311420,210321000869,SESC,907,PS,17,13,0,0,0,0,0,0,0,0,0,0,1,1,0,0,0,0,1,1,13,15,28,30
20192020,063,LAUREL,311,Laurel County,420,Sublimity Elementary School,311420,063311420,210321000869,SESC,907,All Students,123,186,1,2,3,0,0,0,0,0,0,7,1,8,1,0,1,3,5,8,174,115,289,309
20192020,063,LAUREL,311,Laurel County,420,Sublimity Elementary School,311420,063311420,210321000869,SESC,907,KG,17,30,0,0,0,0,0,0,0,0,0,2,0,2,0,0,0,0,3,3,28,14,42,47
20192020,063,LAUREL,311,Laurel County,420,Sublimity Elementary School,311420,063311420,210321000869,SESC,907,01,18,40,0,0,0,0,0,0,0,0,0,2,0,2,1,0,1,1,2,3,36,16,52,58
20192020,063,LAUREL,311,Laurel County,420,Sublimity Elementary School,311420,063311420,210321000869,SESC,907,02,20,25,0,0,0,0,0,0,0,0,0,2,0,2,0,0,0,1,0,1,22,20,42,45
20192020,063,LAUREL,311,Laurel County,420,Sublimity Elementary School,311420,063311420,210321000869,SESC,907,03,24,29,0,1,1,0,0,0,0,0,0,0,1,1,0,0,0,0,0,0,29,22,51,53
20192020,063,LAUREL,311,Laurel County,420,Sublimity Elementary School,311420,063311420,210321000869,SESC,907,04,17,36,0,0,0,0,0,0,0,0,0,1,0,1,0,0,0,1,0,1,34,17,51,53
20192020,063,LAUREL,311,Laurel County,420,Sublimity Elementary School,311420,063311420,210321000869,SESC,907,05,27,26,1,1,2,0,0,0,0,0,0,0,0,0,0,0,0,0,0,0,25,26,51,53
20192020,063,LAUREL,311,Laurel County,430,Cold Hill Elementary School,311430,063311430,210321001483,SESC,907,04,22,24,0,0,0,0,0,0,1,0,1,0,0,0,0,0,0,0,0,0,23,22,45,46
20192020,063,LAUREL,311,Laurel County,430,Cold Hill Elementary School,311430,063311430,210321001483,SESC,907,05,21,20,0,0,0,0,0,0,0,0,0,0,1,1,0,0,0,0,0,0,20,20,40,41
20192020,063,LAUREL,311,Laurel County,430,Cold Hill Elementary School,311430,063311430,210321001483,SESC,907,All Students,114,138,1,0,1,0,0,0,3,1,4,0,3,3,0,0,0,2,0,2,132,110,242,252
20192020,063,LAUREL,311,Laurel County,430,Cold Hill Elementary School,311430,063311430,210321001483,SESC,907,PS,13,7,0,0,0,0,0,0,0,0,0,0,0,0,0,0,0,0,1,1,7,12,19,20
20192020,063,LAUREL,311,Laurel County,430,Cold Hill Elementary School,311430,063311430,210321001483,SESC,907,KG,20,28,1,0,1,0,0,0,0,0,0,0,0,0,0,0,0,1,0,1,26,20,46,48
20192020,063,LAUREL,311,Laurel County,430,Cold Hill Elementary School,311430,063311430,210321001483,SESC,907,01,17,17,0,0,0,0,0,0,1,1,2,0,1,1,0,0,0,0,0,0,16,15,31,34
20192020,063,LAUREL,311,Laurel County,430,Cold Hill Elementary School,311430,063311430,210321001483,SESC,907,02,19,20,0,0,0,0,0,0,0,0,0,0,0,0,0,0,0,0,0,0,20,19,39,39
20192020,063,LAUREL,311,Laurel County,430,Cold Hill Elementary School,311430,063311430,210321001483,SESC,907,03,15,29,0,0,0,0,0,0,1,0,1,0,1,1,0,0,0,1,0,1,27,14,41,44
20192020,064,LAWRENCE,315,Lawrence County,"",---District Total---,315,"","",KEDC,903,05,105,110,1,1,2,0,0,0,1,0,1,3,1,4,0,0,0,0,0,0,105,103,208,215
20192020,064,LAWRENCE,315,Lawrence County,"",---District Total---,315,"","",KEDC,903,06,105,101,1,0,1,0,0,0,0,0,0,2,1,3,0,0,0,1,1,2,97,103,200,206
20192020,064,LAWRENCE,315,Lawrence County,"",---District Total---,315,"","",KEDC,903,07,106,98,1,1,2,0,0,0,0,0,0,1,0,1,0,0,0,0,1,1,96,104,200,204
20192020,064,LAWRENCE,315,Lawrence County,"",---District Total---,315,"","",KEDC,903,08,92,104,0,1,1,0,0,0,1,0,1,1,2,3,0,0,0,0,1,1,102,88,190,196
20192020,064,LAWRENCE,315,Lawrence County,"",---District Total---,315,"","",KEDC,903,09,84,99,2,0,2,0,0,0,1,1,2,1,0,1,0,0,0,1,0,1,94,83,177,183
20192020,064,LAWRENCE,315,Lawrence County,"",---District Total---,315,"","",KEDC,903,10,90,91,0,1,1,0,0,0,0,1,1,1,0,1,0,0,0,0,1,1,90,87,177,181
20192020,064,LAWRENCE,315,Lawrence County,"",---District Total---,315,"","",KEDC,903,12,85,83,0,0,0,0,0,0,1,1,2,1,0,1,0,0,0,0,0,0,81,84,165,168
20192020,064,LAWRENCE,315,Lawrence County,"",---District Total---,315,"","",KEDC,903,11,66,76,1,0,1,0,0,0,0,0,0,1,1,2,0,0,0,0,0,0,74,65,139,142
20192020,064,LAWRENCE,315,Lawrence County,"",---District Total---,315,"","",KEDC,903,All Students,1171,1241,10,5,15,0,0,0,6,4,10,14,12,26,0,0,0,6,6,12,1205,1144,2349,2412
20192020,064,LAWRENCE,315,Lawrence County,"",---District Total---,315,"","",KEDC,903,PS,40,61,0,0,0,0,0,0,0,1,1,1,2,3,0,0,0,0,0,0,60,37,97,101
20192020,064,LAWRENCE,315,Lawrence County,"",---District Total---,315,"","",KEDC,903,KG,77,104,1,0,1,0,0,0,0,0,0,0,0,0,0,0,0,0,0,0,103,77,180,181
20192020,064,LAWRENCE,315,Lawrence County,"",---District Total---,315,"","",KEDC,903,01,94,89,0,0,0,0,0,0,1,1,2,0,0,0,0,0,0,1,1,2,87,92,179,183
20192020,064,LAWRENCE,315,Lawrence County,"",---District Total---,315,"","",KEDC,903,02,84,96,0,0,0,0,0,0,1,0,1,2,2,4,0,0,0,0,0,0,93,82,175,180
20192020,064,LAWRENCE,315,Lawrence County,"",---District Total---,315,"","",KEDC,903,03,81,90,0,0,0,0,0,0,0,0,0,0,1,1,0,0,0,0,0,0,90,80,170,171
20192020,064,LAWRENCE,315,Lawrence County,"",---District Total---,315,"","",KEDC,903,04,102,100,3,1,4,0,0,0,0,0,0,1,4,5,0,0,0,3,1,4,93,96,189,202
20192020,064,LAWRENCE,315,Lawrence County,020,Louisa East Elementary School,315020,064315020,210324002079,KEDC,903,04,76,70,1,1,2,0,0,0,0,0,0,1,3,4,0,0,0,3,1,4,65,71,136,146
20192020,064,LAWRENCE,315,Lawrence County,020,Louisa East Elementary School,315020,064315020,210324002079,KEDC,903,All Students,278,299,1,2,3,0,0,0,2,0,2,4,5,9,0,0,0,3,1,4,289,270,559,577
20192020,064,LAWRENCE,315,Lawrence County,020,Louisa East Elementary School,315020,064315020,210324002079,KEDC,903,02,62,71,0,0,0,0,0,0,1,0,1,1,0,1,0,0,0,0,0,0,69,62,131,133
20192020,064,LAWRENCE,315,Lawrence County,020,Louisa East Elementary School,315020,064315020,210324002079,KEDC,903,03,64,72,0,0,0,0,0,0,0,0,0,0,1,1,0,0,0,0,0,0,72,63,135,136
20192020,064,LAWRENCE,315,Lawrence County,020,Louisa East Elementary School,315020,064315020,210324002079,KEDC,903,05,76,86,0,1,1,0,0,0,1,0,1,2,1,3,0,0,0,0,0,0,83,74,157,162
20192020,064,LAWRENCE,315,Lawrence County,021,Louisa West Elementary School,315021,064315021,210324002155,KEDC,903,KG,57,77,1,0,1,0,0,0,0,0,0,0,0,0,0,0,0,0,0,0,76,57,133,134
20192020,064,LAWRENCE,315,Lawrence County,021,Louisa West Elementary School,315021,064315021,210324002155,KEDC,903,All Students,123,135,1,0,1,0,0,0,1,0,1,0,0,0,0,0,0,1,1,2,132,122,254,258
20192020,064,LAWRENCE,315,Lawrence County,021,Louisa West Elementary School,315021,064315021,210324002155,KEDC,903,PS,29,50,0,0,0,0,0,0,0,1,1,1,2,3,0,0,0,0,0,0,49,26,75,79
20192020,064,LAWRENCE,315,Lawrence County,021,Louisa West Elementary School,315021,064315021,210324002155,KEDC,903,01,66,58,0,0,0,0,0,0,1,0,1,0,0,0,0,0,0,1,1,2,56,65,121,124
20192020,064,LAWRENCE,315,Lawrence County,030,Blaine Elementary School,315030,064315030,210324000870,KEDC,903,07,12,11,0,1,1,0,0,0,0,0,0,0,0,0,0,0,0,0,0,0,11,11,22,23
20192020,064,LAWRENCE,315,Lawrence County,030,Blaine Elementary School,315030,064315030,210324000870,KEDC,903,All Students,86,97,1,2,3,0,0,0,0,0,0,1,2,3,0,0,0,0,0,0,95,82,177,183
20192020,064,LAWRENCE,315,Lawrence County,030,Blaine Elementary School,315030,064315030,210324000870,KEDC,903,PS,2,7,0,0,0,0,0,0,0,0,0,0,0,0,0,0,0,0,0,0,7,2,9,9
20192020,064,LAWRENCE,315,Lawrence County,030,Blaine Elementary School,315030,064315030,210324000870,KEDC,903,KG,10,10,0,0,0,0,0,0,0,0,0,0,0,0,0,0,0,0,0,0,10,10,20,20
20192020,064,LAWRENCE,315,Lawrence County,030,Blaine Elementary School,315030,064315030,210324000870,KEDC,903,01,9,18,0,0,0,0,0,0,0,0,0,0,0,0,0,0,0,0,0,0,18,9,27,27
20192020,064,LAWRENCE,315,Lawrence County,030,Blaine Elementary School,315030,064315030,210324000870,KEDC,903,02,10,11,0,0,0,0,0,0,0,0,0,1,0,1,0,0,0,0,0,0,10,10,20,21
20192020,064,LAWRENCE,315,Lawrence County,030,Blaine Elementary School,315030,064315030,210324000870,KEDC,903,03,6,8,0,0,0,0,0,0,0,0,0,0,0,0,0,0,0,0,0,0,8,6,14,14
20192020,064,LAWRENCE,315,Lawrence County,030,Blaine Elementary School,315030,064315030,210324000870,KEDC,903,04,12,10,1,0,1,0,0,0,0,0,0,0,1,1,0,0,0,0,0,0,9,11,20,22
20192020,064,LAWRENCE,315,Lawrence County,030,Blaine Elementary School,315030,064315030,210324000870,KEDC,903,05,14,9,0,0,0,0,0,0,0,0,0,0,0,0,0,0,0,0,0,0,9,14,23,23
20192020,064,LAWRENCE,315,Lawrence County,030,Blaine Elementary School,315030,064315030,210324000870,KEDC,903,06,6,9,0,0,0,0,0,0,0,0,0,0,0,0,0,0,0,0,0,0,9,6,15,15
20192020,064,LAWRENCE,315,Lawrence County,030,Blaine Elementary School,315030,064315030,210324000870,KEDC,903,08,7,11,0,1,1,0,0,0,0,0,0,0,1,1,0,0,0,0,0,0,11,5,16,18
20192020,064,LAWRENCE,315,Lawrence County,150,Fallsburg Elementary School,315150,064315150,210324000871,KEDC,903,08,8,16,0,0,0,0,0,0,0,0,0,0,0,0,0,0,0,0,0,0,16,8,24,24
20192020,064,LAWRENCE,315,Lawrence County,150,Fallsburg Elementary School,315150,064315150,210324000871,KEDC,903,All Students,114,131,2,0,2,0,0,0,0,1,1,2,3,5,0,0,0,0,0,0,127,110,237,245
20192020,064,LAWRENCE,315,Lawrence County,150,Fallsburg Elementary School,315150,064315150,210324000871,KEDC,903,PS,9,4,0,0,0,0,0,0,0,0,0,0,0,0,0,0,0,0,0,0,4,9,13,13
20192020,064,LAWRENCE,315,Lawrence County,150,Fallsburg Elementary School,315150,064315150,210324000871,KEDC,903,KG,10,17,0,0,0,0,0,0,0,0,0,0,0,0,0,0,0,0,0,0,17,10,27,27
20192020,064,LAWRENCE,315,Lawrence County,150,Fallsburg Elementary School,315150,064315150,210324000871,KEDC,903,01,19,13,0,0,0,0,0,0,0,1,1,0,0,0,0,0,0,0,0,0,13,18,31,32
20192020,064,LAWRENCE,315,Lawrence County,150,Fallsburg Elementary School,315150,064315150,210324000871,KEDC,903,02,12,14,0,0,0,0,0,0,0,0,0,0,2,2,0,0,0,0,0,0,14,10,24,26
20192020,064,LAWRENCE,315,Lawrence County,150,Fallsburg Elementary School,315150,064315150,210324000871,KEDC,903,03,11,10,0,0,0,0,0,0,0,0,0,0,0,0,0,0,0,0,0,0,10,11,21,21
20192020,064,LAWRENCE,315,Lawrence County,150,Fallsburg Elementary School,315150,064315150,210324000871,KEDC,903,04,14,20,1,0,1,0,0,0,0,0,0,0,0,0,0,0,0,0,0,0,19,14,33,34
20192020,064,LAWRENCE,315,Lawrence County,150,Fallsburg Elementary School,315150,064315150,210324000871,KEDC,903,05,15,15,1,0,1,0,0,0,0,0,0,1,0,1,0,0,0,0,0,0,13,15,28,30
20192020,064,LAWRENCE,315,Lawrence County,150,Fallsburg Elementary School,315150,064315150,210324000871,KEDC,903,06,14,12,0,0,0,0,0,0,0,0,0,0,1,1,0,0,0,0,0,0,12,13,25,26
20192020,064,LAWRENCE,315,Lawrence County,150,Fallsburg Elementary School,315150,064315150,210324000871,KEDC,903,07,11,14,0,0,0,0,0,0,0,0,0,1,0,1,0,0,0,0,0,0,13,11,24,25
20192020,064,LAWRENCE,315,Lawrence County,200,Louisa Middle School,315200,064315200,210324000872,KEDC,903,07,83,73,1,0,1,0,0,0,0,0,0,0,0,0,0,0,0,0,1,1,72,82,154,156
20192020,064,LAWRENCE,315,Lawrence County,200,Louisa Middle School,315200,064315200,210324000872,KEDC,903,All Students,245,230,2,0,2,0,0,0,1,0,1,3,1,4,0,0,0,1,3,4,223,241,464,475
20192020,064,LAWRENCE,315,Lawrence County,200,Louisa Middle School,315200,064315200,210324000872,KEDC,903,06,85,80,1,0,1,0,0,0,0,0,0,2,0,2,0,0,0,1,1,2,76,84,160,165
20192020,064,LAWRENCE,315,Lawrence County,200,Louisa Middle School,315200,064315200,210324000872,KEDC,903,08,77,77,0,0,0,0,0,0,1,0,1,1,1,2,0,0,0,0,1,1,75,75,150,154
20192020,064,LAWRENCE,315,Lawrence County,260,Lawrence County High School,315260,064315260,210324000874,KEDC,903,11,66,76,1,0,1,0,0,0,0,0,0,1,1,2,0,0,0,0,0,0,74,65,139,142
20192020,064,LAWRENCE,315,Lawrence County,260,Lawrence County High School,315260,064315260,210324000874,KEDC,903,All Students,325,349,3,1,4,0,0,0,2,3,5,4,1,5,0,0,0,1,1,2,339,319,658,674
20192020,064,LAWRENCE,315,Lawrence County,260,Lawrence County High School,315260,064315260,210324000874,KEDC,903,09,84,99,2,0,2,0,0,0,1,1,2,1,0,1,0,0,0,1,0,1,94,83,177,183
20192020,064,LAWRENCE,315,Lawrence County,260,Lawrence County High School,315260,064315260,210324000874,KEDC,903,10,90,91,0,1,1,0,0,0,0,1,1,1,0,1,0,0,0,0,1,1,90,87,177,181
20192020,064,LAWRENCE,315,Lawrence County,260,Lawrence County High School,315260,064315260,210324000874,KEDC,903,12,85,83,0,0,0,0,0,0,1,1,2,1,0,1,0,0,0,0,0,0,81,84,165,168
20192020,065,LEE,321,Lee County,"",---District Total---,321,"","",KVEC,904,04,24,39,0,0,0,0,0,0,0,0,0,1,1,2,0,0,0,0,0,0,38,23,61,63
20192020,065,LEE,321,Lee County,"",---District Total---,321,"","",KVEC,904,All Students,397,480,7,2,9,0,0,0,0,0,0,1,3,4,0,0,0,2,3,5,470,389,859,877
20192020,065,LEE,321,Lee County,"",---District Total---,321,"","",KVEC,904,KG,26,48,0,0,0,0,0,0,0,0,0,0,1,1,0,0,0,0,0,0,48,25,73,74
20192020,065,LEE,321,Lee County,"",---District Total---,321,"","",KVEC,904,01,40,42,0,1,1,0,0,0,0,0,0,0,0,0,0,0,0,0,0,0,42,39,81,82
20192020,065,LEE,321,Lee County,"",---District Total---,321,"","",KVEC,904,02,26,35,0,1,1,0,0,0,0,0,0,0,0,0,0,0,0,1,0,1,34,25,59,61
20192020,065,LEE,321,Lee County,"",---District Total---,321,"","",KVEC,904,03,28,41,1,0,1,0,0,0,0,0,0,0,0,0,0,0,0,0,0,0,40,28,68,69
20192020,065,LEE,321,Lee County,"",---District Total---,321,"","",KVEC,904,05,32,33,2,0,2,0,0,0,0,0,0,0,0,0,0,0,0,0,2,2,31,30,61,65
20192020,065,LEE,321,Lee County,"",---District Total---,321,"","",KVEC,904,06,26,32,0,0,0,0,0,0,0,0,0,0,0,0,0,0,0,0,0,0,32,26,58,58
20192020,065,LEE,321,Lee County,"",---District Total---,321,"","",KVEC,904,07,34,39,0,0,0,0,0,0,0,0,0,0,0,0,0,0,0,0,0,0,39,34,73,73
20192020,065,LEE,321,Lee County,"",---District Total---,321,"","",KVEC,904,08,30,37,1,0,1,0,0,0,0,0,0,0,0,0,0,0,0,0,1,1,36,29,65,67
20192020,065,LEE,321,Lee County,"",---District Total---,321,"","",KVEC,904,09,46,37,1,0,1,0,0,0,0,0,0,0,1,1,0,0,0,0,0,0,36,45,81,83
20192020,065,LEE,321,Lee County,"",---District Total---,321,"","",KVEC,904,10,27,28,0,0,0,0,0,0,0,0,0,0,0,0,0,0,0,0,0,0,28,27,55,55
20192020,065,LEE,321,Lee County,"",---District Total---,321,"","",KVEC,904,11,34,34,1,0,1,0,0,0,0,0,0,0,0,0,0,0,0,0,0,0,33,34,67,68
20192020,065,LEE,321,Lee County,"",---District Total---,321,"","",KVEC,904,12,24,35,1,0,1,0,0,0,0,0,0,0,0,0,0,0,0,1,0,1,33,24,57,59
20192020,065,LEE,321,Lee County,060,Lee County Middle High School,321060,065321060,210327002434,KVEC,904,11,34,34,1,0,1,0,0,0,0,0,0,0,0,0,0,0,0,0,0,0,33,34,67,68
20192020,065,LEE,321,Lee County,060,Lee County Middle High School,321060,065321060,210327002434,KVEC,904,12,24,35,1,0,1,0,0,0,0,0,0,0,0,0,0,0,0,1,0,1,33,24,57,59
20192020,065,LEE,321,Lee County,060,Lee County Middle High School,321060,065321060,210327002434,KVEC,904,All Students,221,242,4,0,4,0,0,0,0,0,0,0,1,1,0,0,0,1,1,2,237,219,456,463
20192020,065,LEE,321,Lee County,060,Lee County Middle High School,321060,065321060,210327002434,KVEC,904,06,26,32,0,0,0,0,0,0,0,0,0,0,0,0,0,0,0,0,0,0,32,26,58,58
20192020,065,LEE,321,Lee County,060,Lee County Middle High School,321060,065321060,210327002434,KVEC,904,07,34,39,0,0,0,0,0,0,0,0,0,0,0,0,0,0,0,0,0,0,39,34,73,73
20192020,065,LEE,321,Lee County,060,Lee County Middle High School,321060,065321060,210327002434,KVEC,904,08,30,37,1,0,1,0,0,0,0,0,0,0,0,0,0,0,0,0,1,1,36,29,65,67
20192020,065,LEE,321,Lee County,060,Lee County Middle High School,321060,065321060,210327002434,KVEC,904,09,46,37,1,0,1,0,0,0,0,0,0,0,1,1,0,0,0,0,0,0,36,45,81,83
20192020,065,LEE,321,Lee County,060,Lee County Middle High School,321060,065321060,210327002434,KVEC,904,10,27,28,0,0,0,0,0,0,0,0,0,0,0,0,0,0,0,0,0,0,28,27,55,55
20192020,065,LEE,321,Lee County,100,Lee County Elementary School,321100,065321100,210327000216,KVEC,904,03,28,41,1,0,1,0,0,0,0,0,0,0,0,0,0,0,0,0,0,0,40,28,68,69
20192020,065,LEE,321,Lee County,100,Lee County Elementary School,321100,065321100,210327000216,KVEC,904,All Students,176,238,3,2,5,0,0,0,0,0,0,1,2,3,0,0,0,1,2,3,233,170,403,414
20192020,065,LEE,321,Lee County,100,Lee County Elementary School,321100,065321100,210327000216,KVEC,904,KG,26,48,0,0,0,0,0,0,0,0,0,0,1,1,0,0,0,0,0,0,48,25,73,74
20192020,065,LEE,321,Lee County,100,Lee County Elementary School,321100,065321100,210327000216,KVEC,904,01,40,42,0,1,1,0,0,0,0,0,0,0,0,0,0,0,0,0,0,0,42,39,81,82
20192020,065,LEE,321,Lee County,100,Lee County Elementary School,321100,065321100,210327000216,KVEC,904,02,26,35,0,1,1,0,0,0,0,0,0,0,0,0,0,0,0,1,0,1,34,25,59,61
20192020,065,LEE,321,Lee County,100,Lee County Elementary School,321100,065321100,210327000216,KVEC,904,04,24,39,0,0,0,0,0,0,0,0,0,1,1,2,0,0,0,0,0,0,38,23,61,63
20192020,065,LEE,321,Lee County,100,Lee County Elementary School,321100,065321100,210327000216,KVEC,904,05,32,33,2,0,2,0,0,0,0,0,0,0,0,0,0,0,0,0,2,2,31,30,61,65
20192020,066,LESLIE,325,Leslie County,"",---District Total---,325,"","",KVEC,904,12,49,58,0,0,0,0,0,0,0,0,0,0,0,0,0,0,0,0,0,0,58,49,107,107
20192020,066,LESLIE,325,Leslie County,"",---District Total---,325,"","",KVEC,904,All Students,762,836,9,3,12,0,0,0,1,1,2,3,3,6,0,0,0,2,0,2,821,755,1576,1598
20192020,066,LESLIE,325,Leslie County,"",---District Total---,325,"","",KVEC,904,PS,70,65,0,0,0,1,0,1,0,0,0,0,0,0,0,0,0,1,0,1,63,70,133,135
20192020,066,LESLIE,325,Leslie County,"",---District Total---,325,"","",KVEC,904,KG,53,58,0,0,0,0,0,0,0,0,0,0,1,1,0,0,0,0,0,0,58,52,110,111
20192020,066,LESLIE,325,Leslie County,"",---District Total---,325,"","",KVEC,904,01,58,64,0,0,0,0,0,0,0,0,0,2,0,2,0,0,0,0,0,0,62,58,120,122
20192020,066,LESLIE,325,Leslie County,"",---District Total---,325,"","",KVEC,904,02,66,62,1,0,1,0,0,0,0,0,0,0,0,0,0,0,0,0,0,0,61,66,127,128
20192020,066,LESLIE,325,Leslie County,"",---District Total---,325,"","",KVEC,904,03,53,68,0,0,0,0,0,0,0,0,0,0,0,0,0,0,0,0,0,0,68,53,121,121
20192020,066,LESLIE,325,Leslie County,"",---District Total---,325,"","",KVEC,904,04,56,88,3,0,3,0,0,0,0,0,0,0,0,0,0,0,0,0,0,0,85,56,141,144
20192020,066,LESLIE,325,Leslie County,"",---District Total---,325,"","",KVEC,904,05,75,60,0,0,0,0,0,0,0,0,0,0,0,0,0,0,0,0,0,0,60,75,135,135
20192020,066,LESLIE,325,Leslie County,"",---District Total---,325,"","",KVEC,904,06,61,74,1,0,1,0,0,0,0,0,0,1,0,1,0,0,0,0,0,0,72,61,133,135
20192020,066,LESLIE,325,Leslie County,"",---District Total---,325,"","",KVEC,904,07,62,62,3,1,4,0,0,0,0,0,0,0,0,0,0,0,0,0,0,0,59,61,120,124
20192020,066,LESLIE,325,Leslie County,"",---District Total---,325,"","",KVEC,904,08,66,66,0,0,0,0,0,0,1,0,1,0,1,1,0,0,0,0,0,0,65,65,130,132
20192020,066,LESLIE,325,Leslie County,"",---District Total---,325,"","",KVEC,904,09,57,54,1,0,1,0,0,0,0,0,0,0,1,1,0,0,0,1,0,1,52,56,108,111
20192020,066,LESLIE,325,Leslie County,"",---District Total---,325,"","",KVEC,904,10,55,53,0,2,2,0,0,0,0,0,0,0,0,0,0,0,0,1,0,1,52,53,105,108
20192020,066,LESLIE,325,Leslie County,"",---District Total---,325,"","",KVEC,904,11,51,69,0,0,0,0,0,0,0,1,1,0,0,0,0,0,0,0,0,0,69,50,119,120
20192020,066,LESLIE,325,Leslie County,280,Hayes Lewis Elementary School,325280,066325280,210333000882,KVEC,904,08,9,5,0,0,0,0,0,0,0,0,0,0,1,1,0,0,0,0,0,0,5,8,13,14
20192020,066,LESLIE,325,Leslie County,280,Hayes Lewis Elementary School,325280,066325280,210333000882,KVEC,904,All Students,61,62,0,0,0,0,0,0,0,0,0,0,2,2,0,0,0,0,0,0,62,59,121,123
20192020,066,LESLIE,325,Leslie County,280,Hayes Lewis Elementary School,325280,066325280,210333000882,KVEC,904,PS,12,6,0,0,0,0,0,0,0,0,0,0,0,0,0,0,0,0,0,0,6,12,18,18
20192020,066,LESLIE,325,Leslie County,280,Hayes Lewis Elementary School,325280,066325280,210333000882,KVEC,904,KG,4,9,0,0,0,0,0,0,0,0,0,0,1,1,0,0,0,0,0,0,9,3,12,13
20192020,066,LESLIE,325,Leslie County,280,Hayes Lewis Elementary School,325280,066325280,210333000882,KVEC,904,01,8,5,0,0,0,0,0,0,0,0,0,0,0,0,0,0,0,0,0,0,5,8,13,13
20192020,066,LESLIE,325,Leslie County,280,Hayes Lewis Elementary School,325280,066325280,210333000882,KVEC,904,02,7,7,0,0,0,0,0,0,0,0,0,0,0,0,0,0,0,0,0,0,7,7,14,14
20192020,066,LESLIE,325,Leslie County,280,Hayes Lewis Elementary School,325280,066325280,210333000882,KVEC,904,03,2,8,0,0,0,0,0,0,0,0,0,0,0,0,0,0,0,0,0,0,8,2,10,10
20192020,066,LESLIE,325,Leslie County,280,Hayes Lewis Elementary School,325280,066325280,210333000882,KVEC,904,04,8,8,0,0,0,0,0,0,0,0,0,0,0,0,0,0,0,0,0,0,8,8,16,16
20192020,066,LESLIE,325,Leslie County,280,Hayes Lewis Elementary School,325280,066325280,210333000882,KVEC,904,05,11,5,0,0,0,0,0,0,0,0,0,0,0,0,0,0,0,0,0,0,5,11,16,16
20192020,066,LESLIE,325,Leslie County,280,Hayes Lewis Elementary School,325280,066325280,210333000882,KVEC,904,06,4,5,0,0,0,0,0,0,0,0,0,0,0,0,0,0,0,0,0,0,5,4,9,9
20192020,066,LESLIE,325,Leslie County,280,Hayes Lewis Elementary School,325280,066325280,210333000882,KVEC,904,07,8,10,0,0,0,0,0,0,0,0,0,0,0,0,0,0,0,0,0,0,10,8,18,18
20192020,066,LESLIE,325,Leslie County,300,Mountain View Elementary,325300,066325300,210333000883,KVEC,904,08,21,28,0,0,0,0,0,0,1,0,1,0,0,0,0,0,0,0,0,0,27,21,48,49
20192020,066,LESLIE,325,Leslie County,300,Mountain View Elementary,325300,066325300,210333000883,KVEC,904,All Students,200,254,6,1,7,0,0,0,1,0,1,2,0,2,0,0,0,0,0,0,245,199,444,454
20192020,066,LESLIE,325,Leslie County,300,Mountain View Elementary,325300,066325300,210333000883,KVEC,904,PS,28,30,0,0,0,1,0,1,0,0,0,0,0,0,0,0,0,0,0,0,29,28,57,58
20192020,066,LESLIE,325,Leslie County,300,Mountain View Elementary,325300,066325300,210333000883,KVEC,904,KG,19,26,0,0,0,0,0,0,0,0,0,0,0,0,0,0,0,0,0,0,26,19,45,45
20192020,066,LESLIE,325,Leslie County,300,Mountain View Elementary,325300,066325300,210333000883,KVEC,904,01,23,31,0,0,0,0,0,0,0,0,0,1,0,1,0,0,0,0,0,0,30,23,53,54
20192020,066,LESLIE,325,Leslie County,300,Mountain View Elementary,325300,066325300,210333000883,KVEC,904,02,19,26,1,0,1,0,0,0,0,0,0,0,0,0,0,0,0,0,0,0,25,19,44,45
20192020,066,LESLIE,325,Leslie County,300,Mountain View Elementary,325300,066325300,210333000883,KVEC,904,03,22,23,0,0,0,0,0,0,0,0,0,0,0,0,0,0,0,0,0,0,23,22,45,45
20192020,066,LESLIE,325,Leslie County,300,Mountain View Elementary,325300,066325300,210333000883,KVEC,904,04,21,41,3,0,3,0,0,0,0,0,0,0,0,0,0,0,0,0,0,0,38,21,59,62
20192020,066,LESLIE,325,Leslie County,300,Mountain View Elementary,325300,066325300,210333000883,KVEC,904,05,27,26,0,0,0,0,0,0,0,0,0,0,0,0,0,0,0,0,0,0,26,27,53,53
20192020,066,LESLIE,325,Leslie County,300,Mountain View Elementary,325300,066325300,210333000883,KVEC,904,06,28,32,1,0,1,0,0,0,0,0,0,1,0,1,0,0,0,0,0,0,30,28,58,60
20192020,066,LESLIE,325,Leslie County,300,Mountain View Elementary,325300,066325300,210333000883,KVEC,904,07,20,21,1,1,2,0,0,0,0,0,0,0,0,0,0,0,0,0,0,0,20,19,39,41
20192020,066,LESLIE,325,Leslie County,350,Leslie County High School,325350,066325350,210333000885,KVEC,904,11,51,69,0,0,0,0,0,0,0,1,1,0,0,0,0,0,0,0,0,0,69,50,119,120
20192020,066,LESLIE,325,Leslie County,350,Leslie County High School,325350,066325350,210333000885,KVEC,904,All Students,212,234,1,2,3,0,0,0,0,1,1,0,1,1,0,0,0,2,0,2,231,208,439,446
20192020,066,LESLIE,325,Leslie County,350,Leslie County High School,325350,066325350,210333000885,KVEC,904,09,57,54,1,0,1,0,0,0,0,0,0,0,1,1,0,0,0,1,0,1,52,56,108,111
20192020,066,LESLIE,325,Leslie County,350,Leslie County High School,325350,066325350,210333000885,KVEC,904,10,55,53,0,2,2,0,0,0,0,0,0,0,0,0,0,0,0,1,0,1,52,53,105,108
20192020,066,LESLIE,325,Leslie County,350,Leslie County High School,325350,066325350,210333000885,KVEC,904,12,49,58,0,0,0,0,0,0,0,0,0,0,0,0,0,0,0,0,0,0,58,49,107,107
20192020,066,LESLIE,325,Leslie County,420,W B Muncy Elementary School,325420,066325420,210333000886,KVEC,904,PS,11,9,0,0,0,0,0,0,0,0,0,0,0,0,0,0,0,1,0,1,8,11,19,20
20192020,066,LESLIE,325,Leslie County,420,W B Muncy Elementary School,325420,066325420,210333000886,KVEC,904,All Students,104,107,0,0,0,0,0,0,0,0,0,0,0,0,0,0,0,0,0,0,107,104,211,211
20192020,066,LESLIE,325,Leslie County,420,W B Muncy Elementary School,325420,066325420,210333000886,KVEC,904,KG,8,11,0,0,0,0,0,0,0,0,0,0,0,0,0,0,0,0,0,0,11,8,19,19
20192020,066,LESLIE,325,Leslie County,420,W B Muncy Elementary School,325420,066325420,210333000886,KVEC,904,01,11,11,0,0,0,0,0,0,0,0,0,0,0,0,0,0,0,0,0,0,11,11,22,22
20192020,066,LESLIE,325,Leslie County,420,W B Muncy Elementary School,325420,066325420,210333000886,KVEC,904,02,10,13,0,0,0,0,0,0,0,0,0,0,0,0,0,0,0,0,0,0,13,10,23,23
20192020,066,LESLIE,325,Leslie County,420,W B Muncy Elementary School,325420,066325420,210333000886,KVEC,904,03,14,14,0,0,0,0,0,0,0,0,0,0,0,0,0,0,0,0,0,0,14,14,28,28
20192020,066,LESLIE,325,Leslie County,420,W B Muncy Elementary School,325420,066325420,210333000886,KVEC,904,04,12,12,0,0,0,0,0,0,0,0,0,0,0,0,0,0,0,0,0,0,12,12,24,24
20192020,066,LESLIE,325,Leslie County,420,W B Muncy Elementary School,325420,066325420,210333000886,KVEC,904,05,11,10,0,0,0,0,0,0,0,0,0,0,0,0,0,0,0,0,0,0,10,11,21,21
20192020,066,LESLIE,325,Leslie County,420,W B Muncy Elementary School,325420,066325420,210333000886,KVEC,904,06,14,13,0,0,0,0,0,0,0,0,0,0,0,0,0,0,0,0,0,0,13,14,27,27
20192020,066,LESLIE,325,Leslie County,420,W B Muncy Elementary School,325420,066325420,210333000886,KVEC,904,07,10,9,0,0,0,0,0,0,0,0,0,0,0,0,0,0,0,0,0,0,9,10,19,19
20192020,066,LESLIE,325,Leslie County,420,W B Muncy Elementary School,325420,066325420,210333000886,KVEC,904,08,14,14,0,0,0,0,0,0,0,0,0,0,0,0,0,0,0,0,0,0,14,14,28,28
20192020,066,LESLIE,325,Leslie County,570,Stinnett Elementary School,325570,066325570,210333000887,KVEC,904,01,16,17,0,0,0,0,0,0,0,0,0,1,0,1,0,0,0,0,0,0,16,16,32,33
20192020,066,LESLIE,325,Leslie County,570,Stinnett Elementary School,325570,066325570,210333000887,KVEC,904,02,30,16,0,0,0,0,0,0,0,0,0,0,0,0,0,0,0,0,0,0,16,30,46,46
20192020,066,LESLIE,325,Leslie County,570,Stinnett Elementary School,325570,066325570,210333000887,KVEC,904,03,15,23,0,0,0,0,0,0,0,0,0,0,0,0,0,0,0,0,0,0,23,15,38,38
20192020,066,LESLIE,325,Leslie County,570,Stinnett Elementary School,325570,066325570,210333000887,KVEC,904,04,15,27,0,0,0,0,0,0,0,0,0,0,0,0,0,0,0,0,0,0,27,15,42,42
20192020,066,LESLIE,325,Leslie County,570,Stinnett Elementary School,325570,066325570,210333000887,KVEC,904,05,26,19,0,0,0,0,0,0,0,0,0,0,0,0,0,0,0,0,0,0,19,26,45,45
20192020,066,LESLIE,325,Leslie County,570,Stinnett Elementary School,325570,066325570,210333000887,KVEC,904,06,15,24,0,0,0,0,0,0,0,0,0,0,0,0,0,0,0,0,0,0,24,15,39,39
20192020,066,LESLIE,325,Leslie County,570,Stinnett Elementary School,325570,066325570,210333000887,KVEC,904,07,24,22,2,0,2,0,0,0,0,0,0,0,0,0,0,0,0,0,0,0,20,24,44,46
20192020,066,LESLIE,325,Leslie County,570,Stinnett Elementary School,325570,066325570,210333000887,KVEC,904,08,22,19,0,0,0,0,0,0,0,0,0,0,0,0,0,0,0,0,0,0,19,22,41,41
20192020,066,LESLIE,325,Leslie County,570,Stinnett Elementary School,325570,066325570,210333000887,KVEC,904,PS,19,20,0,0,0,0,0,0,0,0,0,0,0,0,0,0,0,0,0,0,20,19,39,39
20192020,066,LESLIE,325,Leslie County,570,Stinnett Elementary School,325570,066325570,210333000887,KVEC,904,KG,22,12,0,0,0,0,0,0,0,0,0,0,0,0,0,0,0,0,0,0,12,22,34,34
20192020,066,LESLIE,325,Leslie County,570,Stinnett Elementary School,325570,066325570,210333000887,KVEC,904,All Students,185,179,2,0,2,0,0,0,0,0,0,1,0,1,0,0,0,0,0,0,176,185,361,364
20192020,067,LETCHER,331,Letcher County,"",---District Total---,331,"","",KVEC,904,08,104,142,0,1,1,0,0,0,0,1,1,1,2,3,0,0,0,2,0,2,139,100,239,246
20192020,067,LETCHER,331,Letcher County,"",---District Total---,331,"","",KVEC,904,09,109,136,1,0,1,0,0,0,0,1,1,2,1,3,0,0,0,0,0,0,133,107,240,245
20192020,067,LETCHER,331,Letcher County,"",---District Total---,331,"","",KVEC,904,10,111,109,0,0,0,0,0,0,0,0,0,1,0,1,0,0,0,0,1,1,108,110,218,220
20192020,067,LETCHER,331,Letcher County,"",---District Total---,331,"","",KVEC,904,11,94,114,2,0,2,0,0,0,1,1,2,0,1,1,0,0,0,0,2,2,111,90,201,208
20192020,067,LETCHER,331,Letcher County,"",---District Total---,331,"","",KVEC,904,14,1,0,0,0,0,0,0,0,0,0,0,0,0,0,0,0,0,0,0,0,0,1,1,1
20192020,067,LETCHER,331,Letcher County,"",---District Total---,331,"","",KVEC,904,All Students,1364,1506,6,4,10,1,1,2,1,4,5,8,10,18,0,0,0,10,15,25,1480,1330,2810,2870
20192020,067,LETCHER,331,Letcher County,"",---District Total---,331,"","",KVEC,904,PS,39,33,0,0,0,0,0,0,1,0,1,0,0,0,0,0,0,0,0,0,32,39,71,72
20192020,067,LETCHER,331,Letcher County,"",---District Total---,331,"","",KVEC,904,KG,99,102,0,0,0,0,0,0,0,0,0,0,2,2,0,0,0,0,0,0,102,97,199,201
20192020,067,LETCHER,331,Letcher County,"",---District Total---,331,"","",KVEC,904,01,117,111,0,0,0,0,0,0,0,0,0,0,1,1,0,0,0,1,2,3,110,114,224,228
20192020,067,LETCHER,331,Letcher County,"",---District Total---,331,"","",KVEC,904,02,111,113,1,0,1,0,0,0,0,0,0,0,1,1,0,0,0,1,1,2,111,109,220,224
20192020,067,LETCHER,331,Letcher County,"",---District Total---,331,"","",KVEC,904,03,101,112,0,1,1,0,0,0,0,0,0,1,0,1,0,0,0,1,1,2,110,99,209,213
20192020,067,LETCHER,331,Letcher County,"",---District Total---,331,"","",KVEC,904,04,107,124,0,1,1,0,0,0,0,0,0,0,0,0,0,0,0,2,3,5,122,103,225,231
20192020,067,LETCHER,331,Letcher County,"",---District Total---,331,"","",KVEC,904,05,115,122,0,1,1,0,1,1,0,0,0,0,1,1,0,0,0,1,1,2,121,111,232,237
20192020,067,LETCHER,331,Letcher County,"",---District Total---,331,"","",KVEC,904,06,100,110,0,0,0,0,0,0,0,1,1,3,0,3,0,0,0,1,2,3,106,97,203,210
20192020,067,LETCHER,331,Letcher County,"",---District Total---,331,"","",KVEC,904,07,118,112,0,0,0,1,0,1,0,0,0,0,1,1,0,0,0,1,2,3,110,115,225,230
20192020,067,LETCHER,331,Letcher County,"",---District Total---,331,"","",KVEC,904,12,77,99,2,0,2,0,0,0,0,0,0,0,0,0,0,0,0,0,0,0,97,77,174,176
20192020,067,LETCHER,331,Letcher County,055,Letcher County Alternative Education Ctr,331055,067331055,210336002344,KVEC,904,All Students,0,1,0,0,0,0,0,0,0,0,0,0,0,0,0,0,0,0,0,0,1,0,1,1
20192020,067,LETCHER,331,Letcher County,055,Letcher County Alternative Education Ctr,331055,067331055,210336002344,KVEC,904,08,0,1,0,0,0,0,0,0,0,0,0,0,0,0,0,0,0,0,0,0,1,0,1,1
20192020,067,LETCHER,331,Letcher County,056,Letcher County Central High School,331056,067331056,210336001998,KVEC,904,10,111,109,0,0,0,0,0,0,0,0,0,1,0,1,0,0,0,0,1,1,108,110,218,220
20192020,067,LETCHER,331,Letcher County,056,Letcher County Central High School,331056,067331056,210336001998,KVEC,904,14,1,0,0,0,0,0,0,0,0,0,0,0,0,0,0,0,0,0,0,0,0,1,1,1
20192020,067,LETCHER,331,Letcher County,056,Letcher County Central High School,331056,067331056,210336001998,KVEC,904,11,94,114,2,0,2,0,0,0,1,1,2,0,1,1,0,0,0,0,2,2,111,90,201,208
20192020,067,LETCHER,331,Letcher County,056,Letcher County Central High School,331056,067331056,210336001998,KVEC,904,12,77,99,2,0,2,0,0,0,0,0,0,0,0,0,0,0,0,0,0,0,97,77,174,176
20192020,067,LETCHER,331,Letcher County,056,Letcher County Central High School,331056,067331056,210336001998,KVEC,904,All Students,392,458,5,0,5,0,0,0,1,2,3,3,2,5,0,0,0,0,3,3,449,385,834,850
20192020,067,LETCHER,331,Letcher County,056,Letcher County Central High School,331056,067331056,210336001998,KVEC,904,09,109,136,1,0,1,0,0,0,0,1,1,2,1,3,0,0,0,0,0,0,133,107,240,245
20192020,067,LETCHER,331,Letcher County,210,Arlie Boggs Elementary School,331210,067331210,210336000892,KVEC,904,01,8,7,0,0,0,0,0,0,0,0,0,0,0,0,0,0,0,0,0,0,7,8,15,15
20192020,067,LETCHER,331,Letcher County,210,Arlie Boggs Elementary School,331210,067331210,210336000892,KVEC,904,All Students,65,66,0,0,0,0,0,0,0,0,0,0,0,0,0,0,0,0,0,0,66,65,131,131
20192020,067,LETCHER,331,Letcher County,210,Arlie Boggs Elementary School,331210,067331210,210336000892,KVEC,904,KG,2,5,0,0,0,0,0,0,0,0,0,0,0,0,0,0,0,0,0,0,5,2,7,7
20192020,067,LETCHER,331,Letcher County,210,Arlie Boggs Elementary School,331210,067331210,210336000892,KVEC,904,02,7,7,0,0,0,0,0,0,0,0,0,0,0,0,0,0,0,0,0,0,7,7,14,14
20192020,067,LETCHER,331,Letcher County,210,Arlie Boggs Elementary School,331210,067331210,210336000892,KVEC,904,03,9,6,0,0,0,0,0,0,0,0,0,0,0,0,0,0,0,0,0,0,6,9,15,15
20192020,067,LETCHER,331,Letcher County,210,Arlie Boggs Elementary School,331210,067331210,210336000892,KVEC,904,04,9,14,0,0,0,0,0,0,0,0,0,0,0,0,0,0,0,0,0,0,14,9,23,23
20192020,067,LETCHER,331,Letcher County,210,Arlie Boggs Elementary School,331210,067331210,210336000892,KVEC,904,05,6,6,0,0,0,0,0,0,0,0,0,0,0,0,0,0,0,0,0,0,6,6,12,12
20192020,067,LETCHER,331,Letcher County,210,Arlie Boggs Elementary School,331210,067331210,210336000892,KVEC,904,06,6,7,0,0,0,0,0,0,0,0,0,0,0,0,0,0,0,0,0,0,7,6,13,13
20192020,067,LETCHER,331,Letcher County,210,Arlie Boggs Elementary School,331210,067331210,210336000892,KVEC,904,07,9,8,0,0,0,0,0,0,0,0,0,0,0,0,0,0,0,0,0,0,8,9,17,17
20192020,067,LETCHER,331,Letcher County,210,Arlie Boggs Elementary School,331210,067331210,210336000892,KVEC,904,08,9,6,0,0,0,0,0,0,0,0,0,0,0,0,0,0,0,0,0,0,6,9,15,15
20192020,067,LETCHER,331,Letcher County,250,Fleming Neon Middle School,331250,067331250,210336000894,KVEC,904,08,27,33,0,1,1,0,0,0,0,0,0,1,2,3,0,0,0,0,0,0,32,24,56,60
20192020,067,LETCHER,331,Letcher County,250,Fleming Neon Middle School,331250,067331250,210336000894,KVEC,904,All Students,90,95,0,1,1,0,0,0,0,1,1,2,2,4,0,0,0,1,1,2,92,85,177,185
20192020,067,LETCHER,331,Letcher County,250,Fleming Neon Middle School,331250,067331250,210336000894,KVEC,904,06,31,30,0,0,0,0,0,0,0,1,1,1,0,1,0,0,0,1,1,2,28,29,57,61
20192020,067,LETCHER,331,Letcher County,250,Fleming Neon Middle School,331250,067331250,210336000894,KVEC,904,07,32,32,0,0,0,0,0,0,0,0,0,0,0,0,0,0,0,0,0,0,32,32,64,64
20192020,067,LETCHER,331,Letcher County,350,Letcher Elementary School,331350,067331350,210336000898,KVEC,904,01,20,16,0,0,0,0,0,0,0,0,0,0,0,0,0,0,0,0,0,0,16,20,36,36
20192020,067,LETCHER,331,Letcher County,350,Letcher Elementary School,331350,067331350,210336000898,KVEC,904,02,22,28,0,0,0,0,0,0,0,0,0,0,1,1,0,0,0,0,1,1,28,20,48,50
20192020,067,LETCHER,331,Letcher County,350,Letcher Elementary School,331350,067331350,210336000898,KVEC,904,03,21,21,0,0,0,0,0,0,0,0,0,0,0,0,0,0,0,0,0,0,21,21,42,42
20192020,067,LETCHER,331,Letcher County,350,Letcher Elementary School,331350,067331350,210336000898,KVEC,904,05,28,29,0,0,0,0,0,0,0,0,0,0,0,0,0,0,0,0,0,0,29,28,57,57
20192020,067,LETCHER,331,Letcher County,350,Letcher Elementary School,331350,067331350,210336000898,KVEC,904,04,28,29,0,0,0,0,0,0,0,0,0,0,0,0,0,0,0,0,0,0,29,28,57,57
20192020,067,LETCHER,331,Letcher County,350,Letcher Elementary School,331350,067331350,210336000898,KVEC,904,All Students,138,150,0,0,0,0,0,0,0,0,0,0,1,1,0,0,0,0,1,1,150,136,286,288
20192020,067,LETCHER,331,Letcher County,350,Letcher Elementary School,331350,067331350,210336000898,KVEC,904,PS,1,6,0,0,0,0,0,0,0,0,0,0,0,0,0,0,0,0,0,0,6,1,7,7
20192020,067,LETCHER,331,Letcher County,350,Letcher Elementary School,331350,067331350,210336000898,KVEC,904,KG,19,27,0,0,0,0,0,0,0,0,0,0,0,0,0,0,0,0,0,0,27,19,46,46
20192020,067,LETCHER,331,Letcher County,355,Letcher Middle School,331355,067331355,210336002318,KVEC,904,07,20,21,0,0,0,0,0,0,0,0,0,0,1,1,0,0,0,0,1,1,21,18,39,41
20192020,067,LETCHER,331,Letcher County,355,Letcher Middle School,331355,067331355,210336002318,KVEC,904,All Students,62,86,0,0,0,0,0,0,0,0,0,0,1,1,0,0,0,1,1,2,85,60,145,148
20192020,067,LETCHER,331,Letcher County,355,Letcher Middle School,331355,067331355,210336002318,KVEC,904,06,20,28,0,0,0,0,0,0,0,0,0,0,0,0,0,0,0,0,0,0,28,20,48,48
20192020,067,LETCHER,331,Letcher County,355,Letcher Middle School,331355,067331355,210336002318,KVEC,904,08,22,37,0,0,0,0,0,0,0,0,0,0,0,0,0,0,0,1,0,1,36,22,58,59
20192020,067,LETCHER,331,Letcher County,380,Cowan Elementary School,331380,067331380,210336000900,KVEC,904,07,29,16,0,0,0,1,0,1,0,0,0,0,0,0,0,0,0,0,0,0,15,29,44,45
20192020,067,LETCHER,331,Letcher County,380,Cowan Elementary School,331380,067331380,210336000900,KVEC,904,All Students,151,141,0,2,2,1,0,1,0,0,0,1,1,2,0,0,0,1,4,5,138,144,282,292
20192020,067,LETCHER,331,Letcher County,380,Cowan Elementary School,331380,067331380,210336000900,KVEC,904,KG,16,15,0,0,0,0,0,0,0,0,0,0,0,0,0,0,0,0,0,0,15,16,31,31
20192020,067,LETCHER,331,Letcher County,380,Cowan Elementary School,331380,067331380,210336000900,KVEC,904,01,20,14,0,0,0,0,0,0,0,0,0,0,0,0,0,0,0,0,1,1,14,19,33,34
20192020,067,LETCHER,331,Letcher County,380,Cowan Elementary School,331380,067331380,210336000900,KVEC,904,02,20,17,0,0,0,0,0,0,0,0,0,0,0,0,0,0,0,0,0,0,17,20,37,37
20192020,067,LETCHER,331,Letcher County,380,Cowan Elementary School,331380,067331380,210336000900,KVEC,904,03,13,13,0,1,1,0,0,0,0,0,0,0,0,0,0,0,0,0,1,1,13,11,24,26
20192020,067,LETCHER,331,Letcher County,380,Cowan Elementary School,331380,067331380,210336000900,KVEC,904,04,17,13,0,1,1,0,0,0,0,0,0,0,0,0,0,0,0,1,1,2,12,15,27,30
20192020,067,LETCHER,331,Letcher County,380,Cowan Elementary School,331380,067331380,210336000900,KVEC,904,05,13,16,0,0,0,0,0,0,0,0,0,0,1,1,0,0,0,0,1,1,16,11,27,29
20192020,067,LETCHER,331,Letcher County,380,Cowan Elementary School,331380,067331380,210336000900,KVEC,904,06,12,20,0,0,0,0,0,0,0,0,0,1,0,1,0,0,0,0,0,0,19,12,31,32
20192020,067,LETCHER,331,Letcher County,380,Cowan Elementary School,331380,067331380,210336000900,KVEC,904,08,11,17,0,0,0,0,0,0,0,0,0,0,0,0,0,0,0,0,0,0,17,11,28,28
20192020,067,LETCHER,331,Letcher County,425,Martha Jane Potter Elementary School,331425,067331425,210336000901,KVEC,904,04,27,24,0,0,0,0,0,0,0,0,0,0,0,0,0,0,0,0,1,1,24,26,50,51
20192020,067,LETCHER,331,Letcher County,425,Martha Jane Potter Elementary School,331425,067331425,210336000901,KVEC,904,All Students,187,188,1,1,2,0,0,0,0,0,0,1,2,3,0,0,0,2,1,3,184,183,367,375
20192020,067,LETCHER,331,Letcher County,425,Martha Jane Potter Elementary School,331425,067331425,210336000901,KVEC,904,PS,0,2,0,0,0,0,0,0,0,0,0,0,0,0,0,0,0,0,0,0,2,0,2,2
20192020,067,LETCHER,331,Letcher County,425,Martha Jane Potter Elementary School,331425,067331425,210336000901,KVEC,904,KG,32,24,0,0,0,0,0,0,0,0,0,0,1,1,0,0,0,0,0,0,24,31,55,56
20192020,067,LETCHER,331,Letcher County,425,Martha Jane Potter Elementary School,331425,067331425,210336000901,KVEC,904,01,27,36,0,0,0,0,0,0,0,0,0,0,1,1,0,0,0,1,0,1,35,26,61,63
20192020,067,LETCHER,331,Letcher County,425,Martha Jane Potter Elementary School,331425,067331425,210336000901,KVEC,904,02,28,28,1,0,1,0,0,0,0,0,0,0,0,0,0,0,0,0,0,0,27,28,55,56
20192020,067,LETCHER,331,Letcher County,425,Martha Jane Potter Elementary School,331425,067331425,210336000901,KVEC,904,03,32,43,0,0,0,0,0,0,0,0,0,1,0,1,0,0,0,0,0,0,42,32,74,75
20192020,067,LETCHER,331,Letcher County,425,Martha Jane Potter Elementary School,331425,067331425,210336000901,KVEC,904,05,41,33,0,1,1,0,0,0,0,0,0,0,0,0,0,0,0,1,0,1,32,40,72,74
20192020,067,LETCHER,331,Letcher County,650,West Whitesburg Elementary School,331650,067331650,210336000903,KVEC,904,03,26,29,0,0,0,0,0,0,0,0,0,0,0,0,0,0,0,1,0,1,28,26,54,55
20192020,067,LETCHER,331,Letcher County,650,West Whitesburg Elementary School,331650,067331650,210336000903,KVEC,904,All Students,185,213,0,0,0,0,1,1,0,0,0,0,1,1,0,0,0,3,2,5,210,181,391,398
20192020,067,LETCHER,331,Letcher County,650,West Whitesburg Elementary School,331650,067331650,210336000903,KVEC,904,PS,38,25,0,0,0,0,0,0,1,0,1,0,0,0,0,0,0,0,0,0,24,38,62,63
20192020,067,LETCHER,331,Letcher County,650,West Whitesburg Elementary School,331650,067331650,210336000903,KVEC,904,KG,30,31,0,0,0,0,0,0,0,0,0,0,1,1,0,0,0,0,0,0,31,29,60,61
20192020,067,LETCHER,331,Letcher County,650,West Whitesburg Elementary School,331650,067331650,210336000903,KVEC,904,01,42,38,0,0,0,0,0,0,0,0,0,0,0,0,0,0,0,0,1,1,38,41,79,80
20192020,067,LETCHER,331,Letcher County,650,West Whitesburg Elementary School,331650,067331650,210336000903,KVEC,904,02,34,33,0,0,0,0,0,0,0,0,0,0,0,0,0,0,0,1,0,1,32,34,66,67
20192020,067,LETCHER,331,Letcher County,650,West Whitesburg Elementary School,331650,067331650,210336000903,KVEC,904,04,26,44,0,0,0,0,0,0,0,0,0,0,0,0,0,0,0,1,1,2,43,25,68,70
20192020,067,LETCHER,331,Letcher County,650,West Whitesburg Elementary School,331650,067331650,210336000903,KVEC,904,05,27,38,0,0,0,0,1,1,0,0,0,0,0,0,0,0,0,0,0,0,38,26,64,65
20192020,067,LETCHER,331,Letcher County,710,Whitesburg Middle School,331710,067331710,210336000904,KVEC,904,08,35,48,0,0,0,0,0,0,0,1,1,0,0,0,0,0,0,1,0,1,47,34,81,83
20192020,067,LETCHER,331,Letcher County,710,Whitesburg Middle School,331710,067331710,210336000904,KVEC,904,All Students,94,108,0,0,0,0,0,0,0,1,1,1,0,1,0,0,0,2,2,4,105,91,196,202
20192020,067,LETCHER,331,Letcher County,710,Whitesburg Middle School,331710,067331710,210336000904,KVEC,904,06,31,25,0,0,0,0,0,0,0,0,0,1,0,1,0,0,0,0,1,1,24,30,54,56
20192020,067,LETCHER,331,Letcher County,710,Whitesburg Middle School,331710,067331710,210336000904,KVEC,904,07,28,35,0,0,0,0,0,0,0,0,0,0,0,0,0,0,0,1,1,2,34,27,61,63
20192020,068,LEWIS,335,Lewis County,"",---District Total---,335,"","",KEDC,903,01,82,86,0,0,0,0,0,0,0,0,0,0,0,0,0,0,0,1,1,2,85,81,166,168
20192020,068,LEWIS,335,Lewis County,"",---District Total---,335,"","",KEDC,903,02,72,75,0,1,1,0,0,0,0,0,0,0,0,0,0,0,0,2,0,2,73,71,144,147
20192020,068,LEWIS,335,Lewis County,"",---District Total---,335,"","",KEDC,903,03,78,80,0,0,0,0,0,0,0,0,0,0,0,0,0,0,0,1,0,1,79,78,157,158
20192020,068,LEWIS,335,Lewis County,"",---District Total---,335,"","",KEDC,903,04,68,82,0,0,0,0,0,0,0,0,0,0,0,0,0,0,0,3,0,3,79,68,147,150
20192020,068,LEWIS,335,Lewis County,"",---District Total---,335,"","",KEDC,903,05,78,88,0,0,0,0,0,0,0,0,0,0,0,0,0,0,0,6,3,9,82,75,157,166
20192020,068,LEWIS,335,Lewis County,"",---District Total---,335,"","",KEDC,903,06,75,74,0,0,0,0,0,0,0,0,0,0,0,0,0,0,0,4,1,5,70,74,144,149
20192020,068,LEWIS,335,Lewis County,"",---District Total---,335,"","",KEDC,903,07,83,99,0,1,1,0,0,0,0,0,0,0,0,0,0,0,0,2,6,8,97,76,173,182
20192020,068,LEWIS,335,Lewis County,"",---District Total---,335,"","",KEDC,903,08,95,88,1,0,1,0,0,0,0,0,0,0,0,0,0,0,0,1,4,5,86,91,177,183
20192020,068,LEWIS,335,Lewis County,"",---District Total---,335,"","",KEDC,903,09,81,82,0,2,2,0,0,0,0,0,0,0,0,0,0,0,0,2,2,4,80,77,157,163
20192020,068,LEWIS,335,Lewis County,"",---District Total---,335,"","",KEDC,903,10,101,91,0,1,1,0,0,0,0,1,1,1,4,5,0,0,0,1,2,3,89,93,182,192
20192020,068,LEWIS,335,Lewis County,"",---District Total---,335,"","",KEDC,903,11,72,58,0,0,0,0,0,0,0,0,0,0,1,1,0,0,0,2,1,3,56,70,126,130
20192020,068,LEWIS,335,Lewis County,"",---District Total---,335,"","",KEDC,903,14,0,1,0,0,0,0,0,0,0,0,0,0,0,0,0,0,0,0,0,0,1,0,1,1
20192020,068,LEWIS,335,Lewis County,"",---District Total---,335,"","",KEDC,903,12,88,85,0,1,1,0,0,0,0,1,1,0,0,0,0,0,0,1,4,5,84,82,166,173
20192020,068,LEWIS,335,Lewis County,"",---District Total---,335,"","",KEDC,903,All Students,1055,1067,1,6,7,0,0,0,0,2,2,3,5,8,0,0,0,27,26,53,1036,1016,2052,2122
20192020,068,LEWIS,335,Lewis County,"",---District Total---,335,"","",KEDC,903,PS,34,53,0,0,0,0,0,0,0,0,0,0,0,0,0,0,0,0,0,0,53,34,87,87
20192020,068,LEWIS,335,Lewis County,"",---District Total---,335,"","",KEDC,903,KG,82,78,0,0,0,0,0,0,0,0,0,2,0,2,0,0,0,1,2,3,75,80,155,160
20192020,068,LEWIS,335,Lewis County,040,Garrison Elementary School,335040,068335040,210339000906,KEDC,903,05,22,18,0,0,0,0,0,0,0,0,0,0,0,0,0,0,0,3,3,6,15,19,34,40
20192020,068,LEWIS,335,Lewis County,040,Garrison Elementary School,335040,068335040,210339000906,KEDC,903,All Students,129,140,0,1,1,0,0,0,0,0,0,0,0,0,0,0,0,8,6,14,132,122,254,269
20192020,068,LEWIS,335,Lewis County,040,Garrison Elementary School,335040,068335040,210339000906,KEDC,903,PS,14,9,0,0,0,0,0,0,0,0,0,0,0,0,0,0,0,0,0,0,9,14,23,23
20192020,068,LEWIS,335,Lewis County,040,Garrison Elementary School,335040,068335040,210339000906,KEDC,903,KG,21,22,0,0,0,0,0,0,0,0,0,0,0,0,0,0,0,0,2,2,22,19,41,43
20192020,068,LEWIS,335,Lewis County,040,Garrison Elementary School,335040,068335040,210339000906,KEDC,903,01,20,16,0,0,0,0,0,0,0,0,0,0,0,0,0,0,0,0,1,1,16,19,35,36
20192020,068,LEWIS,335,Lewis County,040,Garrison Elementary School,335040,068335040,210339000906,KEDC,903,02,13,20,0,1,1,0,0,0,0,0,0,0,0,0,0,0,0,2,0,2,18,12,30,33
20192020,068,LEWIS,335,Lewis County,040,Garrison Elementary School,335040,068335040,210339000906,KEDC,903,03,14,21,0,0,0,0,0,0,0,0,0,0,0,0,0,0,0,0,0,0,21,14,35,35
20192020,068,LEWIS,335,Lewis County,040,Garrison Elementary School,335040,068335040,210339000906,KEDC,903,04,19,21,0,0,0,0,0,0,0,0,0,0,0,0,0,0,0,1,0,1,20,19,39,40
20192020,068,LEWIS,335,Lewis County,040,Garrison Elementary School,335040,068335040,210339000906,KEDC,903,06,20,22,0,0,0,0,0,0,0,0,0,0,0,0,0,0,0,2,0,2,20,20,40,42
20192020,068,LEWIS,335,Lewis County,090,Laurel Elementary School,335090,068335090,210339000908,KEDC,903,04,1,1,0,0,0,0,0,0,0,0,0,0,0,0,0,0,0,0,0,0,1,1,2,2
20192020,068,LEWIS,335,Lewis County,090,Laurel Elementary School,335090,068335090,210339000908,KEDC,903,All Students,37,38,0,0,0,0,0,0,0,0,0,0,0,0,0,0,0,0,1,1,38,36,74,75
20192020,068,LEWIS,335,Lewis County,090,Laurel Elementary School,335090,068335090,210339000908,KEDC,903,PS,9,9,0,0,0,0,0,0,0,0,0,0,0,0,0,0,0,0,0,0,9,9,18,18
20192020,068,LEWIS,335,Lewis County,090,Laurel Elementary School,335090,068335090,210339000908,KEDC,903,KG,4,6,0,0,0,0,0,0,0,0,0,0,0,0,0,0,0,0,0,0,6,4,10,10
20192020,068,LEWIS,335,Lewis County,090,Laurel Elementary School,335090,068335090,210339000908,KEDC,903,01,4,3,0,0,0,0,0,0,0,0,0,0,0,0,0,0,0,0,0,0,3,4,7,7
20192020,068,LEWIS,335,Lewis County,090,Laurel Elementary School,335090,068335090,210339000908,KEDC,903,02,8,6,0,0,0,0,0,0,0,0,0,0,0,0,0,0,0,0,0,0,6,8,14,14
20192020,068,LEWIS,335,Lewis County,090,Laurel Elementary School,335090,068335090,210339000908,KEDC,903,03,8,10,0,0,0,0,0,0,0,0,0,0,0,0,0,0,0,0,0,0,10,8,18,18
20192020,068,LEWIS,335,Lewis County,090,Laurel Elementary School,335090,068335090,210339000908,KEDC,903,06,6,2,0,0,0,0,0,0,0,0,0,0,0,0,0,0,0,0,1,1,2,5,7,8
20192020,068,LEWIS,335,Lewis County,090,Laurel Elementary School,335090,068335090,210339000908,KEDC,903,05,6,10,0,0,0,0,0,0,0,0,0,0,0,0,0,0,0,0,0,0,10,6,16,16
20192020,068,LEWIS,335,Lewis County,095,Lewis County Central Elementary School,335095,068335095,210339000909,KEDC,903,06,30,30,0,0,0,0,0,0,0,0,0,0,0,0,0,0,0,1,0,1,29,30,59,60
20192020,068,LEWIS,335,Lewis County,095,Lewis County Central Elementary School,335095,068335095,210339000909,KEDC,903,All Students,226,245,0,0,0,0,0,0,0,0,0,2,0,2,0,0,0,8,0,8,235,226,461,471
20192020,068,LEWIS,335,Lewis County,095,Lewis County Central Elementary School,335095,068335095,210339000909,KEDC,903,PS,6,21,0,0,0,0,0,0,0,0,0,0,0,0,0,0,0,0,0,0,21,6,27,27
20192020,068,LEWIS,335,Lewis County,095,Lewis County Central Elementary School,335095,068335095,210339000909,KEDC,903,KG,34,30,0,0,0,0,0,0,0,0,0,2,0,2,0,0,0,0,0,0,28,34,62,64
20192020,068,LEWIS,335,Lewis County,095,Lewis County Central Elementary School,335095,068335095,210339000909,KEDC,903,01,37,42,0,0,0,0,0,0,0,0,0,0,0,0,0,0,0,1,0,1,41,37,78,79
20192020,068,LEWIS,335,Lewis County,095,Lewis County Central Elementary School,335095,068335095,210339000909,KEDC,903,02,33,32,0,0,0,0,0,0,0,0,0,0,0,0,0,0,0,0,0,0,32,33,65,65
20192020,068,LEWIS,335,Lewis County,095,Lewis County Central Elementary School,335095,068335095,210339000909,KEDC,903,03,33,34,0,0,0,0,0,0,0,0,0,0,0,0,0,0,0,1,0,1,33,33,66,67
20192020,068,LEWIS,335,Lewis County,095,Lewis County Central Elementary School,335095,068335095,210339000909,KEDC,903,04,30,37,0,0,0,0,0,0,0,0,0,0,0,0,0,0,0,2,0,2,35,30,65,67
20192020,068,LEWIS,335,Lewis County,095,Lewis County Central Elementary School,335095,068335095,210339000909,KEDC,903,05,29,40,0,0,0,0,0,0,0,0,0,0,0,0,0,0,0,3,0,3,37,29,66,69
20192020,068,LEWIS,335,Lewis County,100,Lewis County Middle School,335100,068335100,210339001503,KEDC,903,08,95,88,1,0,1,0,0,0,0,0,0,0,0,0,0,0,0,1,4,5,86,91,177,183
20192020,068,LEWIS,335,Lewis County,100,Lewis County Middle School,335100,068335100,210339001503,KEDC,903,All Students,178,187,1,1,2,0,0,0,0,0,0,0,0,0,0,0,0,3,10,13,183,167,350,365
20192020,068,LEWIS,335,Lewis County,100,Lewis County Middle School,335100,068335100,210339001503,KEDC,903,07,83,99,0,1,1,0,0,0,0,0,0,0,0,0,0,0,0,2,6,8,97,76,173,182
20192020,068,LEWIS,335,Lewis County,120,Lewis County High School,335120,068335120,210339000910,KEDC,903,10,101,91,0,1,1,0,0,0,0,1,1,1,4,5,0,0,0,1,2,3,89,93,182,192
20192020,068,LEWIS,335,Lewis County,120,Lewis County High School,335120,068335120,210339000910,KEDC,903,11,72,58,0,0,0,0,0,0,0,0,0,0,1,1,0,0,0,2,1,3,56,70,126,130
20192020,068,LEWIS,335,Lewis County,120,Lewis County High School,335120,068335120,210339000910,KEDC,903,14,0,1,0,0,0,0,0,0,0,0,0,0,0,0,0,0,0,0,0,0,1,0,1,1
20192020,068,LEWIS,335,Lewis County,120,Lewis County High School,335120,068335120,210339000910,KEDC,903,12,88,85,0,1,1,0,0,0,0,1,1,0,0,0,0,0,0,1,4,5,84,82,166,173
20192020,068,LEWIS,335,Lewis County,120,Lewis County High School,335120,068335120,210339000910,KEDC,903,All Students,342,317,0,4,4,0,0,0,0,2,2,1,5,6,0,0,0,6,9,15,310,322,632,659
20192020,068,LEWIS,335,Lewis County,120,Lewis County High School,335120,068335120,210339000910,KEDC,903,09,81,82,0,2,2,0,0,0,0,0,0,0,0,0,0,0,0,2,2,4,80,77,157,163
20192020,068,LEWIS,335,Lewis County,140,Tollesboro Elementary School,335140,068335140,210339000911,KEDC,903,05,21,20,0,0,0,0,0,0,0,0,0,0,0,0,0,0,0,0,0,0,20,21,41,41
20192020,068,LEWIS,335,Lewis County,140,Tollesboro Elementary School,335140,068335140,210339000911,KEDC,903,All Students,143,140,0,0,0,0,0,0,0,0,0,0,0,0,0,0,0,2,0,2,138,143,281,283
20192020,068,LEWIS,335,Lewis County,140,Tollesboro Elementary School,335140,068335140,210339000911,KEDC,903,PS,5,14,0,0,0,0,0,0,0,0,0,0,0,0,0,0,0,0,0,0,14,5,19,19
20192020,068,LEWIS,335,Lewis County,140,Tollesboro Elementary School,335140,068335140,210339000911,KEDC,903,KG,23,20,0,0,0,0,0,0,0,0,0,0,0,0,0,0,0,1,0,1,19,23,42,43
20192020,068,LEWIS,335,Lewis County,140,Tollesboro Elementary School,335140,068335140,210339000911,KEDC,903,01,21,25,0,0,0,0,0,0,0,0,0,0,0,0,0,0,0,0,0,0,25,21,46,46
20192020,068,LEWIS,335,Lewis County,140,Tollesboro Elementary School,335140,068335140,210339000911,KEDC,903,02,18,17,0,0,0,0,0,0,0,0,0,0,0,0,0,0,0,0,0,0,17,18,35,35
20192020,068,LEWIS,335,Lewis County,140,Tollesboro Elementary School,335140,068335140,210339000911,KEDC,903,03,23,15,0,0,0,0,0,0,0,0,0,0,0,0,0,0,0,0,0,0,15,23,38,38
20192020,068,LEWIS,335,Lewis County,140,Tollesboro Elementary School,335140,068335140,210339000911,KEDC,903,04,18,23,0,0,0,0,0,0,0,0,0,0,0,0,0,0,0,0,0,0,23,18,41,41
20192020,068,LEWIS,335,Lewis County,140,Tollesboro Elementary School,335140,068335140,210339000911,KEDC,903,06,19,20,0,0,0,0,0,0,0,0,0,0,0,0,0,0,0,1,0,1,19,19,38,39
20192020,068,LEWIS,335,Lewis County,970,Foster Meade Career & Technical Center,335970,068335970,210339002377,KEDC,903,11,0,0,0,0,0,0,0,0,0,0,0,0,0,0,0,0,0,0,0,0,0,0,0,0
20192020,068,LEWIS,335,Lewis County,970,Foster Meade Career & Technical Center,335970,068335970,210339002377,KEDC,903,All Students,0,0,0,0,0,0,0,0,0,0,0,0,0,0,0,0,0,0,0,0,0,0,0,0
20192020,068,LEWIS,335,Lewis County,970,Foster Meade Career & Technical Center,335970,068335970,210339002377,KEDC,903,09,0,0,0,0,0,0,0,0,0,0,0,0,0,0,0,0,0,0,0,0,0,0,0,0
20192020,068,LEWIS,335,Lewis County,970,Foster Meade Career & Technical Center,335970,068335970,210339002377,KEDC,903,10,0,0,0,0,0,0,0,0,0,0,0,0,0,0,0,0,0,0,0,0,0,0,0,0
20192020,068,LEWIS,335,Lewis County,970,Foster Meade Career & Technical Center,335970,068335970,210339002377,KEDC,903,12,0,0,0,0,0,0,0,0,0,0,0,0,0,0,0,0,0,0,0,0,0,0,0,0
20192020,069,LINCOLN,341,Lincoln County,"",---District Total---,341,"","",SESC,907,12,131,143,3,2,5,0,0,0,1,2,3,0,10,10,0,0,0,4,5,9,135,112,247,274
20192020,069,LINCOLN,341,Lincoln County,"",---District Total---,341,"","",SESC,907,All Students,1618,1770,30,23,53,7,4,11,4,10,14,83,61,144,0,0,0,65,48,113,1581,1472,3053,3388
20192020,069,LINCOLN,341,Lincoln County,"",---District Total---,341,"","",SESC,907,PS,95,130,2,2,4,0,0,0,2,1,3,4,4,8,0,0,0,5,4,9,117,84,201,225
20192020,069,LINCOLN,341,Lincoln County,"",---District Total---,341,"","",SESC,907,KG,134,133,3,1,4,0,0,0,0,0,0,8,1,9,0,0,0,4,3,7,118,129,247,267
20192020,069,LINCOLN,341,Lincoln County,"",---District Total---,341,"","",SESC,907,01,123,149,3,2,5,0,0,0,1,0,1,6,4,10,0,0,0,7,9,16,132,108,240,272
20192020,069,LINCOLN,341,Lincoln County,"",---District Total---,341,"","",SESC,907,02,113,126,0,0,0,0,1,1,0,0,0,5,2,7,0,0,0,7,3,10,114,107,221,239
20192020,069,LINCOLN,341,Lincoln County,"",---District Total---,341,"","",SESC,907,03,120,124,1,1,2,1,1,2,0,2,2,10,4,14,0,0,0,3,4,7,109,108,217,244
20192020,069,LINCOLN,341,Lincoln County,"",---District Total---,341,"","",SESC,907,04,124,128,4,1,5,1,0,1,1,0,1,6,3,9,0,0,0,3,7,10,113,113,226,252
20192020,069,LINCOLN,341,Lincoln County,"",---District Total---,341,"","",SESC,907,05,140,145,4,4,8,0,2,2,0,1,1,8,8,16,0,0,0,2,1,3,131,124,255,285
20192020,069,LINCOLN,341,Lincoln County,"",---District Total---,341,"","",SESC,907,06,114,137,3,1,4,2,0,2,1,0,1,3,5,8,0,0,0,5,3,8,123,105,228,251
20192020,069,LINCOLN,341,Lincoln County,"",---District Total---,341,"","",SESC,907,07,110,150,4,2,6,0,0,0,0,0,0,7,5,12,0,0,0,7,3,10,132,100,232,260
20192020,069,LINCOLN,341,Lincoln County,"",---District Total---,341,"","",SESC,907,08,140,148,3,1,4,1,0,1,0,1,1,13,4,17,0,0,0,5,3,8,126,131,257,288
20192020,069,LINCOLN,341,Lincoln County,"",---District Total---,341,"","",SESC,907,09,124,141,0,0,0,2,0,2,0,0,0,9,6,15,0,0,0,5,3,8,125,115,240,265
20192020,069,LINCOLN,341,Lincoln County,"",---District Total---,341,"","",SESC,907,10,130,124,2,5,7,0,0,0,0,4,4,4,5,9,0,0,0,6,2,8,112,114,226,254
20192020,069,LINCOLN,341,Lincoln County,"",---District Total---,341,"","",SESC,907,11,115,121,0,3,3,0,0,0,0,0,0,4,4,8,0,0,0,7,2,9,110,106,216,236
20192020,069,LINCOLN,341,Lincoln County,"",---District Total---,341,"","",SESC,907,14,0,1,0,0,0,0,0,0,0,0,0,0,0,0,0,0,0,0,0,0,1,0,1,1
20192020,069,LINCOLN,341,Lincoln County,040,Crab Orchard Elementary School,341040,069341040,210348000914,SESC,907,02,16,15,0,0,0,0,0,0,0,0,0,2,1,3,0,0,0,1,0,1,12,15,27,31
20192020,069,LINCOLN,341,Lincoln County,040,Crab Orchard Elementary School,341040,069341040,210348000914,SESC,907,All Students,118,124,1,0,1,0,0,0,0,0,0,11,5,16,0,0,0,3,0,3,109,113,222,242
20192020,069,LINCOLN,341,Lincoln County,040,Crab Orchard Elementary School,341040,069341040,210348000914,SESC,907,PS,20,20,0,0,0,0,0,0,0,0,0,0,1,1,0,0,0,1,0,1,19,19,38,40
20192020,069,LINCOLN,341,Lincoln County,040,Crab Orchard Elementary School,341040,069341040,210348000914,SESC,907,KG,25,18,0,0,0,0,0,0,0,0,0,1,0,1,0,0,0,0,0,0,17,25,42,43
20192020,069,LINCOLN,341,Lincoln County,040,Crab Orchard Elementary School,341040,069341040,210348000914,SESC,907,01,25,25,1,0,1,0,0,0,0,0,0,1,2,3,0,0,0,1,0,1,22,23,45,50
20192020,069,LINCOLN,341,Lincoln County,040,Crab Orchard Elementary School,341040,069341040,210348000914,SESC,907,03,18,22,0,0,0,0,0,0,0,0,0,2,0,2,0,0,0,0,0,0,20,18,38,40
20192020,069,LINCOLN,341,Lincoln County,040,Crab Orchard Elementary School,341040,069341040,210348000914,SESC,907,04,16,15,0,0,0,0,0,0,0,0,0,1,0,1,0,0,0,1,0,1,13,16,29,31
20192020,069,LINCOLN,341,Lincoln County,040,Crab Orchard Elementary School,341040,069341040,210348000914,SESC,907,05,18,29,0,0,0,0,0,0,0,0,0,4,2,6,0,0,0,0,0,0,25,16,41,47
20192020,069,LINCOLN,341,Lincoln County,050,Highland Elementary School,341050,069341050,210348000915,SESC,907,05,26,20,0,0,0,0,0,0,0,0,0,1,1,2,0,0,0,0,0,0,19,25,44,46
20192020,069,LINCOLN,341,Lincoln County,050,Highland Elementary School,341050,069341050,210348000915,SESC,907,All Students,112,110,0,0,0,0,0,0,0,1,1,7,4,11,0,0,0,2,3,5,101,104,205,222
20192020,069,LINCOLN,341,Lincoln County,050,Highland Elementary School,341050,069341050,210348000915,SESC,907,PS,10,8,0,0,0,0,0,0,0,0,0,1,1,2,0,0,0,0,0,0,7,9,16,18
20192020,069,LINCOLN,341,Lincoln County,050,Highland Elementary School,341050,069341050,210348000915,SESC,907,KG,21,16,0,0,0,0,0,0,0,0,0,1,0,1,0,0,0,0,2,2,15,19,34,37
20192020,069,LINCOLN,341,Lincoln County,050,Highland Elementary School,341050,069341050,210348000915,SESC,907,01,14,16,0,0,0,0,0,0,0,0,0,2,1,3,0,0,0,0,1,1,14,12,26,30
20192020,069,LINCOLN,341,Lincoln County,050,Highland Elementary School,341050,069341050,210348000915,SESC,907,02,14,23,0,0,0,0,0,0,0,0,0,1,0,1,0,0,0,1,0,1,21,14,35,37
20192020,069,LINCOLN,341,Lincoln County,050,Highland Elementary School,341050,069341050,210348000915,SESC,907,03,17,14,0,0,0,0,0,0,0,1,1,2,1,3,0,0,0,1,0,1,11,15,26,31
20192020,069,LINCOLN,341,Lincoln County,050,Highland Elementary School,341050,069341050,210348000915,SESC,907,04,20,21,0,0,0,0,0,0,0,0,0,0,1,1,0,0,0,0,0,0,21,19,40,41
20192020,069,LINCOLN,341,Lincoln County,065,Lincoln County Middle School,341065,069341065,210348000478,SESC,907,07,110,150,4,2,6,0,0,0,0,0,0,7,5,12,0,0,0,7,3,10,132,100,232,260
20192020,069,LINCOLN,341,Lincoln County,065,Lincoln County Middle School,341065,069341065,210348000478,SESC,907,All Students,364,435,10,4,14,3,0,3,1,1,2,23,14,37,0,0,0,17,9,26,381,336,717,799
20192020,069,LINCOLN,341,Lincoln County,065,Lincoln County Middle School,341065,069341065,210348000478,SESC,907,06,114,137,3,1,4,2,0,2,1,0,1,3,5,8,0,0,0,5,3,8,123,105,228,251
20192020,069,LINCOLN,341,Lincoln County,065,Lincoln County Middle School,341065,069341065,210348000478,SESC,907,08,140,148,3,1,4,1,0,1,0,1,1,13,4,17,0,0,0,5,3,8,126,131,257,288
20192020,069,LINCOLN,341,Lincoln County,070,Hustonville Elementary School,341070,069341070,210348000916,SESC,907,04,25,28,0,0,0,0,0,0,0,0,0,3,1,4,0,0,0,1,2,3,24,22,46,53
20192020,069,LINCOLN,341,Lincoln County,070,Hustonville Elementary School,341070,069341070,210348000916,SESC,907,All Students,166,192,2,0,2,1,1,2,0,0,0,9,3,12,0,0,0,6,8,14,174,154,328,358
20192020,069,LINCOLN,341,Lincoln County,070,Hustonville Elementary School,341070,069341070,210348000916,SESC,907,PS,16,22,0,0,0,0,0,0,1,1,2,0,1,1,0,0,0,1,1,2,20,13,33,38
20192020,069,LINCOLN,341,Lincoln County,070,Hustonville Elementary School,341070,069341070,210348000916,SESC,907,KG,32,38,1,0,1,0,0,0,0,0,0,1,0,1,0,0,0,2,0,2,34,32,66,70
20192020,069,LINCOLN,341,Lincoln County,070,Hustonville Elementary School,341070,069341070,210348000916,SESC,907,01,29,36,1,0,1,0,0,0,0,0,0,3,0,3,0,0,0,2,2,4,30,27,57,65
20192020,069,LINCOLN,341,Lincoln County,070,Hustonville Elementary School,341070,069341070,210348000916,SESC,907,02,24,33,0,0,0,0,0,0,0,0,0,0,0,0,0,0,0,1,1,2,32,23,55,57
20192020,069,LINCOLN,341,Lincoln County,070,Hustonville Elementary School,341070,069341070,210348000916,SESC,907,03,23,32,0,0,0,1,0,1,0,0,0,2,1,3,0,0,0,0,3,3,29,19,48,55
20192020,069,LINCOLN,341,Lincoln County,070,Hustonville Elementary School,341070,069341070,210348000916,SESC,907,05,33,25,0,0,0,0,1,1,0,0,0,0,1,1,0,0,0,0,0,0,25,31,56,58
20192020,069,LINCOLN,341,Lincoln County,095,Lincoln County High School,341095,069341095,210348000918,SESC,907,14,0,1,0,0,0,0,0,0,0,0,0,0,0,0,0,0,0,0,0,0,1,0,1,1
20192020,069,LINCOLN,341,Lincoln County,095,Lincoln County High School,341095,069341095,210348000918,SESC,907,All Students,500,530,5,10,15,2,0,2,1,6,7,17,25,42,0,0,0,22,12,34,483,447,930,1030
20192020,069,LINCOLN,341,Lincoln County,095,Lincoln County High School,341095,069341095,210348000918,SESC,907,09,124,141,0,0,0,2,0,2,0,0,0,9,6,15,0,0,0,5,3,8,125,115,240,265
20192020,069,LINCOLN,341,Lincoln County,095,Lincoln County High School,341095,069341095,210348000918,SESC,907,10,130,124,2,5,7,0,0,0,0,4,4,4,5,9,0,0,0,6,2,8,112,114,226,254
20192020,069,LINCOLN,341,Lincoln County,095,Lincoln County High School,341095,069341095,210348000918,SESC,907,11,115,121,0,3,3,0,0,0,0,0,0,4,4,8,0,0,0,7,2,9,110,106,216,236
20192020,069,LINCOLN,341,Lincoln County,095,Lincoln County High School,341095,069341095,210348000918,SESC,907,12,131,143,3,2,5,0,0,0,1,2,3,0,10,10,0,0,0,4,5,9,135,112,247,274
20192020,069,LINCOLN,341,Lincoln County,130,Stanford Elementary School,341130,069341130,210348000920,SESC,907,05,44,52,4,4,8,0,1,1,0,1,1,3,4,7,0,0,0,1,1,2,44,33,77,96
20192020,069,LINCOLN,341,Lincoln County,130,Stanford Elementary School,341130,069341130,210348000920,SESC,907,All Students,239,278,12,9,21,1,3,4,2,2,4,13,9,22,0,0,0,14,13,27,236,203,439,517
20192020,069,LINCOLN,341,Lincoln County,130,Stanford Elementary School,341130,069341130,210348000920,SESC,907,PS,37,63,2,2,4,0,0,0,1,0,1,3,1,4,0,0,0,3,3,6,54,31,85,100
20192020,069,LINCOLN,341,Lincoln County,130,Stanford Elementary School,341130,069341130,210348000920,SESC,907,KG,36,42,2,1,3,0,0,0,0,0,0,3,1,4,0,0,0,2,1,3,35,33,68,78
20192020,069,LINCOLN,341,Lincoln County,130,Stanford Elementary School,341130,069341130,210348000920,SESC,907,01,36,54,1,2,3,0,0,0,1,0,1,0,1,1,0,0,0,4,4,8,48,29,77,90
20192020,069,LINCOLN,341,Lincoln County,130,Stanford Elementary School,341130,069341130,210348000920,SESC,907,02,43,43,0,0,0,0,1,1,0,0,0,2,1,3,0,0,0,4,2,6,37,39,76,86
20192020,069,LINCOLN,341,Lincoln County,130,Stanford Elementary School,341130,069341130,210348000920,SESC,907,03,39,41,1,1,2,0,1,1,0,1,1,4,2,6,0,0,0,2,1,3,34,33,67,80
20192020,069,LINCOLN,341,Lincoln County,130,Stanford Elementary School,341130,069341130,210348000920,SESC,907,04,41,46,4,1,5,1,0,1,1,0,1,1,0,1,0,0,0,1,4,5,38,36,74,87
20192020,069,LINCOLN,341,Lincoln County,150,Waynesburg Elementary School,341150,069341150,210348000921,SESC,907,03,23,15,0,0,0,0,0,0,0,0,0,0,0,0,0,0,0,0,0,0,15,23,38,38
20192020,069,LINCOLN,341,Lincoln County,150,Waynesburg Elementary School,341150,069341150,210348000921,SESC,907,All Students,119,101,0,0,0,0,0,0,0,0,0,3,1,4,0,0,0,1,3,4,97,115,212,220
20192020,069,LINCOLN,341,Lincoln County,150,Waynesburg Elementary School,341150,069341150,210348000921,SESC,907,PS,12,17,0,0,0,0,0,0,0,0,0,0,0,0,0,0,0,0,0,0,17,12,29,29
20192020,069,LINCOLN,341,Lincoln County,150,Waynesburg Elementary School,341150,069341150,210348000921,SESC,907,KG,20,19,0,0,0,0,0,0,0,0,0,2,0,2,0,0,0,0,0,0,17,20,37,39
20192020,069,LINCOLN,341,Lincoln County,150,Waynesburg Elementary School,341150,069341150,210348000921,SESC,907,01,19,18,0,0,0,0,0,0,0,0,0,0,0,0,0,0,0,0,2,2,18,17,35,37
20192020,069,LINCOLN,341,Lincoln County,150,Waynesburg Elementary School,341150,069341150,210348000921,SESC,907,05,19,19,0,0,0,0,0,0,0,0,0,0,0,0,0,0,0,1,0,1,18,19,37,38
20192020,069,LINCOLN,341,Lincoln County,150,Waynesburg Elementary School,341150,069341150,210348000921,SESC,907,02,16,12,0,0,0,0,0,0,0,0,0,0,0,0,0,0,0,0,0,0,12,16,28,28
20192020,069,LINCOLN,341,Lincoln County,150,Waynesburg Elementary School,341150,069341150,210348000921,SESC,907,04,22,18,0,0,0,0,0,0,0,0,0,1,1,2,0,0,0,0,1,1,17,20,37,40
20192020,070,LIVINGSTON,345,Livingston County,"",---District Total---,345,"","",WKEC,908,02,33,30,0,2,2,0,0,0,0,0,0,1,1,2,0,0,0,1,0,1,28,30,58,63
20192020,070,LIVINGSTON,345,Livingston County,"",---District Total---,345,"","",WKEC,908,All Students,523,575,8,2,10,0,1,1,3,2,5,24,26,50,0,1,1,20,15,35,520,476,996,1098
20192020,070,LIVINGSTON,345,Livingston County,"",---District Total---,345,"","",WKEC,908,PS,33,49,0,0,0,0,0,0,1,0,1,1,2,3,0,0,0,3,1,4,44,30,74,82
20192020,070,LIVINGSTON,345,Livingston County,"",---District Total---,345,"","",WKEC,908,KG,36,37,0,0,0,0,0,0,0,0,0,0,1,1,0,0,0,1,1,2,36,34,70,73
20192020,070,LIVINGSTON,345,Livingston County,"",---District Total---,345,"","",WKEC,908,01,37,52,1,0,1,0,1,1,0,0,0,4,1,5,0,0,0,1,0,1,46,35,81,89
20192020,070,LIVINGSTON,345,Livingston County,"",---District Total---,345,"","",WKEC,908,03,33,50,0,0,0,0,0,0,0,0,0,4,3,7,0,0,0,2,2,4,44,28,72,83
20192020,070,LIVINGSTON,345,Livingston County,"",---District Total---,345,"","",WKEC,908,04,38,56,1,0,1,0,0,0,1,0,1,0,3,3,0,0,0,4,2,6,50,33,83,94
20192020,070,LIVINGSTON,345,Livingston County,"",---District Total---,345,"","",WKEC,908,05,42,45,1,0,1,0,0,0,1,1,2,3,1,4,0,0,0,0,0,0,40,40,80,87
20192020,070,LIVINGSTON,345,Livingston County,"",---District Total---,345,"","",WKEC,908,06,43,45,1,0,1,0,0,0,0,0,0,1,3,4,0,0,0,4,4,8,39,36,75,88
20192020,070,LIVINGSTON,345,Livingston County,"",---District Total---,345,"","",WKEC,908,07,44,51,1,0,1,0,0,0,1,0,1,3,4,7,0,0,0,3,1,4,43,39,82,95
20192020,070,LIVINGSTON,345,Livingston County,"",---District Total---,345,"","",WKEC,908,08,39,51,1,0,1,0,0,0,0,0,0,4,0,4,0,0,0,0,1,1,46,38,84,90
20192020,070,LIVINGSTON,345,Livingston County,"",---District Total---,345,"","",WKEC,908,09,56,51,0,0,0,0,0,0,0,0,0,1,3,4,0,0,0,4,2,6,46,51,97,107
20192020,070,LIVINGSTON,345,Livingston County,"",---District Total---,345,"","",WKEC,908,10,41,38,2,0,2,0,0,0,0,1,1,1,1,2,0,1,1,0,2,2,35,36,71,79
20192020,070,LIVINGSTON,345,Livingston County,"",---District Total---,345,"","",WKEC,908,11,42,33,0,0,0,0,0,0,0,0,0,1,2,3,0,0,0,0,0,0,32,40,72,75
20192020,070,LIVINGSTON,345,Livingston County,"",---District Total---,345,"","",WKEC,908,12,38,36,0,0,0,0,0,0,0,0,0,1,3,4,0,0,0,0,0,0,35,35,70,74
20192020,070,LIVINGSTON,345,Livingston County,"",---District Total---,345,"","",WKEC,908,14,1,0,0,0,0,0,0,0,0,0,0,0,0,0,0,0,0,0,0,0,0,1,1,1
20192020,070,LIVINGSTON,345,Livingston County,020,North Livingston Elementary School,345020,070345020,210351001133,WKEC,908,05,20,13,0,0,0,0,0,0,1,0,1,1,0,1,0,0,0,0,0,0,11,20,31,33
20192020,070,LIVINGSTON,345,Livingston County,020,North Livingston Elementary School,345020,070345020,210351001133,WKEC,908,All Students,71,71,1,0,1,0,0,0,2,0,2,2,1,3,0,0,0,3,3,6,63,67,130,142
20192020,070,LIVINGSTON,345,Livingston County,020,North Livingston Elementary School,345020,070345020,210351001133,WKEC,908,PS,9,16,0,0,0,0,0,0,0,0,0,1,0,1,0,0,0,0,1,1,15,8,23,25
20192020,070,LIVINGSTON,345,Livingston County,020,North Livingston Elementary School,345020,070345020,210351001133,WKEC,908,KG,11,12,0,0,0,0,0,0,0,0,0,0,0,0,0,0,0,0,1,1,12,10,22,23
20192020,070,LIVINGSTON,345,Livingston County,020,North Livingston Elementary School,345020,070345020,210351001133,WKEC,908,01,10,12,0,0,0,0,0,0,0,0,0,1,0,1,0,0,0,0,0,0,11,10,21,22
20192020,070,LIVINGSTON,345,Livingston County,020,North Livingston Elementary School,345020,070345020,210351001133,WKEC,908,02,11,5,0,0,0,0,0,0,0,0,0,0,0,0,0,0,0,0,0,0,5,11,16,16
20192020,070,LIVINGSTON,345,Livingston County,020,North Livingston Elementary School,345020,070345020,210351001133,WKEC,908,03,10,17,0,0,0,0,0,0,0,0,0,0,0,0,0,0,0,2,2,4,15,8,23,27
20192020,070,LIVINGSTON,345,Livingston County,020,North Livingston Elementary School,345020,070345020,210351001133,WKEC,908,04,9,12,1,0,1,0,0,0,1,0,1,0,1,1,0,0,0,1,0,1,9,8,17,21
20192020,070,LIVINGSTON,345,Livingston County,021,South Livingston Elementary School,345021,070345021,210351001999,WKEC,908,04,29,44,0,0,0,0,0,0,0,0,0,0,2,2,0,0,0,3,2,5,41,25,66,73
20192020,070,LIVINGSTON,345,Livingston County,021,South Livingston Elementary School,345021,070345021,210351001999,WKEC,908,All Students,148,199,2,2,4,0,1,1,0,1,1,10,9,19,0,0,0,6,2,8,181,133,314,347
20192020,070,LIVINGSTON,345,Livingston County,021,South Livingston Elementary School,345021,070345021,210351001999,WKEC,908,PS,24,33,0,0,0,0,0,0,1,0,1,0,2,2,0,0,0,3,0,3,29,22,51,57
20192020,070,LIVINGSTON,345,Livingston County,021,South Livingston Elementary School,345021,070345021,210351001999,WKEC,908,KG,25,25,0,0,0,0,0,0,0,0,0,0,1,1,0,0,0,1,0,1,24,24,48,50
20192020,070,LIVINGSTON,345,Livingston County,021,South Livingston Elementary School,345021,070345021,210351001999,WKEC,908,01,27,40,1,0,1,0,1,1,0,0,0,3,1,4,0,0,0,1,0,1,35,25,60,67
20192020,070,LIVINGSTON,345,Livingston County,021,South Livingston Elementary School,345021,070345021,210351001999,WKEC,908,02,22,25,0,2,2,0,0,0,0,0,0,1,1,2,0,0,0,1,0,1,23,19,42,47
20192020,070,LIVINGSTON,345,Livingston County,021,South Livingston Elementary School,345021,070345021,210351001999,WKEC,908,03,23,33,0,0,0,0,0,0,0,0,0,4,3,7,0,0,0,0,0,0,29,20,49,56
20192020,070,LIVINGSTON,345,Livingston County,021,South Livingston Elementary School,345021,070345021,210351001999,WKEC,908,05,22,32,1,0,1,0,0,0,0,1,1,2,1,3,0,0,0,0,0,0,29,20,49,54
20192020,070,LIVINGSTON,345,Livingston County,050,Livingston Central High School,345050,070345050,210351000924,WKEC,908,12,38,36,0,0,0,0,0,0,0,0,0,1,3,4,0,0,0,0,0,0,35,35,70,74
20192020,070,LIVINGSTON,345,Livingston County,050,Livingston Central High School,345050,070345050,210351000924,WKEC,908,All Students,178,159,2,0,2,0,0,0,0,1,1,4,9,13,0,1,1,4,4,8,149,163,312,337
20192020,070,LIVINGSTON,345,Livingston County,050,Livingston Central High School,345050,070345050,210351000924,WKEC,908,08,0,1,0,0,0,0,0,0,0,0,0,0,0,0,0,0,0,0,0,0,1,0,1,1
20192020,070,LIVINGSTON,345,Livingston County,050,Livingston Central High School,345050,070345050,210351000924,WKEC,908,09,56,51,0,0,0,0,0,0,0,0,0,1,3,4,0,0,0,4,2,6,46,51,97,107
20192020,070,LIVINGSTON,345,Livingston County,050,Livingston Central High School,345050,070345050,210351000924,WKEC,908,10,41,38,2,0,2,0,0,0,0,1,1,1,1,2,0,1,1,0,2,2,35,36,71,79
20192020,070,LIVINGSTON,345,Livingston County,050,Livingston Central High School,345050,070345050,210351000924,WKEC,908,11,42,33,0,0,0,0,0,0,0,0,0,1,2,3,0,0,0,0,0,0,32,40,72,75
20192020,070,LIVINGSTON,345,Livingston County,050,Livingston Central High School,345050,070345050,210351000924,WKEC,908,14,1,0,0,0,0,0,0,0,0,0,0,0,0,0,0,0,0,0,0,0,0,1,1,1
20192020,070,LIVINGSTON,345,Livingston County,065,Livingston County Middle School,345065,070345065,210351001484,WKEC,908,07,44,51,1,0,1,0,0,0,1,0,1,3,4,7,0,0,0,3,1,4,43,39,82,95
20192020,070,LIVINGSTON,345,Livingston County,065,Livingston County Middle School,345065,070345065,210351001484,WKEC,908,All Students,126,146,3,0,3,0,0,0,1,0,1,8,7,15,0,0,0,7,6,13,127,113,240,272
20192020,070,LIVINGSTON,345,Livingston County,065,Livingston County Middle School,345065,070345065,210351001484,WKEC,908,06,43,45,1,0,1,0,0,0,0,0,0,1,3,4,0,0,0,4,4,8,39,36,75,88
20192020,070,LIVINGSTON,345,Livingston County,065,Livingston County Middle School,345065,070345065,210351001484,WKEC,908,08,39,50,1,0,1,0,0,0,0,0,0,4,0,4,0,0,0,0,1,1,45,38,83,89
20192020,071,LOGAN,351,Logan County,"",---District Total---,351,"","",GRREC,902,PS,72,104,2,4,6,0,0,0,0,0,0,8,4,12,0,0,0,3,3,6,91,61,152,176
20192020,071,LOGAN,351,Logan County,"",---District Total---,351,"","",GRREC,902,All Students,1626,1704,50,35,85,4,2,6,3,3,6,91,61,152,0,0,0,54,60,114,1502,1465,2967,3330
20192020,071,LOGAN,351,Logan County,"",---District Total---,351,"","",GRREC,902,KG,126,135,2,2,4,0,0,0,0,0,0,3,4,7,0,0,0,5,5,10,125,115,240,261
20192020,071,LOGAN,351,Logan County,"",---District Total---,351,"","",GRREC,902,01,118,143,4,4,8,1,1,2,0,0,0,4,4,8,0,0,0,8,4,12,126,105,231,261
20192020,071,LOGAN,351,Logan County,"",---District Total---,351,"","",GRREC,902,02,118,125,3,1,4,0,0,0,0,0,0,9,8,17,0,0,0,2,7,9,111,102,213,243
20192020,071,LOGAN,351,Logan County,"",---District Total---,351,"","",GRREC,902,03,123,117,7,3,10,1,0,1,0,0,0,4,1,5,0,0,0,5,5,10,100,114,214,240
20192020,071,LOGAN,351,Logan County,"",---District Total---,351,"","",GRREC,902,04,112,132,3,0,3,0,0,0,0,0,0,7,5,12,0,0,0,5,7,12,117,100,217,244
20192020,071,LOGAN,351,Logan County,"",---District Total---,351,"","",GRREC,902,05,125,117,6,3,9,0,0,0,0,0,0,6,4,10,0,0,0,2,3,5,103,115,218,242
20192020,071,LOGAN,351,Logan County,"",---District Total---,351,"","",GRREC,902,06,122,147,2,4,6,0,0,0,0,1,1,12,2,14,0,0,0,5,4,9,128,111,239,269
20192020,071,LOGAN,351,Logan County,"",---District Total---,351,"","",GRREC,902,07,121,133,7,1,8,0,0,0,0,0,0,8,5,13,0,0,0,5,2,7,113,113,226,254
20192020,071,LOGAN,351,Logan County,"",---District Total---,351,"","",GRREC,902,08,144,140,1,4,5,1,0,1,0,0,0,10,10,20,0,0,0,2,4,6,126,126,252,284
20192020,071,LOGAN,351,Logan County,"",---District Total---,351,"","",GRREC,902,09,137,143,4,2,6,0,1,1,0,0,0,9,7,16,0,0,0,5,4,9,125,123,248,280
20192020,071,LOGAN,351,Logan County,"",---District Total---,351,"","",GRREC,902,10,128,119,5,1,6,0,0,0,2,0,2,8,3,11,0,0,0,2,7,9,102,117,219,247
20192020,071,LOGAN,351,Logan County,"",---District Total---,351,"","",GRREC,902,11,116,124,3,3,6,1,0,1,1,0,1,5,4,9,0,0,0,6,5,11,108,104,212,240
20192020,071,LOGAN,351,Logan County,"",---District Total---,351,"","",GRREC,902,12,136,128,3,7,10,0,0,0,0,2,2,6,4,10,0,0,0,2,3,5,117,120,237,264
20192020,071,LOGAN,351,Logan County,"",---District Total---,351,"","",GRREC,902,14,0,1,0,0,0,0,0,0,0,0,0,0,0,0,0,0,0,0,0,0,1,0,1,1
20192020,071,LOGAN,351,Logan County,011,Adairville Elementary School,351011,071351011,210354001542,GRREC,902,08,19,19,1,1,2,1,0,1,0,0,0,3,6,9,0,0,0,0,0,0,14,12,26,38
20192020,071,LOGAN,351,Logan County,011,Adairville Elementary School,351011,071351011,210354001542,GRREC,902,PS,11,23,1,2,3,0,0,0,0,0,0,5,2,7,0,0,0,1,1,2,16,6,22,34
20192020,071,LOGAN,351,Logan County,011,Adairville Elementary School,351011,071351011,210354001542,GRREC,902,KG,19,19,1,2,3,0,0,0,0,0,0,2,2,4,0,0,0,2,2,4,14,13,27,38
20192020,071,LOGAN,351,Logan County,011,Adairville Elementary School,351011,071351011,210354001542,GRREC,902,01,19,23,2,1,3,1,0,1,0,0,0,2,2,4,0,0,0,3,0,3,15,16,31,42
20192020,071,LOGAN,351,Logan County,011,Adairville Elementary School,351011,071351011,210354001542,GRREC,902,02,15,21,0,0,0,0,0,0,0,0,0,4,1,5,0,0,0,0,1,1,17,13,30,36
20192020,071,LOGAN,351,Logan County,011,Adairville Elementary School,351011,071351011,210354001542,GRREC,902,03,11,19,4,2,6,0,0,0,0,0,0,2,0,2,0,0,0,0,0,0,13,9,22,30
20192020,071,LOGAN,351,Logan County,011,Adairville Elementary School,351011,071351011,210354001542,GRREC,902,04,14,23,2,0,2,0,0,0,0,0,0,2,3,5,0,0,0,1,0,1,18,11,29,37
20192020,071,LOGAN,351,Logan County,011,Adairville Elementary School,351011,071351011,210354001542,GRREC,902,05,23,21,4,2,6,0,0,0,0,0,0,0,2,2,0,0,0,0,0,0,17,19,36,44
20192020,071,LOGAN,351,Logan County,011,Adairville Elementary School,351011,071351011,210354001542,GRREC,902,All Students,153,195,18,11,29,2,0,2,0,0,0,25,18,43,0,0,0,8,5,13,142,119,261,348
20192020,071,LOGAN,351,Logan County,011,Adairville Elementary School,351011,071351011,210354001542,GRREC,902,06,15,29,1,2,3,0,0,0,0,0,0,7,0,7,0,0,0,0,2,2,21,11,32,44
20192020,071,LOGAN,351,Logan County,011,Adairville Elementary School,351011,071351011,210354001542,GRREC,902,07,18,21,3,1,4,0,0,0,0,0,0,3,2,5,0,0,0,2,0,2,13,15,28,39
20192020,071,LOGAN,351,Logan County,012,Auburn Elementary School,351012,071351012,210354001543,GRREC,902,06,35,33,1,0,1,0,0,0,0,0,0,0,0,0,0,0,0,1,1,2,31,34,65,68
20192020,071,LOGAN,351,Logan County,012,Auburn Elementary School,351012,071351012,210354001543,GRREC,902,08,43,43,0,1,1,0,0,0,0,0,0,5,1,6,0,0,0,0,1,1,38,40,78,86
20192020,071,LOGAN,351,Logan County,012,Auburn Elementary School,351012,071351012,210354001543,GRREC,902,All Students,313,345,7,3,10,1,1,2,0,0,0,13,6,19,0,0,0,10,12,22,314,291,605,658
20192020,071,LOGAN,351,Logan County,012,Auburn Elementary School,351012,071351012,210354001543,GRREC,902,PS,28,30,1,1,2,0,0,0,0,0,0,1,1,2,0,0,0,1,0,1,27,26,53,58
20192020,071,LOGAN,351,Logan County,012,Auburn Elementary School,351012,071351012,210354001543,GRREC,902,KG,29,42,0,0,0,0,0,0,0,0,0,0,0,0,0,0,0,1,0,1,41,29,70,71
20192020,071,LOGAN,351,Logan County,012,Auburn Elementary School,351012,071351012,210354001543,GRREC,902,01,32,38,0,0,0,0,1,1,0,0,0,0,0,0,0,0,0,1,4,5,37,27,64,70
20192020,071,LOGAN,351,Logan County,012,Auburn Elementary School,351012,071351012,210354001543,GRREC,902,02,33,39,3,1,4,0,0,0,0,0,0,2,3,5,0,0,0,2,2,4,32,27,59,72
20192020,071,LOGAN,351,Logan County,012,Auburn Elementary School,351012,071351012,210354001543,GRREC,902,03,42,36,1,0,1,1,0,1,0,0,0,1,0,1,0,0,0,2,1,3,31,41,72,78
20192020,071,LOGAN,351,Logan County,012,Auburn Elementary School,351012,071351012,210354001543,GRREC,902,04,30,36,0,0,0,0,0,0,0,0,0,1,1,2,0,0,0,1,2,3,34,27,61,66
20192020,071,LOGAN,351,Logan County,012,Auburn Elementary School,351012,071351012,210354001543,GRREC,902,05,28,35,1,1,2,0,0,0,0,0,0,1,0,1,0,0,0,1,0,1,32,27,59,63
20192020,071,LOGAN,351,Logan County,012,Auburn Elementary School,351012,071351012,210354001543,GRREC,902,07,41,43,1,0,1,0,0,0,0,0,0,3,1,4,0,0,0,1,1,2,38,39,77,84
20192020,071,LOGAN,351,Logan County,013,Chandlers Elementary School,351013,071351013,210354001544,GRREC,902,06,22,26,0,0,0,0,0,0,0,0,0,1,0,1,0,0,0,1,0,1,24,22,46,48
20192020,071,LOGAN,351,Logan County,013,Chandlers Elementary School,351013,071351013,210354001544,GRREC,902,08,24,29,0,0,0,0,0,0,0,0,0,1,1,2,0,0,0,1,0,1,27,23,50,53
20192020,071,LOGAN,351,Logan County,013,Chandlers Elementary School,351013,071351013,210354001544,GRREC,902,All Students,214,228,5,1,6,0,0,0,0,0,0,9,7,16,0,0,0,9,7,16,205,199,404,442
20192020,071,LOGAN,351,Logan County,013,Chandlers Elementary School,351013,071351013,210354001544,GRREC,902,PS,7,15,0,1,1,0,0,0,0,0,0,1,0,1,0,0,0,0,1,1,14,5,19,22
20192020,071,LOGAN,351,Logan County,013,Chandlers Elementary School,351013,071351013,210354001544,GRREC,902,KG,28,24,0,0,0,0,0,0,0,0,0,0,1,1,0,0,0,1,0,1,23,27,50,52
20192020,071,LOGAN,351,Logan County,013,Chandlers Elementary School,351013,071351013,210354001544,GRREC,902,01,17,32,2,1,3,0,0,0,0,0,0,0,1,1,0,0,0,2,0,2,28,15,43,49
20192020,071,LOGAN,351,Logan County,013,Chandlers Elementary School,351013,071351013,210354001544,GRREC,902,02,25,20,0,0,0,0,0,0,0,0,0,3,1,4,0,0,0,0,2,2,17,22,39,45
20192020,071,LOGAN,351,Logan County,013,Chandlers Elementary School,351013,071351013,210354001544,GRREC,902,03,33,22,0,0,0,0,0,0,0,0,0,1,0,1,0,0,0,1,2,3,20,31,51,55
20192020,071,LOGAN,351,Logan County,013,Chandlers Elementary School,351013,071351013,210354001544,GRREC,902,04,19,29,0,0,0,0,0,0,0,0,0,1,0,1,0,0,0,2,2,4,26,17,43,48
20192020,071,LOGAN,351,Logan County,013,Chandlers Elementary School,351013,071351013,210354001544,GRREC,902,05,28,21,0,0,0,0,0,0,0,0,0,2,2,4,0,0,0,0,1,1,19,25,44,49
20192020,071,LOGAN,351,Logan County,013,Chandlers Elementary School,351013,071351013,210354001544,GRREC,902,07,18,25,3,0,3,0,0,0,0,0,0,0,1,1,0,0,0,1,0,1,21,17,38,43
20192020,071,LOGAN,351,Logan County,014,Lewisburg Elementary School,351014,071351014,210354001545,GRREC,902,07,31,26,0,0,0,0,0,0,0,0,0,2,1,3,0,0,0,0,1,1,24,29,53,57
20192020,071,LOGAN,351,Logan County,014,Lewisburg Elementary School,351014,071351014,210354001545,GRREC,902,All Students,228,241,1,0,1,0,0,0,0,0,0,10,10,20,0,0,0,7,7,14,223,211,434,469
20192020,071,LOGAN,351,Logan County,014,Lewisburg Elementary School,351014,071351014,210354001545,GRREC,902,PS,15,22,0,0,0,0,0,0,0,0,0,1,0,1,0,0,0,0,1,1,21,14,35,37
20192020,071,LOGAN,351,Logan County,014,Lewisburg Elementary School,351014,071351014,210354001545,GRREC,902,KG,30,29,0,0,0,0,0,0,0,0,0,1,1,2,0,0,0,0,1,1,28,28,56,59
20192020,071,LOGAN,351,Logan County,014,Lewisburg Elementary School,351014,071351014,210354001545,GRREC,902,01,31,34,0,0,0,0,0,0,0,0,0,1,1,2,0,0,0,1,0,1,32,30,62,65
20192020,071,LOGAN,351,Logan County,014,Lewisburg Elementary School,351014,071351014,210354001545,GRREC,902,02,25,20,0,0,0,0,0,0,0,0,0,0,2,2,0,0,0,0,1,1,20,22,42,45
20192020,071,LOGAN,351,Logan County,014,Lewisburg Elementary School,351014,071351014,210354001545,GRREC,902,03,17,19,0,0,0,0,0,0,0,0,0,0,1,1,0,0,0,1,0,1,18,16,34,36
20192020,071,LOGAN,351,Logan County,014,Lewisburg Elementary School,351014,071351014,210354001545,GRREC,902,04,22,22,0,0,0,0,0,0,0,0,0,2,1,3,0,0,0,1,1,2,19,20,39,44
20192020,071,LOGAN,351,Logan County,014,Lewisburg Elementary School,351014,071351014,210354001545,GRREC,902,05,18,24,1,0,1,0,0,0,0,0,0,2,0,2,0,0,0,1,1,2,20,17,37,42
20192020,071,LOGAN,351,Logan County,014,Lewisburg Elementary School,351014,071351014,210354001545,GRREC,902,06,24,32,0,0,0,0,0,0,0,0,0,1,2,3,0,0,0,2,0,2,29,22,51,56
20192020,071,LOGAN,351,Logan County,014,Lewisburg Elementary School,351014,071351014,210354001545,GRREC,902,08,30,35,0,0,0,0,0,0,0,0,0,1,1,2,0,0,0,1,2,3,33,27,60,65
20192020,071,LOGAN,351,Logan County,016,Olmstead Elementary School,351016,071351016,210354001546,GRREC,902,08,27,12,0,2,2,0,0,0,0,0,0,0,1,1,0,0,0,0,1,1,12,23,35,39
20192020,071,LOGAN,351,Logan County,016,Olmstead Elementary School,351016,071351016,210354001546,GRREC,902,All Students,200,176,4,7,11,0,0,0,0,1,1,6,2,8,0,0,0,5,10,15,161,180,341,376
20192020,071,LOGAN,351,Logan County,016,Olmstead Elementary School,351016,071351016,210354001546,GRREC,902,PS,11,14,0,0,0,0,0,0,0,0,0,0,1,1,0,0,0,1,0,1,13,10,23,25
20192020,071,LOGAN,351,Logan County,016,Olmstead Elementary School,351016,071351016,210354001546,GRREC,902,KG,20,21,1,0,1,0,0,0,0,0,0,0,0,0,0,0,0,1,2,3,19,18,37,41
20192020,071,LOGAN,351,Logan County,016,Olmstead Elementary School,351016,071351016,210354001546,GRREC,902,01,19,16,0,2,2,0,0,0,0,0,0,1,0,1,0,0,0,1,0,1,14,17,31,35
20192020,071,LOGAN,351,Logan County,016,Olmstead Elementary School,351016,071351016,210354001546,GRREC,902,02,20,25,0,0,0,0,0,0,0,0,0,0,1,1,0,0,0,0,1,1,25,18,43,45
20192020,071,LOGAN,351,Logan County,016,Olmstead Elementary School,351016,071351016,210354001546,GRREC,902,03,20,21,2,1,3,0,0,0,0,0,0,0,0,0,0,0,0,1,2,3,18,17,35,41
20192020,071,LOGAN,351,Logan County,016,Olmstead Elementary School,351016,071351016,210354001546,GRREC,902,04,27,22,1,0,1,0,0,0,0,0,0,1,0,1,0,0,0,0,2,2,20,25,45,49
20192020,071,LOGAN,351,Logan County,016,Olmstead Elementary School,351016,071351016,210354001546,GRREC,902,05,28,16,0,0,0,0,0,0,0,0,0,1,0,1,0,0,0,0,1,1,15,27,42,44
20192020,071,LOGAN,351,Logan County,016,Olmstead Elementary School,351016,071351016,210354001546,GRREC,902,06,26,26,0,2,2,0,0,0,0,1,1,3,0,3,0,0,0,1,1,2,22,22,44,52
20192020,071,LOGAN,351,Logan County,016,Olmstead Elementary School,351016,071351016,210354001546,GRREC,902,07,13,17,0,0,0,0,0,0,0,0,0,0,0,0,0,0,0,1,0,1,16,13,29,30
20192020,071,LOGAN,351,Logan County,030,The Academy,351030,071351030,210354002396,GRREC,902,11,5,12,0,1,1,0,0,0,0,0,0,1,0,1,0,0,0,2,0,2,9,4,13,17
20192020,071,LOGAN,351,Logan County,030,The Academy,351030,071351030,210354002396,GRREC,902,All Students,30,42,2,1,3,0,0,0,0,0,0,3,1,4,0,0,0,2,0,2,35,28,63,72
20192020,071,LOGAN,351,Logan County,030,The Academy,351030,071351030,210354002396,GRREC,902,06,0,1,0,0,0,0,0,0,0,0,0,0,0,0,0,0,0,0,0,0,1,0,1,1
20192020,071,LOGAN,351,Logan County,030,The Academy,351030,071351030,210354002396,GRREC,902,07,0,1,0,0,0,0,0,0,0,0,0,0,0,0,0,0,0,0,0,0,1,0,1,1
20192020,071,LOGAN,351,Logan County,030,The Academy,351030,071351030,210354002396,GRREC,902,08,1,2,0,0,0,0,0,0,0,0,0,0,0,0,0,0,0,0,0,0,2,1,3,3
20192020,071,LOGAN,351,Logan County,030,The Academy,351030,071351030,210354002396,GRREC,902,09,3,8,1,0,1,0,0,0,0,0,0,1,1,2,0,0,0,0,0,0,6,2,8,11
20192020,071,LOGAN,351,Logan County,030,The Academy,351030,071351030,210354002396,GRREC,902,10,6,5,1,0,1,0,0,0,0,0,0,0,0,0,0,0,0,0,0,0,4,6,10,11
20192020,071,LOGAN,351,Logan County,030,The Academy,351030,071351030,210354002396,GRREC,902,12,15,13,0,0,0,0,0,0,0,0,0,1,0,1,0,0,0,0,0,0,12,15,27,28
20192020,071,LOGAN,351,Logan County,140,Logan County High School,351140,071351140,210354001458,GRREC,902,14,0,1,0,0,0,0,0,0,0,0,0,0,0,0,0,0,0,0,0,0,1,0,1,1
20192020,071,LOGAN,351,Logan County,140,Logan County High School,351140,071351140,210354001458,GRREC,902,All Students,488,477,13,12,25,1,1,2,3,2,5,25,17,42,0,0,0,13,19,32,422,437,859,965
20192020,071,LOGAN,351,Logan County,140,Logan County High School,351140,071351140,210354001458,GRREC,902,09,134,135,3,2,5,0,1,1,0,0,0,8,6,14,0,0,0,5,4,9,119,121,240,269
20192020,071,LOGAN,351,Logan County,140,Logan County High School,351140,071351140,210354001458,GRREC,902,10,122,114,4,1,5,0,0,0,2,0,2,8,3,11,0,0,0,2,7,9,98,111,209,236
20192020,071,LOGAN,351,Logan County,140,Logan County High School,351140,071351140,210354001458,GRREC,902,11,111,112,3,2,5,1,0,1,1,0,1,4,4,8,0,0,0,4,5,9,99,100,199,223
20192020,071,LOGAN,351,Logan County,140,Logan County High School,351140,071351140,210354001458,GRREC,902,12,121,115,3,7,10,0,0,0,0,2,2,5,4,9,0,0,0,2,3,5,105,105,210,236
20192020,059,KENTON,354,Ludlow Independent,"",---District Total---,354,"","",NKCES,905,14,1,0,0,0,0,0,0,0,0,0,0,0,0,0,0,0,0,0,0,0,0,1,1,1
20192020,059,KENTON,354,Ludlow Independent,"",---District Total---,354,"","",NKCES,905,All Students,384,409,12,4,16,1,0,1,0,2,2,17,16,33,1,0,1,28,22,50,350,340,690,793
20192020,059,KENTON,354,Ludlow Independent,"",---District Total---,354,"","",NKCES,905,PS,29,26,1,0,1,0,0,0,0,0,0,1,2,3,0,0,0,3,4,7,21,23,44,55
20192020,059,KENTON,354,Ludlow Independent,"",---District Total---,354,"","",NKCES,905,KG,26,28,2,0,2,0,0,0,0,0,0,2,1,3,0,0,0,2,1,3,22,24,46,54
20192020,059,KENTON,354,Ludlow Independent,"",---District Total---,354,"","",NKCES,905,01,30,41,2,0,2,0,0,0,0,0,0,2,0,2,0,0,0,4,1,5,33,29,62,71
20192020,059,KENTON,354,Ludlow Independent,"",---District Total---,354,"","",NKCES,905,02,23,22,1,0,1,0,0,0,0,0,0,2,2,4,0,0,0,3,1,4,16,20,36,45
20192020,059,KENTON,354,Ludlow Independent,"",---District Total---,354,"","",NKCES,905,03,36,28,1,2,3,0,0,0,0,0,0,1,0,1,1,0,1,0,3,3,25,31,56,64
20192020,059,KENTON,354,Ludlow Independent,"",---District Total---,354,"","",NKCES,905,04,27,26,0,0,0,0,0,0,0,0,0,1,2,3,0,0,0,1,0,1,24,25,49,53
20192020,059,KENTON,354,Ludlow Independent,"",---District Total---,354,"","",NKCES,905,05,25,29,0,0,0,0,0,0,0,0,0,1,3,4,0,0,0,3,0,3,25,22,47,54
20192020,059,KENTON,354,Ludlow Independent,"",---District Total---,354,"","",NKCES,905,06,35,31,2,0,2,1,0,1,0,0,0,1,2,3,0,0,0,1,5,6,26,28,54,66
20192020,059,KENTON,354,Ludlow Independent,"",---District Total---,354,"","",NKCES,905,07,32,31,1,1,2,0,0,0,0,1,1,0,3,3,0,0,0,4,3,7,26,24,50,63
20192020,059,KENTON,354,Ludlow Independent,"",---District Total---,354,"","",NKCES,905,08,38,31,0,1,1,0,0,0,0,0,0,0,0,0,0,0,0,2,3,5,29,34,63,69
20192020,059,KENTON,354,Ludlow Independent,"",---District Total---,354,"","",NKCES,905,09,26,43,0,0,0,0,0,0,0,1,1,3,1,4,0,0,0,3,1,4,37,23,60,69
20192020,059,KENTON,354,Ludlow Independent,"",---District Total---,354,"","",NKCES,905,10,24,35,1,0,1,0,0,0,0,0,0,1,0,1,0,0,0,2,1,3,31,23,54,59
20192020,059,KENTON,354,Ludlow Independent,"",---District Total---,354,"","",NKCES,905,11,35,39,1,0,1,0,0,0,0,0,0,2,1,3,0,0,0,2,2,4,34,32,66,74
20192020,059,KENTON,354,Ludlow Independent,"",---District Total---,354,"","",NKCES,905,12,26,25,1,0,1,0,0,0,0,0,0,1,1,2,0,0,0,1,1,2,22,24,46,51
20192020,059,KENTON,354,Ludlow Independent,010,Mary A. Goetz Elementary School,354010,059354010,210363000938,NKCES,905,PS,29,26,1,0,1,0,0,0,0,0,0,1,2,3,0,0,0,3,4,7,21,23,44,55
20192020,059,KENTON,354,Ludlow Independent,010,Mary A. Goetz Elementary School,354010,059354010,210363000938,NKCES,905,All Students,202,205,8,2,10,1,0,1,0,0,0,10,10,20,1,0,1,14,11,25,171,179,350,407
20192020,059,KENTON,354,Ludlow Independent,010,Mary A. Goetz Elementary School,354010,059354010,210363000938,NKCES,905,KG,26,28,2,0,2,0,0,0,0,0,0,2,1,3,0,0,0,2,1,3,22,24,46,54
20192020,059,KENTON,354,Ludlow Independent,010,Mary A. Goetz Elementary School,354010,059354010,210363000938,NKCES,905,01,30,41,2,0,2,0,0,0,0,0,0,2,0,2,0,0,0,4,1,5,33,29,62,71
20192020,059,KENTON,354,Ludlow Independent,010,Mary A. Goetz Elementary School,354010,059354010,210363000938,NKCES,905,02,23,22,1,0,1,0,0,0,0,0,0,2,2,4,0,0,0,3,1,4,16,20,36,45
20192020,059,KENTON,354,Ludlow Independent,010,Mary A. Goetz Elementary School,354010,059354010,210363000938,NKCES,905,03,36,28,1,2,3,0,0,0,0,0,0,1,0,1,1,0,1,0,3,3,25,31,56,64
20192020,059,KENTON,354,Ludlow Independent,010,Mary A. Goetz Elementary School,354010,059354010,210363000938,NKCES,905,04,27,26,0,0,0,0,0,0,0,0,0,1,2,3,0,0,0,1,0,1,24,25,49,53
20192020,059,KENTON,354,Ludlow Independent,010,Mary A. Goetz Elementary School,354010,059354010,210363000938,NKCES,905,05,25,29,0,0,0,0,0,0,0,0,0,1,3,4,0,0,0,3,0,3,25,22,47,54
20192020,059,KENTON,354,Ludlow Independent,010,Mary A. Goetz Elementary School,354010,059354010,210363000938,NKCES,905,06,35,31,2,0,2,1,0,1,0,0,0,1,2,3,0,0,0,1,5,6,26,28,54,66
20192020,059,KENTON,354,Ludlow Independent,020,Ludlow High School,354020,059354020,210363000939,NKCES,905,14,1,0,0,0,0,0,0,0,0,0,0,0,0,0,0,0,0,0,0,0,0,1,1,1
20192020,059,KENTON,354,Ludlow Independent,020,Ludlow High School,354020,059354020,210363000939,NKCES,905,All Students,182,204,4,2,6,0,0,0,0,2,2,7,6,13,0,0,0,14,11,25,179,161,340,386
20192020,059,KENTON,354,Ludlow Independent,020,Ludlow High School,354020,059354020,210363000939,NKCES,905,08,38,31,0,1,1,0,0,0,0,0,0,0,0,0,0,0,0,2,3,5,29,34,63,69
20192020,059,KENTON,354,Ludlow Independent,020,Ludlow High School,354020,059354020,210363000939,NKCES,905,09,26,43,0,0,0,0,0,0,0,1,1,3,1,4,0,0,0,3,1,4,37,23,60,69
20192020,059,KENTON,354,Ludlow Independent,020,Ludlow High School,354020,059354020,210363000939,NKCES,905,10,24,35,1,0,1,0,0,0,0,0,0,1,0,1,0,0,0,2,1,3,31,23,54,59
20192020,059,KENTON,354,Ludlow Independent,020,Ludlow High School,354020,059354020,210363000939,NKCES,905,07,32,31,1,1,2,0,0,0,0,1,1,0,3,3,0,0,0,4,3,7,26,24,50,63
20192020,059,KENTON,354,Ludlow Independent,020,Ludlow High School,354020,059354020,210363000939,NKCES,905,11,35,39,1,0,1,0,0,0,0,0,0,2,1,3,0,0,0,2,2,4,34,32,66,74
20192020,059,KENTON,354,Ludlow Independent,020,Ludlow High School,354020,059354020,210363000939,NKCES,905,12,26,25,1,0,1,0,0,0,0,0,0,1,1,2,0,0,0,1,1,2,22,24,46,51
20192020,072,LYON,361,Lyon County,"",---District Total---,361,"","",WKEC,908,05,44,34,0,4,4,0,0,0,0,2,2,0,1,1,0,1,1,5,2,7,29,34,63,78
20192020,072,LYON,361,Lyon County,"",---District Total---,361,"","",WKEC,908,06,20,54,2,0,2,0,0,0,0,0,0,1,0,1,1,0,1,1,3,4,49,17,66,74
20192020,072,LYON,361,Lyon County,"",---District Total---,361,"","",WKEC,908,07,35,34,1,1,2,0,0,0,1,0,1,2,1,3,0,0,0,1,3,4,29,30,59,69
20192020,072,LYON,361,Lyon County,"",---District Total---,361,"","",WKEC,908,08,43,43,0,4,4,0,0,0,1,0,1,4,0,4,0,0,0,1,1,2,37,38,75,86
20192020,072,LYON,361,Lyon County,"",---District Total---,361,"","",WKEC,908,09,39,37,1,0,1,0,0,0,1,2,3,2,1,3,0,0,0,2,0,2,31,36,67,76
20192020,072,LYON,361,Lyon County,"",---District Total---,361,"","",WKEC,908,10,33,28,0,1,1,0,0,0,0,0,0,1,2,3,0,1,1,0,2,2,27,27,54,61
20192020,072,LYON,361,Lyon County,"",---District Total---,361,"","",WKEC,908,11,34,38,0,2,2,0,0,0,0,0,0,0,0,0,0,0,0,0,2,2,38,30,68,72
20192020,072,LYON,361,Lyon County,"",---District Total---,361,"","",WKEC,908,14,1,0,0,0,0,0,0,0,0,0,0,0,1,1,0,0,0,0,0,0,0,0,0,1
20192020,072,LYON,361,Lyon County,"",---District Total---,361,"","",WKEC,908,12,34,24,1,1,2,0,0,0,1,1,2,1,1,2,0,0,0,0,1,1,21,30,51,58
20192020,072,LYON,361,Lyon County,"",---District Total---,361,"","",WKEC,908,All Students,431,456,11,16,27,2,1,3,6,5,11,21,12,33,1,2,3,14,19,33,401,376,777,887
20192020,072,LYON,361,Lyon County,"",---District Total---,361,"","",WKEC,908,PS,27,39,1,1,2,0,0,0,0,0,0,0,1,1,0,0,0,1,1,2,37,24,61,66
20192020,072,LYON,361,Lyon County,"",---District Total---,361,"","",WKEC,908,KG,30,33,1,0,1,0,0,0,1,0,1,2,1,3,0,0,0,1,2,3,28,27,55,63
20192020,072,LYON,361,Lyon County,"",---District Total---,361,"","",WKEC,908,01,38,32,2,2,4,0,0,0,0,0,0,1,2,3,0,0,0,1,1,2,28,33,61,70
20192020,072,LYON,361,Lyon County,"",---District Total---,361,"","",WKEC,908,02,25,25,1,1,2,0,1,1,0,0,0,3,0,3,0,0,0,0,0,0,21,23,44,50
20192020,072,LYON,361,Lyon County,"",---District Total---,361,"","",WKEC,908,03,26,35,2,0,2,1,0,1,0,0,0,3,0,3,0,0,0,1,1,2,28,25,53,61
20192020,072,LYON,361,Lyon County,"",---District Total---,361,"","",WKEC,908,04,29,39,0,0,0,1,0,1,1,0,1,1,2,3,0,0,0,1,1,2,35,26,61,68
20192020,072,LYON,361,Lyon County,020,Lyon County Elementary School,361020,072361020,210369000942,WKEC,908,02,25,25,1,1,2,0,1,1,0,0,0,3,0,3,0,0,0,0,0,0,21,23,44,50
20192020,072,LYON,361,Lyon County,020,Lyon County Elementary School,361020,072361020,210369000942,WKEC,908,04,29,39,0,0,0,1,0,1,1,0,1,1,2,3,0,0,0,1,1,2,35,26,61,68
20192020,072,LYON,361,Lyon County,020,Lyon County Elementary School,361020,072361020,210369000942,WKEC,908,05,44,34,0,4,4,0,0,0,0,2,2,0,1,1,0,1,1,5,2,7,29,34,63,78
20192020,072,LYON,361,Lyon County,020,Lyon County Elementary School,361020,072361020,210369000942,WKEC,908,All Students,192,198,6,7,13,2,1,3,2,2,4,10,6,16,0,1,1,9,7,16,169,168,337,390
20192020,072,LYON,361,Lyon County,020,Lyon County Elementary School,361020,072361020,210369000942,WKEC,908,PS,27,39,1,1,2,0,0,0,0,0,0,0,1,1,0,0,0,1,1,2,37,24,61,66
20192020,072,LYON,361,Lyon County,020,Lyon County Elementary School,361020,072361020,210369000942,WKEC,908,KG,30,33,1,0,1,0,0,0,1,0,1,2,1,3,0,0,0,1,2,3,28,27,55,63
20192020,072,LYON,361,Lyon County,020,Lyon County Elementary School,361020,072361020,210369000942,WKEC,908,01,38,32,2,2,4,0,0,0,0,0,0,1,2,3,0,0,0,1,1,2,28,33,61,70
20192020,072,LYON,361,Lyon County,020,Lyon County Elementary School,361020,072361020,210369000942,WKEC,908,03,26,35,2,0,2,1,0,1,0,0,0,3,0,3,0,0,0,1,1,2,28,25,53,61
20192020,072,LYON,361,Lyon County,023,Lyon County Middle School,361023,072361023,210369001950,WKEC,908,All Students,98,131,3,5,8,0,0,0,2,0,2,7,1,8,1,0,1,3,7,10,115,85,200,229
20192020,072,LYON,361,Lyon County,023,Lyon County Middle School,361023,072361023,210369001950,WKEC,908,08,43,43,0,4,4,0,0,0,1,0,1,4,0,4,0,0,0,1,1,2,37,38,75,86
20192020,072,LYON,361,Lyon County,023,Lyon County Middle School,361023,072361023,210369001950,WKEC,908,06,20,54,2,0,2,0,0,0,0,0,0,1,0,1,1,0,1,1,3,4,49,17,66,74
20192020,072,LYON,361,Lyon County,023,Lyon County Middle School,361023,072361023,210369001950,WKEC,908,07,35,34,1,1,2,0,0,0,1,0,1,2,1,3,0,0,0,1,3,4,29,30,59,69
20192020,072,LYON,361,Lyon County,070,Lyon County High School,361070,072361070,210369000943,WKEC,908,11,34,38,0,2,2,0,0,0,0,0,0,0,0,0,0,0,0,0,2,2,38,30,68,72
20192020,072,LYON,361,Lyon County,070,Lyon County High School,361070,072361070,210369000943,WKEC,908,All Students,141,127,2,4,6,0,0,0,2,3,5,4,5,9,0,1,1,2,5,7,117,123,240,268
20192020,072,LYON,361,Lyon County,070,Lyon County High School,361070,072361070,210369000943,WKEC,908,09,39,37,1,0,1,0,0,0,1,2,3,2,1,3,0,0,0,2,0,2,31,36,67,76
20192020,072,LYON,361,Lyon County,070,Lyon County High School,361070,072361070,210369000943,WKEC,908,10,33,28,0,1,1,0,0,0,0,0,0,1,2,3,0,1,1,0,2,2,27,27,54,61
20192020,072,LYON,361,Lyon County,070,Lyon County High School,361070,072361070,210369000943,WKEC,908,12,34,24,1,1,2,0,0,0,1,1,2,1,1,2,0,0,0,0,1,1,21,30,51,58
20192020,072,LYON,361,Lyon County,070,Lyon County High School,361070,072361070,210369000943,WKEC,908,14,1,0,0,0,0,0,0,0,0,0,0,0,1,1,0,0,0,0,0,0,0,0,0,1
20192020,073,MADISON,365,Madison County,"",---District Total---,365,"","",SESC,907,14,1,7,0,0,0,0,0,0,0,0,0,0,0,0,0,0,0,0,0,0,7,1,8,8
20192020,073,MADISON,365,Madison County,"",---District Total---,365,"","",SESC,907,All Students,5706,5830,227,220,447,6,15,21,58,60,118,314,258,572,3,4,7,284,293,577,4938,4856,9794,11536
20192020,073,MADISON,365,Madison County,"",---District Total---,365,"","",SESC,907,PS,117,182,13,7,20,0,0,0,2,0,2,9,4,13,0,0,0,8,2,10,150,104,254,299
20192020,073,MADISON,365,Madison County,"",---District Total---,365,"","",SESC,907,KG,430,389,16,17,33,0,0,0,2,8,10,14,20,34,1,0,1,23,25,48,333,360,693,819
20192020,073,MADISON,365,Madison County,"",---District Total---,365,"","",SESC,907,01,449,462,18,20,38,0,0,0,4,1,5,25,15,40,0,0,0,29,24,53,386,389,775,911
20192020,073,MADISON,365,Madison County,"",---District Total---,365,"","",SESC,907,02,398,412,11,14,25,0,3,3,4,0,4,20,11,31,0,0,0,18,16,34,359,354,713,810
20192020,073,MADISON,365,Madison County,"",---District Total---,365,"","",SESC,907,03,444,455,19,10,29,1,1,2,5,4,9,29,23,52,1,0,1,27,28,55,373,378,751,899
20192020,073,MADISON,365,Madison County,"",---District Total---,365,"","",SESC,907,04,415,433,20,13,33,0,0,0,4,2,6,22,20,42,0,0,0,24,17,41,363,363,726,848
20192020,073,MADISON,365,Madison County,"",---District Total---,365,"","",SESC,907,05,466,509,16,19,35,0,1,1,3,4,7,30,20,50,0,1,1,31,27,58,429,394,823,975
20192020,073,MADISON,365,Madison County,"",---District Total---,365,"","",SESC,907,06,487,459,16,17,33,0,0,0,3,5,8,27,23,50,0,1,1,11,21,32,402,420,822,946
20192020,073,MADISON,365,Madison County,"",---District Total---,365,"","",SESC,907,07,484,464,19,26,45,1,1,2,3,6,9,25,15,40,0,1,1,20,31,51,396,404,800,948
20192020,073,MADISON,365,Madison County,"",---District Total---,365,"","",SESC,907,08,453,501,15,12,27,1,1,2,4,6,10,31,25,56,0,1,1,25,20,45,425,388,813,954
20192020,073,MADISON,365,Madison County,"",---District Total---,365,"","",SESC,907,09,450,485,20,20,40,0,2,2,6,5,11,25,17,42,0,0,0,25,23,48,409,383,792,935
20192020,073,MADISON,365,Madison County,"",---District Total---,365,"","",SESC,907,10,407,445,19,7,26,1,3,4,5,4,9,22,25,47,0,0,0,14,25,39,384,343,727,852
20192020,073,MADISON,365,Madison County,"",---District Total---,365,"","",SESC,907,11,421,404,20,18,38,0,2,2,7,8,15,22,23,45,1,0,1,19,21,40,335,349,684,825
20192020,073,MADISON,365,Madison County,"",---District Total---,365,"","",SESC,907,12,401,405,18,27,45,2,1,3,8,7,15,22,21,43,0,0,0,18,15,33,337,330,667,806
20192020,073,MADISON,365,Madison County,007,Shannon Johnson Elementary School,365007,073365007,210372001901,SESC,907,04,44,40,1,0,1,0,0,0,0,0,0,1,2,3,0,0,0,2,2,4,36,40,76,84
20192020,073,MADISON,365,Madison County,007,Shannon Johnson Elementary School,365007,073365007,210372001901,SESC,907,All Students,313,305,4,3,7,0,0,0,3,2,5,8,8,16,1,0,1,16,7,23,273,293,566,618
20192020,073,MADISON,365,Madison County,007,Shannon Johnson Elementary School,365007,073365007,210372001901,SESC,907,PS,12,22,0,0,0,0,0,0,1,0,1,1,1,2,0,0,0,1,0,1,19,11,30,34
20192020,073,MADISON,365,Madison County,007,Shannon Johnson Elementary School,365007,073365007,210372001901,SESC,907,KG,82,74,0,3,3,0,0,0,0,1,1,2,2,4,0,0,0,3,2,5,69,74,143,156
20192020,073,MADISON,365,Madison County,007,Shannon Johnson Elementary School,365007,073365007,210372001901,SESC,907,01,39,48,0,0,0,0,0,0,1,0,1,1,1,2,0,0,0,2,0,2,44,38,82,87
20192020,073,MADISON,365,Madison County,007,Shannon Johnson Elementary School,365007,073365007,210372001901,SESC,907,02,54,42,1,0,1,0,0,0,1,0,1,2,1,3,0,0,0,1,1,2,37,52,89,96
20192020,073,MADISON,365,Madison County,007,Shannon Johnson Elementary School,365007,073365007,210372001901,SESC,907,03,41,50,1,0,1,0,0,0,0,0,0,2,1,3,1,0,1,2,0,2,44,40,84,91
20192020,073,MADISON,365,Madison County,007,Shannon Johnson Elementary School,365007,073365007,210372001901,SESC,907,05,53,51,1,0,1,0,0,0,1,1,2,0,1,1,0,0,0,6,2,8,43,49,92,104
20192020,073,MADISON,365,Madison County,008,Boonesborough Elementary,365008,073365008,210372002481,SESC,907,04,23,27,0,0,0,0,0,0,0,0,0,2,2,4,0,0,0,0,1,1,25,20,45,50
20192020,073,MADISON,365,Madison County,008,Boonesborough Elementary,365008,073365008,210372002481,SESC,907,All Students,203,201,4,5,9,0,0,0,0,1,1,14,8,22,0,0,0,15,6,21,168,183,351,404
20192020,073,MADISON,365,Madison County,008,Boonesborough Elementary,365008,073365008,210372002481,SESC,907,PS,18,13,1,0,1,0,0,0,0,0,0,0,0,0,0,0,0,1,0,1,11,18,29,31
20192020,073,MADISON,365,Madison County,008,Boonesborough Elementary,365008,073365008,210372002481,SESC,907,KG,34,26,0,2,2,0,0,0,0,0,0,1,0,1,0,0,0,4,1,5,21,31,52,60
20192020,073,MADISON,365,Madison County,008,Boonesborough Elementary,365008,073365008,210372002481,SESC,907,01,32,39,1,0,1,0,0,0,0,0,0,1,0,1,0,0,0,4,1,5,33,31,64,71
20192020,073,MADISON,365,Madison County,008,Boonesborough Elementary,365008,073365008,210372002481,SESC,907,02,36,32,0,1,1,0,0,0,0,0,0,1,2,3,0,0,0,1,0,1,30,33,63,68
20192020,073,MADISON,365,Madison County,008,Boonesborough Elementary,365008,073365008,210372002481,SESC,907,03,34,40,2,1,3,0,0,0,0,0,0,4,2,6,0,0,0,2,2,4,32,29,61,74
20192020,073,MADISON,365,Madison County,008,Boonesborough Elementary,365008,073365008,210372002481,SESC,907,05,44,37,1,1,2,0,0,0,0,1,1,5,2,7,0,0,0,4,1,5,27,39,66,81
20192020,073,MADISON,365,Madison County,010,Clark Moores Middle School,365010,073365010,210372000944,SESC,907,07,104,92,4,10,14,0,0,0,1,0,1,7,4,11,0,0,0,6,9,15,74,81,155,196
20192020,073,MADISON,365,Madison County,010,Clark Moores Middle School,365010,073365010,210372000944,SESC,907,All Students,288,290,11,15,26,0,0,0,1,1,2,19,19,38,0,0,0,17,20,37,242,233,475,578
20192020,073,MADISON,365,Madison County,010,Clark Moores Middle School,365010,073365010,210372000944,SESC,907,06,93,100,5,4,9,0,0,0,0,1,1,8,10,18,0,0,0,3,5,8,84,73,157,193
20192020,073,MADISON,365,Madison County,010,Clark Moores Middle School,365010,073365010,210372000944,SESC,907,08,91,98,2,1,3,0,0,0,0,0,0,4,5,9,0,0,0,8,6,14,84,79,163,189
20192020,073,MADISON,365,Madison County,015,Daniel Boone Elementary School,365015,073365015,210372000945,SESC,907,05,37,45,3,3,6,0,0,0,1,0,1,5,0,5,0,0,0,1,3,4,35,31,66,82
20192020,073,MADISON,365,Madison County,015,Daniel Boone Elementary School,365015,073365015,210372000945,SESC,907,All Students,239,229,20,24,44,1,0,1,7,3,10,26,13,39,0,0,0,14,14,28,161,185,346,468
20192020,073,MADISON,365,Madison County,015,Daniel Boone Elementary School,365015,073365015,210372000945,SESC,907,01,58,51,7,4,11,0,0,0,1,1,2,7,2,9,0,0,0,4,3,7,32,48,80,109
20192020,073,MADISON,365,Madison County,015,Daniel Boone Elementary School,365015,073365015,210372000945,SESC,907,02,49,47,4,5,9,0,0,0,2,0,2,5,3,8,0,0,0,2,2,4,34,39,73,96
20192020,073,MADISON,365,Madison County,015,Daniel Boone Elementary School,365015,073365015,210372000945,SESC,907,03,43,40,2,4,6,1,0,1,2,2,4,5,4,9,0,0,0,5,3,8,25,30,55,83
20192020,073,MADISON,365,Madison County,015,Daniel Boone Elementary School,365015,073365015,210372000945,SESC,907,04,52,46,4,8,12,0,0,0,1,0,1,4,4,8,0,0,0,2,3,5,35,37,72,98
20192020,073,MADISON,365,Madison County,018,Glenn R Marshall Elementary School,365018,073365018,210372002032,SESC,907,05,46,50,3,5,8,0,0,0,0,0,0,9,4,13,0,0,0,2,6,8,36,31,67,96
20192020,073,MADISON,365,Madison County,018,Glenn R Marshall Elementary School,365018,073365018,210372002032,SESC,907,All Students,194,233,14,11,25,0,1,1,0,0,0,21,19,40,0,0,0,12,23,35,186,140,326,427
20192020,073,MADISON,365,Madison County,018,Glenn R Marshall Elementary School,365018,073365018,210372002032,SESC,907,01,45,55,2,2,4,0,0,0,0,0,0,3,6,9,0,0,0,3,7,10,47,30,77,100
20192020,073,MADISON,365,Madison County,018,Glenn R Marshall Elementary School,365018,073365018,210372002032,SESC,907,02,29,39,3,2,5,0,1,1,0,0,0,3,2,5,0,0,0,2,2,4,31,22,53,68
20192020,073,MADISON,365,Madison County,018,Glenn R Marshall Elementary School,365018,073365018,210372002032,SESC,907,03,44,46,3,0,3,0,0,0,0,0,0,3,6,9,0,0,0,2,6,8,38,32,70,90
20192020,073,MADISON,365,Madison County,018,Glenn R Marshall Elementary School,365018,073365018,210372002032,SESC,907,04,30,43,3,2,5,0,0,0,0,0,0,3,1,4,0,0,0,3,2,5,34,25,59,73
20192020,073,MADISON,365,Madison County,020,Madison Middle School,365020,073365020,210372000250,SESC,907,07,104,93,6,9,15,0,0,0,1,2,3,7,4,11,0,1,1,6,9,15,73,79,152,197
20192020,073,MADISON,365,Madison County,020,Madison Middle School,365020,073365020,210372000250,SESC,907,All Students,274,277,17,19,36,1,0,1,4,3,7,29,14,43,0,3,3,17,19,36,209,216,425,551
20192020,073,MADISON,365,Madison County,020,Madison Middle School,365020,073365020,210372000250,SESC,907,06,99,101,6,5,11,0,0,0,1,0,1,13,5,18,0,1,1,4,4,8,77,84,161,200
20192020,073,MADISON,365,Madison County,020,Madison Middle School,365020,073365020,210372000250,SESC,907,08,71,83,5,5,10,1,0,1,2,1,3,9,5,14,0,1,1,7,6,13,59,53,112,154
20192020,073,MADISON,365,Madison County,021,B. Michael Caudill Middle School,365021,073365021,210372002217,SESC,907,07,85,101,5,6,11,0,0,0,0,1,1,3,1,4,0,0,0,2,8,10,91,69,160,186
20192020,073,MADISON,365,Madison County,021,B. Michael Caudill Middle School,365021,073365021,210372002217,SESC,907,All Students,299,304,13,10,23,0,1,1,1,3,4,15,14,29,0,0,0,10,19,29,265,252,517,603
20192020,073,MADISON,365,Madison County,021,B. Michael Caudill Middle School,365021,073365021,210372002217,SESC,907,06,100,84,3,3,6,0,0,0,1,0,1,3,4,7,0,0,0,3,7,10,74,86,160,184
20192020,073,MADISON,365,Madison County,021,B. Michael Caudill Middle School,365021,073365021,210372002217,SESC,907,08,114,119,5,1,6,0,1,1,0,2,2,9,9,18,0,0,0,5,4,9,100,97,197,233
20192020,073,MADISON,365,Madison County,030,Kingston Elementary School,365030,073365030,210372000946,SESC,907,PS,10,26,1,1,2,0,0,0,0,0,0,0,0,0,0,0,0,1,0,1,24,9,33,36
20192020,073,MADISON,365,Madison County,030,Kingston Elementary School,365030,073365030,210372000946,SESC,907,All Students,288,284,2,3,5,0,0,0,1,0,1,5,8,13,0,0,0,10,10,20,266,267,533,572
20192020,073,MADISON,365,Madison County,030,Kingston Elementary School,365030,073365030,210372000946,SESC,907,KG,51,52,0,0,0,0,0,0,0,0,0,1,0,1,0,0,0,5,1,6,46,50,96,103
20192020,073,MADISON,365,Madison County,030,Kingston Elementary School,365030,073365030,210372000946,SESC,907,01,57,45,0,0,0,0,0,0,0,0,0,1,0,1,0,0,0,1,1,2,43,56,99,102
20192020,073,MADISON,365,Madison County,030,Kingston Elementary School,365030,073365030,210372000946,SESC,907,02,44,44,0,1,1,0,0,0,0,0,0,1,0,1,0,0,0,1,2,3,42,41,83,88
20192020,073,MADISON,365,Madison County,030,Kingston Elementary School,365030,073365030,210372000946,SESC,907,03,51,45,1,0,1,0,0,0,1,0,1,1,4,5,0,0,0,1,2,3,41,45,86,96
20192020,073,MADISON,365,Madison County,030,Kingston Elementary School,365030,073365030,210372000946,SESC,907,04,47,48,0,0,0,0,0,0,0,0,0,0,2,2,0,0,0,2,2,4,46,43,89,95
20192020,073,MADISON,365,Madison County,030,Kingston Elementary School,365030,073365030,210372000946,SESC,907,05,38,50,1,2,3,0,0,0,0,0,0,1,2,3,0,0,0,0,2,2,48,32,80,88
20192020,073,MADISON,365,Madison County,040,Kirksville Elementary School,365040,073365040,210372000947,SESC,907,All Students,238,300,22,14,36,0,0,0,1,0,1,32,20,52,0,0,0,19,19,38,226,185,411,538
20192020,073,MADISON,365,Madison County,040,Kirksville Elementary School,365040,073365040,210372000947,SESC,907,KG,40,44,3,1,4,0,0,0,0,0,0,2,3,5,0,0,0,2,4,6,37,32,69,84
20192020,073,MADISON,365,Madison County,040,Kirksville Elementary School,365040,073365040,210372000947,SESC,907,01,49,43,2,6,8,0,0,0,0,0,0,5,2,7,0,0,0,3,3,6,33,38,71,92
20192020,073,MADISON,365,Madison County,040,Kirksville Elementary School,365040,073365040,210372000947,SESC,907,02,32,45,2,2,4,0,0,0,0,0,0,5,1,6,0,0,0,0,2,2,38,27,65,77
20192020,073,MADISON,365,Madison County,040,Kirksville Elementary School,365040,073365040,210372000947,SESC,907,03,41,55,5,1,6,0,0,0,1,0,1,8,3,11,0,0,0,7,5,12,34,32,66,96
20192020,073,MADISON,365,Madison County,040,Kirksville Elementary School,365040,073365040,210372000947,SESC,907,04,34,50,6,1,7,0,0,0,0,0,0,6,4,10,0,0,0,2,2,4,36,27,63,84
20192020,073,MADISON,365,Madison County,040,Kirksville Elementary School,365040,073365040,210372000947,SESC,907,05,42,63,4,3,7,0,0,0,0,0,0,6,7,13,0,0,0,5,3,8,48,29,77,105
20192020,073,MADISON,365,Madison County,040,Kirksville Elementary School,365040,073365040,210372000947,SESC,907,PS,14,19,2,2,4,0,0,0,0,0,0,2,0,2,0,0,0,0,1,1,15,11,26,33
20192020,073,MADISON,365,Madison County,045,Kit Carson Elementary School,365045,073365045,210372000948,SESC,907,05,69,67,2,3,5,0,0,0,0,1,1,1,4,5,0,1,1,5,5,10,59,55,114,136
20192020,073,MADISON,365,Madison County,045,Kit Carson Elementary School,365045,073365045,210372000948,SESC,907,03,55,40,3,2,5,0,0,0,1,0,1,2,0,2,0,0,0,3,8,11,31,45,76,95
20192020,073,MADISON,365,Madison County,045,Kit Carson Elementary School,365045,073365045,210372000948,SESC,907,04,52,39,2,2,4,0,0,0,2,0,2,2,3,5,0,0,0,3,1,4,30,46,76,91
20192020,073,MADISON,365,Madison County,045,Kit Carson Elementary School,365045,073365045,210372000948,SESC,907,All Students,266,234,12,9,21,0,0,0,4,1,5,9,8,17,0,1,1,21,16,37,188,231,419,500
20192020,073,MADISON,365,Madison County,045,Kit Carson Elementary School,365045,073365045,210372000948,SESC,907,01,45,45,5,2,7,0,0,0,1,0,1,3,0,3,0,0,0,4,1,5,32,42,74,90
20192020,073,MADISON,365,Madison County,045,Kit Carson Elementary School,365045,073365045,210372000948,SESC,907,02,45,43,0,0,0,0,0,0,0,0,0,1,1,2,0,0,0,6,1,7,36,43,79,88
20192020,073,MADISON,365,Madison County,050,Madison Central High School,365050,073365050,210372000949,SESC,907,11,266,231,16,17,33,0,2,2,4,5,9,17,18,35,1,0,1,16,12,28,177,212,389,497
20192020,073,MADISON,365,Madison County,050,Madison Central High School,365050,073365050,210372000949,SESC,907,14,1,4,0,0,0,0,0,0,0,0,0,0,0,0,0,0,0,0,0,0,4,1,5,5
20192020,073,MADISON,365,Madison County,050,Madison Central High School,365050,073365050,210372000949,SESC,907,All Students,1001,989,63,60,123,3,6,9,17,13,30,66,66,132,1,0,1,54,62,116,785,794,1579,1990
20192020,073,MADISON,365,Madison County,050,Madison Central High School,365050,073365050,210372000949,SESC,907,09,273,269,17,15,32,0,2,2,5,3,8,18,12,30,0,0,0,16,20,36,213,221,434,542
20192020,073,MADISON,365,Madison County,050,Madison Central High School,365050,073365050,210372000949,SESC,907,10,230,257,14,5,19,1,2,3,4,2,6,18,19,37,0,0,0,7,18,25,213,184,397,487
20192020,073,MADISON,365,Madison County,050,Madison Central High School,365050,073365050,210372000949,SESC,907,12,231,228,16,23,39,2,0,2,4,3,7,13,17,30,0,0,0,15,12,27,178,176,354,459
20192020,073,MADISON,365,Madison County,065,Bellevue Transitional School,365065,073365065,210372002084,SESC,907,12,0,1,0,0,0,0,0,0,0,0,0,0,0,0,0,0,0,1,0,1,0,0,0,1
20192020,073,MADISON,365,Madison County,065,Bellevue Transitional School,365065,073365065,210372002084,SESC,907,All Students,6,10,2,1,3,0,0,0,0,0,0,0,0,0,0,0,0,4,0,4,4,5,9,16
20192020,073,MADISON,365,Madison County,065,Bellevue Transitional School,365065,073365065,210372002084,SESC,907,06,1,1,0,0,0,0,0,0,0,0,0,0,0,0,0,0,0,0,0,0,1,1,2,2
20192020,073,MADISON,365,Madison County,065,Bellevue Transitional School,365065,073365065,210372002084,SESC,907,07,1,0,0,0,0,0,0,0,0,0,0,0,0,0,0,0,0,0,0,0,0,1,1,1
20192020,073,MADISON,365,Madison County,065,Bellevue Transitional School,365065,073365065,210372002084,SESC,907,09,0,4,1,0,1,0,0,0,0,0,0,0,0,0,0,0,0,1,0,1,2,0,2,4
20192020,073,MADISON,365,Madison County,065,Bellevue Transitional School,365065,073365065,210372002084,SESC,907,10,3,3,1,0,1,0,0,0,0,0,0,0,0,0,0,0,0,2,0,2,0,3,3,6
20192020,073,MADISON,365,Madison County,065,Bellevue Transitional School,365065,073365065,210372002084,SESC,907,11,1,1,0,1,1,0,0,0,0,0,0,0,0,0,0,0,0,0,0,0,1,0,1,2
20192020,073,MADISON,365,Madison County,100,Silver Creek Elementary School,365100,073365100,210372000950,SESC,907,05,43,43,1,0,1,0,1,1,0,0,0,1,0,1,0,0,0,2,3,5,39,39,78,86
20192020,073,MADISON,365,Madison County,100,Silver Creek Elementary School,365100,073365100,210372000950,SESC,907,All Students,190,191,3,0,3,0,3,3,1,0,1,5,5,10,0,0,0,8,6,14,174,176,350,381
20192020,073,MADISON,365,Madison County,100,Silver Creek Elementary School,365100,073365100,210372000950,SESC,907,PS,9,15,0,0,0,0,0,0,0,0,0,0,0,0,0,0,0,0,0,0,15,9,24,24
20192020,073,MADISON,365,Madison County,100,Silver Creek Elementary School,365100,073365100,210372000950,SESC,907,KG,1,0,0,0,0,0,0,0,0,0,0,0,1,1,0,0,0,0,0,0,0,0,0,1
20192020,073,MADISON,365,Madison County,100,Silver Creek Elementary School,365100,073365100,210372000950,SESC,907,01,33,30,0,0,0,0,0,0,0,0,0,0,1,1,0,0,0,1,0,1,29,32,61,63
20192020,073,MADISON,365,Madison County,100,Silver Creek Elementary School,365100,073365100,210372000950,SESC,907,02,29,39,0,0,0,0,2,2,0,0,0,0,1,1,0,0,0,0,1,1,39,25,64,68
20192020,073,MADISON,365,Madison County,100,Silver Creek Elementary School,365100,073365100,210372000950,SESC,907,03,43,38,0,0,0,0,0,0,0,0,0,3,1,4,0,0,0,3,1,4,32,41,73,81
20192020,073,MADISON,365,Madison County,100,Silver Creek Elementary School,365100,073365100,210372000950,SESC,907,04,41,41,2,0,2,0,0,0,1,0,1,1,1,2,0,0,0,2,1,3,35,39,74,82
20192020,073,MADISON,365,Madison County,110,Madison Kindergarten Academy,365110,073365110,210372002392,SESC,907,PS,37,67,9,4,13,0,0,0,1,0,1,5,3,8,0,0,0,5,1,6,47,29,76,104
20192020,073,MADISON,365,Madison County,110,Madison Kindergarten Academy,365110,073365110,210372002392,SESC,907,All Students,154,140,13,10,23,0,0,0,2,4,6,8,12,20,0,0,0,9,14,23,108,114,222,294
20192020,073,MADISON,365,Madison County,110,Madison Kindergarten Academy,365110,073365110,210372002392,SESC,907,KG,154,140,13,10,23,0,0,0,2,4,6,8,12,20,0,0,0,9,14,23,108,114,222,294
20192020,073,MADISON,365,Madison County,120,Waco Elementary School,365120,073365120,210372000951,SESC,907,04,34,40,0,0,0,0,0,0,0,0,0,0,0,0,0,0,0,3,0,3,37,34,71,74
20192020,073,MADISON,365,Madison County,120,Waco Elementary School,365120,073365120,210372000951,SESC,907,All Students,209,229,0,2,2,0,0,0,0,1,1,3,3,6,0,0,0,8,7,15,218,196,414,438
20192020,073,MADISON,365,Madison County,120,Waco Elementary School,365120,073365120,210372000951,SESC,907,PS,17,20,0,0,0,0,0,0,0,0,0,1,0,1,0,0,0,0,0,0,19,17,36,37
20192020,073,MADISON,365,Madison County,120,Waco Elementary School,365120,073365120,210372000951,SESC,907,KG,39,34,0,1,1,0,0,0,0,0,0,0,1,1,0,0,0,0,2,2,34,35,69,73
20192020,073,MADISON,365,Madison County,120,Waco Elementary School,365120,073365120,210372000951,SESC,907,01,33,42,0,0,0,0,0,0,0,0,0,1,1,2,0,0,0,2,2,4,39,30,69,75
20192020,073,MADISON,365,Madison County,120,Waco Elementary School,365120,073365120,210372000951,SESC,907,02,32,31,0,0,0,0,0,0,0,0,0,1,0,1,0,0,0,1,2,3,29,30,59,63
20192020,073,MADISON,365,Madison County,120,Waco Elementary School,365120,073365120,210372000951,SESC,907,03,33,40,0,1,1,0,0,0,0,1,1,0,1,1,0,0,0,0,0,0,40,30,70,73
20192020,073,MADISON,365,Madison County,120,Waco Elementary School,365120,073365120,210372000951,SESC,907,05,38,42,0,0,0,0,0,0,0,0,0,1,0,1,0,0,0,2,1,3,39,37,76,80
20192020,073,MADISON,365,Madison County,130,White Hall Elementary School,365130,073365130,210372000952,SESC,907,04,36,34,1,0,1,0,0,0,0,0,0,3,1,4,0,0,0,3,2,5,27,33,60,70
20192020,073,MADISON,365,Madison County,130,White Hall Elementary School,365130,073365130,210372000952,SESC,907,All Students,158,172,4,6,10,0,0,0,1,0,1,7,2,9,0,0,0,16,9,25,144,141,285,330
20192020,073,MADISON,365,Madison County,130,White Hall Elementary School,365130,073365130,210372000952,SESC,907,01,27,40,1,3,4,0,0,0,0,0,0,2,0,2,0,0,0,5,4,9,32,20,52,67
20192020,073,MADISON,365,Madison County,130,White Hall Elementary School,365130,073365130,210372000952,SESC,907,02,22,28,0,1,1,0,0,0,0,0,0,1,0,1,0,0,0,3,2,5,24,19,43,50
20192020,073,MADISON,365,Madison County,130,White Hall Elementary School,365130,073365130,210372000952,SESC,907,03,38,35,2,0,2,0,0,0,0,0,0,0,1,1,0,0,0,2,1,3,31,36,67,73
20192020,073,MADISON,365,Madison County,130,White Hall Elementary School,365130,073365130,210372000952,SESC,907,05,35,35,0,2,2,0,0,0,1,0,1,1,0,1,0,0,0,3,0,3,30,33,63,70
20192020,073,MADISON,365,Madison County,140,Foley Middle School,365140,073365140,210372000953,SESC,907,07,82,68,1,0,1,0,1,1,0,2,2,5,2,7,0,0,0,3,4,7,59,73,132,150
20192020,073,MADISON,365,Madison County,140,Foley Middle School,365140,073365140,210372000953,SESC,907,All Students,240,215,4,3,7,0,1,1,0,4,4,12,7,19,0,0,0,7,6,13,192,219,411,455
20192020,073,MADISON,365,Madison County,140,Foley Middle School,365140,073365140,210372000953,SESC,907,06,84,70,0,2,2,0,0,0,0,2,2,1,1,2,0,0,0,1,2,3,68,77,145,154
20192020,073,MADISON,365,Madison County,140,Foley Middle School,365140,073365140,210372000953,SESC,907,08,74,77,3,1,4,0,0,0,0,0,0,6,4,10,0,0,0,3,0,3,65,69,134,151
20192020,073,MADISON,365,Madison County,145,Farristown Middle School,365145,073365145,210372002311,SESC,907,07,85,75,3,0,3,0,0,0,0,0,0,2,4,6,0,0,0,3,1,4,67,80,147,160
20192020,073,MADISON,365,Madison County,145,Farristown Middle School,365145,073365145,210372002311,SESC,907,All Students,239,225,4,4,8,0,0,0,0,1,1,6,8,14,0,0,0,3,5,8,212,221,433,464
20192020,073,MADISON,365,Madison County,145,Farristown Middle School,365145,073365145,210372002311,SESC,907,06,77,70,1,2,3,0,0,0,0,0,0,2,2,4,0,0,0,0,2,2,67,71,138,147
20192020,073,MADISON,365,Madison County,145,Farristown Middle School,365145,073365145,210372002311,SESC,907,08,77,80,0,2,2,0,0,0,0,1,1,2,2,4,0,0,0,0,2,2,78,70,148,157
20192020,073,MADISON,365,Madison County,150,Madison Southern High School,365150,073365150,210372001594,SESC,907,12,156,142,1,2,3,0,1,1,1,0,1,9,4,13,0,0,0,1,3,4,130,146,276,298
20192020,073,MADISON,365,Madison County,150,Madison Southern High School,365150,073365150,210372001594,SESC,907,All Students,580,615,8,6,14,0,1,1,3,2,5,24,19,43,0,0,0,11,17,28,569,535,1104,1195
20192020,073,MADISON,365,Madison County,150,Madison Southern High School,365150,073365150,210372001594,SESC,907,09,144,173,2,3,5,0,0,0,0,1,1,6,5,11,0,0,0,3,1,4,162,134,296,317
20192020,073,MADISON,365,Madison County,150,Madison Southern High School,365150,073365150,210372001594,SESC,907,10,142,153,2,1,3,0,0,0,0,1,1,4,5,9,0,0,0,5,6,11,142,129,271,295
20192020,073,MADISON,365,Madison County,150,Madison Southern High School,365150,073365150,210372001594,SESC,907,11,138,144,3,0,3,0,0,0,2,0,2,5,5,10,0,0,0,2,7,9,132,126,258,282
20192020,073,MADISON,365,Madison County,150,Madison Southern High School,365150,073365150,210372001594,SESC,907,14,0,3,0,0,0,0,0,0,0,0,0,0,0,0,0,0,0,0,0,0,3,0,3,3
20192020,073,MADISON,365,Madison County,160,Madison County Day Treatment,365160,073365160,210372001678,SESC,907,11,0,1,1,0,1,0,0,0,0,0,0,0,0,0,0,0,0,0,0,0,0,0,0,1
20192020,073,MADISON,365,Madison County,160,Madison County Day Treatment,365160,073365160,210372001678,SESC,907,All Students,2,18,3,1,4,0,0,0,0,0,0,1,0,1,0,0,0,1,0,1,13,1,14,20
20192020,073,MADISON,365,Madison County,160,Madison County Day Treatment,365160,073365160,210372001678,SESC,907,06,0,1,0,0,0,0,0,0,0,0,0,0,0,0,0,0,0,0,0,0,1,0,1,1
20192020,073,MADISON,365,Madison County,160,Madison County Day Treatment,365160,073365160,210372001678,SESC,907,07,0,2,0,0,0,0,0,0,0,0,0,1,0,1,0,0,0,0,0,0,1,0,1,2
20192020,073,MADISON,365,Madison County,160,Madison County Day Treatment,365160,073365160,210372001678,SESC,907,08,0,3,0,0,0,0,0,0,0,0,0,0,0,0,0,0,0,0,0,0,3,0,3,3
20192020,073,MADISON,365,Madison County,160,Madison County Day Treatment,365160,073365160,210372001678,SESC,907,09,1,6,0,1,1,0,0,0,0,0,0,0,0,0,0,0,0,1,0,1,5,0,5,7
20192020,073,MADISON,365,Madison County,160,Madison County Day Treatment,365160,073365160,210372001678,SESC,907,10,1,3,1,0,1,0,0,0,0,0,0,0,0,0,0,0,0,0,0,0,2,1,3,4
20192020,073,MADISON,365,Madison County,160,Madison County Day Treatment,365160,073365160,210372001678,SESC,907,12,0,2,1,0,1,0,0,0,0,0,0,0,0,0,0,0,0,0,0,0,1,0,1,2
20192020,073,MADISON,365,Madison County,450,Model Laboratory Elementary School,365450,073365450,210372001485,SESC,907,All Students,150,142,2,6,8,0,1,1,2,7,9,2,3,5,1,0,1,4,6,10,131,127,258,292
20192020,073,MADISON,365,Madison County,450,Model Laboratory Elementary School,365450,073365450,210372001485,SESC,907,KG,29,19,0,0,0,0,0,0,0,3,3,0,1,1,1,0,1,0,1,1,18,24,42,48
20192020,073,MADISON,365,Madison County,450,Model Laboratory Elementary School,365450,073365450,210372001485,SESC,907,01,31,24,0,3,3,0,0,0,1,0,1,1,2,3,0,0,0,0,2,2,22,24,46,55
20192020,073,MADISON,365,Madison County,450,Model Laboratory Elementary School,365450,073365450,210372001485,SESC,907,02,26,22,1,2,3,0,0,0,1,0,1,0,0,0,0,0,0,1,1,2,19,23,42,48
20192020,073,MADISON,365,Madison County,450,Model Laboratory Elementary School,365450,073365450,210372001485,SESC,907,03,21,26,0,1,1,0,1,1,0,1,1,1,0,1,0,0,0,0,0,0,25,18,43,47
20192020,073,MADISON,365,Madison County,450,Model Laboratory Elementary School,365450,073365450,210372001485,SESC,907,04,22,25,1,0,1,0,0,0,0,2,2,0,0,0,0,0,0,2,1,3,22,19,41,47
20192020,073,MADISON,365,Madison County,450,Model Laboratory Elementary School,365450,073365450,210372001485,SESC,907,05,21,26,0,0,0,0,0,0,0,1,1,0,0,0,0,0,0,1,1,2,25,19,44,47
20192020,073,MADISON,365,Madison County,460,Model Laboratory High School,365460,073365460,210372001486,SESC,907,12,14,32,0,2,2,0,0,0,3,4,7,0,0,0,0,0,0,1,0,1,28,8,36,46
20192020,073,MADISON,365,Madison County,460,Model Laboratory High School,365460,073365460,210372001486,SESC,907,11,16,27,0,0,0,0,0,0,1,3,4,0,0,0,0,0,0,1,2,3,25,11,36,43
20192020,073,MADISON,365,Madison County,460,Model Laboratory High School,365460,073365460,210372001486,SESC,907,All Students,175,227,2,8,10,1,1,2,10,14,24,2,2,4,0,0,0,8,8,16,204,142,346,402
20192020,073,MADISON,365,Madison County,460,Model Laboratory High School,365460,073365460,210372001486,SESC,907,06,33,32,1,1,2,0,0,0,1,2,3,0,1,1,0,0,0,0,1,1,30,28,58,65
20192020,073,MADISON,365,Madison County,460,Model Laboratory High School,365460,073365460,210372001486,SESC,907,07,23,33,0,1,1,1,0,1,1,1,2,0,0,0,0,0,0,0,0,0,31,21,52,56
20192020,073,MADISON,365,Madison County,460,Model Laboratory High School,365460,073365460,210372001486,SESC,907,08,26,41,0,2,2,0,0,0,2,2,4,1,0,1,0,0,0,2,2,4,36,20,56,67
20192020,073,MADISON,365,Madison County,460,Model Laboratory High School,365460,073365460,210372001486,SESC,907,09,32,33,0,1,1,0,0,0,1,1,2,1,0,1,0,0,0,4,2,6,27,28,55,65
20192020,073,MADISON,365,Madison County,460,Model Laboratory High School,365460,073365460,210372001486,SESC,907,10,31,29,1,1,2,0,1,1,1,1,2,0,1,1,0,0,0,0,1,1,27,26,53,60
20192020,074,MAGOFFIN,371,Magoffin County,"",---District Total---,371,"","",KVEC,904,10,69,76,0,0,0,0,0,0,0,0,0,0,0,0,0,0,0,0,1,1,76,68,144,145
20192020,074,MAGOFFIN,371,Magoffin County,"",---District Total---,371,"","",KVEC,904,All Students,891,1015,3,0,3,0,0,0,1,0,1,10,6,16,0,1,1,9,2,11,992,882,1874,1906
20192020,074,MAGOFFIN,371,Magoffin County,"",---District Total---,371,"","",KVEC,904,KG,68,71,0,0,0,0,0,0,0,0,0,1,1,2,0,0,0,0,0,0,70,67,137,139
20192020,074,MAGOFFIN,371,Magoffin County,"",---District Total---,371,"","",KVEC,904,01,63,94,0,0,0,0,0,0,0,0,0,1,3,4,0,0,0,0,0,0,93,60,153,157
20192020,074,MAGOFFIN,371,Magoffin County,"",---District Total---,371,"","",KVEC,904,02,81,74,0,0,0,0,0,0,0,0,0,2,0,2,0,0,0,1,0,1,71,81,152,155
20192020,074,MAGOFFIN,371,Magoffin County,"",---District Total---,371,"","",KVEC,904,03,56,74,1,0,1,0,0,0,0,0,0,0,0,0,0,1,1,2,1,3,71,54,125,130
20192020,074,MAGOFFIN,371,Magoffin County,"",---District Total---,371,"","",KVEC,904,04,55,86,0,0,0,0,0,0,0,0,0,0,0,0,0,0,0,1,0,1,85,55,140,141
20192020,074,MAGOFFIN,371,Magoffin County,"",---District Total---,371,"","",KVEC,904,05,66,65,0,0,0,0,0,0,0,0,0,0,1,1,0,0,0,2,0,2,63,65,128,131
20192020,074,MAGOFFIN,371,Magoffin County,"",---District Total---,371,"","",KVEC,904,06,72,80,0,0,0,0,0,0,0,0,0,1,1,2,0,0,0,1,0,1,78,71,149,152
20192020,074,MAGOFFIN,371,Magoffin County,"",---District Total---,371,"","",KVEC,904,07,72,88,0,0,0,0,0,0,0,0,0,1,0,1,0,0,0,2,0,2,85,72,157,160
20192020,074,MAGOFFIN,371,Magoffin County,"",---District Total---,371,"","",KVEC,904,08,69,90,0,0,0,0,0,0,1,0,1,2,0,2,0,0,0,0,0,0,87,69,156,159
20192020,074,MAGOFFIN,371,Magoffin County,"",---District Total---,371,"","",KVEC,904,09,83,75,0,0,0,0,0,0,0,0,0,2,0,2,0,0,0,0,0,0,73,83,156,158
20192020,074,MAGOFFIN,371,Magoffin County,"",---District Total---,371,"","",KVEC,904,11,71,69,0,0,0,0,0,0,0,0,0,0,0,0,0,0,0,0,0,0,69,71,140,140
20192020,074,MAGOFFIN,371,Magoffin County,"",---District Total---,371,"","",KVEC,904,12,66,73,2,0,2,0,0,0,0,0,0,0,0,0,0,0,0,0,0,0,71,66,137,139
20192020,074,MAGOFFIN,371,Magoffin County,172,North Magoffin Elementary,371172,074371172,210375002238,KVEC,904,06,30,26,0,0,0,0,0,0,0,0,0,0,0,0,0,0,0,0,0,0,26,30,56,56
20192020,074,MAGOFFIN,371,Magoffin County,172,North Magoffin Elementary,371172,074371172,210375002238,KVEC,904,All Students,192,210,0,0,0,0,0,0,0,0,0,1,2,3,0,0,0,1,0,1,208,190,398,402
20192020,074,MAGOFFIN,371,Magoffin County,172,North Magoffin Elementary,371172,074371172,210375002238,KVEC,904,KG,34,35,0,0,0,0,0,0,0,0,0,1,0,1,0,0,0,0,0,0,34,34,68,69
20192020,074,MAGOFFIN,371,Magoffin County,172,North Magoffin Elementary,371172,074371172,210375002238,KVEC,904,01,31,37,0,0,0,0,0,0,0,0,0,0,2,2,0,0,0,0,0,0,37,29,66,68
20192020,074,MAGOFFIN,371,Magoffin County,172,North Magoffin Elementary,371172,074371172,210375002238,KVEC,904,02,25,31,0,0,0,0,0,0,0,0,0,0,0,0,0,0,0,0,0,0,31,25,56,56
20192020,074,MAGOFFIN,371,Magoffin County,172,North Magoffin Elementary,371172,074371172,210375002238,KVEC,904,03,21,28,0,0,0,0,0,0,0,0,0,0,0,0,0,0,0,1,0,1,27,21,48,49
20192020,074,MAGOFFIN,371,Magoffin County,172,North Magoffin Elementary,371172,074371172,210375002238,KVEC,904,04,22,34,0,0,0,0,0,0,0,0,0,0,0,0,0,0,0,0,0,0,34,22,56,56
20192020,074,MAGOFFIN,371,Magoffin County,172,North Magoffin Elementary,371172,074371172,210375002238,KVEC,904,05,29,19,0,0,0,0,0,0,0,0,0,0,0,0,0,0,0,0,0,0,19,29,48,48
20192020,074,MAGOFFIN,371,Magoffin County,173,South Magoffin Elementary,371173,074371173,210375002227,KVEC,904,04,8,12,0,0,0,0,0,0,0,0,0,0,0,0,0,0,0,1,0,1,11,8,19,20
20192020,074,MAGOFFIN,371,Magoffin County,173,South Magoffin Elementary,371173,074371173,210375002227,KVEC,904,All Students,75,89,0,0,0,0,0,0,0,0,0,1,1,2,0,0,0,2,1,3,86,73,159,164
20192020,074,MAGOFFIN,371,Magoffin County,173,South Magoffin Elementary,371173,074371173,210375002227,KVEC,904,KG,12,11,0,0,0,0,0,0,0,0,0,0,0,0,0,0,0,0,0,0,11,12,23,23
20192020,074,MAGOFFIN,371,Magoffin County,173,South Magoffin Elementary,371173,074371173,210375002227,KVEC,904,01,8,18,0,0,0,0,0,0,0,0,0,0,1,1,0,0,0,0,0,0,18,7,25,26
20192020,074,MAGOFFIN,371,Magoffin County,173,South Magoffin Elementary,371173,074371173,210375002227,KVEC,904,02,15,14,0,0,0,0,0,0,0,0,0,1,0,1,0,0,0,0,0,0,13,15,28,29
20192020,074,MAGOFFIN,371,Magoffin County,173,South Magoffin Elementary,371173,074371173,210375002227,KVEC,904,03,12,17,0,0,0,0,0,0,0,0,0,0,0,0,0,0,0,1,1,2,16,11,27,29
20192020,074,MAGOFFIN,371,Magoffin County,173,South Magoffin Elementary,371173,074371173,210375002227,KVEC,904,05,13,7,0,0,0,0,0,0,0,0,0,0,0,0,0,0,0,0,0,0,7,13,20,20
20192020,074,MAGOFFIN,371,Magoffin County,173,South Magoffin Elementary,371173,074371173,210375002227,KVEC,904,06,7,10,0,0,0,0,0,0,0,0,0,0,0,0,0,0,0,0,0,0,10,7,17,17
20192020,074,MAGOFFIN,371,Magoffin County,175,Herald Whitaker Middle School,371175,074371175,210375001618,KVEC,904,07,72,87,0,0,0,0,0,0,0,0,0,1,0,1,0,0,0,2,0,2,84,72,156,159
20192020,074,MAGOFFIN,371,Magoffin County,175,Herald Whitaker Middle School,371175,074371175,210375001618,KVEC,904,All Students,140,177,0,0,0,0,0,0,1,0,1,3,0,3,0,0,0,2,0,2,171,140,311,317
20192020,074,MAGOFFIN,371,Magoffin County,175,Herald Whitaker Middle School,371175,074371175,210375001618,KVEC,904,08,68,90,0,0,0,0,0,0,1,0,1,2,0,2,0,0,0,0,0,0,87,68,155,158
20192020,074,MAGOFFIN,371,Magoffin County,360,Salyersville Grade School,371360,074371360,210375000958,KVEC,904,All Students,194,245,1,0,1,0,0,0,0,0,0,3,3,6,0,1,1,4,0,4,237,190,427,439
20192020,074,MAGOFFIN,371,Magoffin County,360,Salyersville Grade School,371360,074371360,210375000958,KVEC,904,KG,22,25,0,0,0,0,0,0,0,0,0,0,1,1,0,0,0,0,0,0,25,21,46,47
20192020,074,MAGOFFIN,371,Magoffin County,360,Salyersville Grade School,371360,074371360,210375000958,KVEC,904,01,24,39,0,0,0,0,0,0,0,0,0,1,0,1,0,0,0,0,0,0,38,24,62,63
20192020,074,MAGOFFIN,371,Magoffin County,360,Salyersville Grade School,371360,074371360,210375000958,KVEC,904,02,41,29,0,0,0,0,0,0,0,0,0,1,0,1,0,0,0,1,0,1,27,41,68,70
20192020,074,MAGOFFIN,371,Magoffin County,360,Salyersville Grade School,371360,074371360,210375000958,KVEC,904,03,23,29,1,0,1,0,0,0,0,0,0,0,0,0,0,1,1,0,0,0,28,22,50,52
20192020,074,MAGOFFIN,371,Magoffin County,360,Salyersville Grade School,371360,074371360,210375000958,KVEC,904,04,25,40,0,0,0,0,0,0,0,0,0,0,0,0,0,0,0,0,0,0,40,25,65,65
20192020,074,MAGOFFIN,371,Magoffin County,360,Salyersville Grade School,371360,074371360,210375000958,KVEC,904,05,24,39,0,0,0,0,0,0,0,0,0,0,1,1,0,0,0,2,0,2,37,23,60,63
20192020,074,MAGOFFIN,371,Magoffin County,360,Salyersville Grade School,371360,074371360,210375000958,KVEC,904,06,35,44,0,0,0,0,0,0,0,0,0,1,1,2,0,0,0,1,0,1,42,34,76,79
20192020,074,MAGOFFIN,371,Magoffin County,370,Magoffin County High School,371370,074371370,210375000960,KVEC,904,All Students,290,294,2,0,2,0,0,0,0,0,0,2,0,2,0,0,0,0,1,1,290,289,579,584
20192020,074,MAGOFFIN,371,Magoffin County,370,Magoffin County High School,371370,074371370,210375000960,KVEC,904,07,0,1,0,0,0,0,0,0,0,0,0,0,0,0,0,0,0,0,0,0,1,0,1,1
20192020,074,MAGOFFIN,371,Magoffin County,370,Magoffin County High School,371370,074371370,210375000960,KVEC,904,08,1,0,0,0,0,0,0,0,0,0,0,0,0,0,0,0,0,0,0,0,0,1,1,1
20192020,074,MAGOFFIN,371,Magoffin County,370,Magoffin County High School,371370,074371370,210375000960,KVEC,904,09,83,75,0,0,0,0,0,0,0,0,0,2,0,2,0,0,0,0,0,0,73,83,156,158
20192020,074,MAGOFFIN,371,Magoffin County,370,Magoffin County High School,371370,074371370,210375000960,KVEC,904,10,69,76,0,0,0,0,0,0,0,0,0,0,0,0,0,0,0,0,1,1,76,68,144,145
20192020,074,MAGOFFIN,371,Magoffin County,370,Magoffin County High School,371370,074371370,210375000960,KVEC,904,11,71,69,0,0,0,0,0,0,0,0,0,0,0,0,0,0,0,0,0,0,69,71,140,140
20192020,074,MAGOFFIN,371,Magoffin County,370,Magoffin County High School,371370,074371370,210375000960,KVEC,904,12,66,73,2,0,2,0,0,0,0,0,0,0,0,0,0,0,0,0,0,0,71,66,137,139
20192020,075,MARION,375,Marion County,"",---District Total---,375,"","",CKEC,901,14,0,2,0,0,0,0,0,0,0,0,0,0,0,0,0,0,0,0,0,0,2,0,2,2
20192020,075,MARION,375,Marion County,"",---District Total---,375,"","",CKEC,901,12,102,108,8,9,17,0,0,0,1,1,2,7,2,9,0,0,0,1,0,1,91,90,181,210
20192020,075,MARION,375,Marion County,"",---District Total---,375,"","",CKEC,901,All Students,1553,1582,106,113,219,1,0,1,10,13,23,117,98,215,2,3,5,52,53,105,1294,1273,2567,3135
20192020,075,MARION,375,Marion County,"",---District Total---,375,"","",CKEC,901,PS,62,78,5,4,9,0,0,0,0,0,0,5,5,10,0,0,0,7,4,11,61,49,110,140
20192020,075,MARION,375,Marion County,"",---District Total---,375,"","",CKEC,901,KG,97,113,4,8,12,0,0,0,1,1,2,10,14,24,0,0,0,7,7,14,91,67,158,210
20192020,075,MARION,375,Marion County,"",---District Total---,375,"","",CKEC,901,01,122,98,8,8,16,0,0,0,1,1,2,5,8,13,0,1,1,2,7,9,82,97,179,220
20192020,075,MARION,375,Marion County,"",---District Total---,375,"","",CKEC,901,02,97,122,6,6,12,0,0,0,0,1,1,9,6,15,1,0,1,2,8,10,104,76,180,219
20192020,075,MARION,375,Marion County,"",---District Total---,375,"","",CKEC,901,03,122,108,8,9,17,0,0,0,3,0,3,8,8,16,0,0,0,6,7,13,83,98,181,230
20192020,075,MARION,375,Marion County,"",---District Total---,375,"","",CKEC,901,04,105,112,10,4,14,0,0,0,0,1,1,8,6,14,0,1,1,12,6,18,82,87,169,217
20192020,075,MARION,375,Marion County,"",---District Total---,375,"","",CKEC,901,05,146,147,9,8,17,0,0,0,1,2,3,13,7,20,0,0,0,4,4,8,120,125,245,293
20192020,075,MARION,375,Marion County,"",---District Total---,375,"","",CKEC,901,06,112,131,10,11,21,0,0,0,0,2,2,8,8,16,0,0,0,5,2,7,108,89,197,243
20192020,075,MARION,375,Marion County,"",---District Total---,375,"","",CKEC,901,07,134,138,9,13,22,1,0,1,0,1,1,14,11,25,1,0,1,4,5,9,109,104,213,272
20192020,075,MARION,375,Marion County,"",---District Total---,375,"","",CKEC,901,08,119,134,7,6,13,0,0,0,1,0,1,12,6,18,0,0,0,4,3,7,110,104,214,253
20192020,075,MARION,375,Marion County,"",---District Total---,375,"","",CKEC,901,09,120,127,11,8,19,0,0,0,0,1,1,9,7,16,0,1,1,0,1,1,107,102,209,247
20192020,075,MARION,375,Marion County,"",---District Total---,375,"","",CKEC,901,10,152,131,10,15,25,0,0,0,1,0,1,9,6,15,0,0,0,5,2,7,106,129,235,283
20192020,075,MARION,375,Marion County,"",---District Total---,375,"","",CKEC,901,11,125,111,6,8,14,0,0,0,1,2,3,5,9,14,0,0,0,0,1,1,99,105,204,236
20192020,075,MARION,375,Marion County,020,Calvary Elementary School,375020,075375020,210378000962,CKEC,901,04,14,24,0,1,1,0,0,0,0,0,0,1,0,1,0,0,0,1,1,2,22,12,34,38
20192020,075,MARION,375,Marion County,020,Calvary Elementary School,375020,075375020,210378000962,CKEC,901,All Students,109,105,2,2,4,0,0,0,0,0,0,5,2,7,0,0,0,2,3,5,96,102,198,214
20192020,075,MARION,375,Marion County,020,Calvary Elementary School,375020,075375020,210378000962,CKEC,901,KG,13,14,0,1,1,0,0,0,0,0,0,2,0,2,0,0,0,0,1,1,12,11,23,27
20192020,075,MARION,375,Marion County,020,Calvary Elementary School,375020,075375020,210378000962,CKEC,901,01,19,13,0,0,0,0,0,0,0,0,0,0,0,0,0,0,0,0,0,0,13,19,32,32
20192020,075,MARION,375,Marion County,020,Calvary Elementary School,375020,075375020,210378000962,CKEC,901,02,15,12,1,0,1,0,0,0,0,0,0,0,1,1,0,0,0,0,0,0,11,14,25,27
20192020,075,MARION,375,Marion County,020,Calvary Elementary School,375020,075375020,210378000962,CKEC,901,03,21,18,1,0,1,0,0,0,0,0,0,1,1,2,0,0,0,1,0,1,15,20,35,39
20192020,075,MARION,375,Marion County,020,Calvary Elementary School,375020,075375020,210378000962,CKEC,901,05,27,24,0,0,0,0,0,0,0,0,0,1,0,1,0,0,0,0,1,1,23,26,49,51
20192020,075,MARION,375,Marion County,030,Hugh C. Spalding Academy,375030,075375030,210378002328,CKEC,901,All Students,71,44,5,6,11,0,0,0,0,0,0,2,4,6,0,0,0,3,1,4,34,60,94,115
20192020,075,MARION,375,Marion County,030,Hugh C. Spalding Academy,375030,075375030,210378002328,CKEC,901,09,9,3,1,0,1,0,0,0,0,0,0,0,0,0,0,0,0,0,0,0,2,9,11,12
20192020,075,MARION,375,Marion County,030,Hugh C. Spalding Academy,375030,075375030,210378002328,CKEC,901,10,31,17,2,3,5,0,0,0,0,0,0,1,2,3,0,0,0,2,1,3,12,25,37,48
20192020,075,MARION,375,Marion County,030,Hugh C. Spalding Academy,375030,075375030,210378002328,CKEC,901,11,19,15,1,2,3,0,0,0,0,0,0,0,1,1,0,0,0,0,0,0,14,16,30,34
20192020,075,MARION,375,Marion County,030,Hugh C. Spalding Academy,375030,075375030,210378002328,CKEC,901,12,12,9,1,1,2,0,0,0,0,0,0,1,1,2,0,0,0,1,0,1,6,10,16,21
20192020,075,MARION,375,Marion County,040,Glasscock Elementary School,375040,075375040,210378000963,CKEC,901,05,37,45,7,4,11,0,0,0,0,0,0,1,5,6,0,0,0,3,3,6,34,25,59,82
20192020,075,MARION,375,Marion County,040,Glasscock Elementary School,375040,075375040,210378000963,CKEC,901,All Students,215,240,34,25,59,0,0,0,1,2,3,14,22,36,0,0,0,15,16,31,176,150,326,455
20192020,075,MARION,375,Marion County,040,Glasscock Elementary School,375040,075375040,210378000963,CKEC,901,PS,23,37,3,2,5,0,0,0,0,0,0,2,0,2,0,0,0,5,2,7,27,19,46,60
20192020,075,MARION,375,Marion County,040,Glasscock Elementary School,375040,075375040,210378000963,CKEC,901,KG,35,47,4,5,9,0,0,0,0,1,1,5,5,10,0,0,0,3,3,6,35,21,56,82
20192020,075,MARION,375,Marion County,040,Glasscock Elementary School,375040,075375040,210378000963,CKEC,901,01,42,36,6,5,11,0,0,0,0,0,0,4,4,8,0,0,0,1,4,5,25,29,54,78
20192020,075,MARION,375,Marion County,040,Glasscock Elementary School,375040,075375040,210378000963,CKEC,901,02,28,41,4,3,7,0,0,0,0,0,0,1,1,2,0,0,0,1,3,4,35,21,56,69
20192020,075,MARION,375,Marion County,040,Glasscock Elementary School,375040,075375040,210378000963,CKEC,901,03,37,35,6,5,11,0,0,0,1,0,1,2,4,6,0,0,0,2,2,4,24,26,50,72
20192020,075,MARION,375,Marion County,040,Glasscock Elementary School,375040,075375040,210378000963,CKEC,901,04,36,36,7,3,10,0,0,0,0,1,1,1,3,4,0,0,0,5,1,6,23,28,51,72
20192020,075,MARION,375,Marion County,085,Marion County Knight Academy,375085,075375085,210378002443,CKEC,901,08,119,134,7,6,13,0,0,0,1,0,1,12,6,18,0,0,0,4,3,7,110,104,214,253
20192020,075,MARION,375,Marion County,085,Marion County Knight Academy,375085,075375085,210378002443,CKEC,901,All Students,230,258,17,14,31,0,0,0,1,1,2,21,13,34,0,1,1,4,4,8,215,197,412,488
20192020,075,MARION,375,Marion County,085,Marion County Knight Academy,375085,075375085,210378002443,CKEC,901,09,111,124,10,8,18,0,0,0,0,1,1,9,7,16,0,1,1,0,1,1,105,93,198,235
20192020,075,MARION,375,Marion County,095,Marion County Middle School,375095,075375095,210378002454,CKEC,901,06,112,131,10,11,21,0,0,0,0,2,2,8,8,16,0,0,0,5,2,7,108,89,197,243
20192020,075,MARION,375,Marion County,095,Marion County Middle School,375095,075375095,210378002454,CKEC,901,All Students,246,269,19,24,43,1,0,1,0,3,3,22,19,41,1,0,1,9,7,16,217,193,410,515
20192020,075,MARION,375,Marion County,095,Marion County Middle School,375095,075375095,210378002454,CKEC,901,07,134,138,9,13,22,1,0,1,0,1,1,14,11,25,1,0,1,4,5,9,109,104,213,272
20192020,075,MARION,375,Marion County,100,West Marion Elementary School,375100,075375100,210378001619,CKEC,901,04,31,23,0,0,0,0,0,0,0,0,0,0,0,0,0,0,0,0,0,0,23,31,54,54
20192020,075,MARION,375,Marion County,100,West Marion Elementary School,375100,075375100,210378001619,CKEC,901,All Students,197,195,2,1,3,0,0,0,0,0,0,3,2,5,0,0,0,1,7,8,189,187,376,392
20192020,075,MARION,375,Marion County,100,West Marion Elementary School,375100,075375100,210378001619,CKEC,901,PS,18,22,0,0,0,0,0,0,0,0,0,2,0,2,0,0,0,0,0,0,20,18,38,40
20192020,075,MARION,375,Marion County,100,West Marion Elementary School,375100,075375100,210378001619,CKEC,901,KG,29,26,0,0,0,0,0,0,0,0,0,0,1,1,0,0,0,1,3,4,25,25,50,55
20192020,075,MARION,375,Marion County,100,West Marion Elementary School,375100,075375100,210378001619,CKEC,901,01,29,30,1,0,1,0,0,0,0,0,0,0,1,1,0,0,0,0,1,1,29,27,56,59
20192020,075,MARION,375,Marion County,100,West Marion Elementary School,375100,075375100,210378001619,CKEC,901,02,24,41,0,0,0,0,0,0,0,0,0,1,0,1,0,0,0,0,1,1,40,23,63,65
20192020,075,MARION,375,Marion County,100,West Marion Elementary School,375100,075375100,210378001619,CKEC,901,03,39,31,0,1,1,0,0,0,0,0,0,1,0,1,0,0,0,0,2,2,30,36,66,70
20192020,075,MARION,375,Marion County,100,West Marion Elementary School,375100,075375100,210378001619,CKEC,901,05,45,44,1,0,1,0,0,0,0,0,0,1,0,1,0,0,0,0,0,0,42,45,87,89
20192020,075,MARION,375,Marion County,210,Lebanon Elementary School,375210,075375210,210378000967,CKEC,901,04,24,29,3,0,3,0,0,0,0,0,0,6,3,9,0,1,1,6,4,10,14,16,30,53
20192020,075,MARION,375,Marion County,210,Lebanon Elementary School,375210,075375210,210378000967,CKEC,901,All Students,168,160,7,15,22,0,0,0,5,4,9,31,23,54,1,2,3,15,13,28,101,111,212,328
20192020,075,MARION,375,Marion County,210,Lebanon Elementary School,375210,075375210,210378000967,CKEC,901,PS,21,19,2,2,4,0,0,0,0,0,0,1,5,6,0,0,0,2,2,4,14,12,26,40
20192020,075,MARION,375,Marion County,210,Lebanon Elementary School,375210,075375210,210378000967,CKEC,901,KG,20,26,0,2,2,0,0,0,1,0,1,3,8,11,0,0,0,3,0,3,19,10,29,46
20192020,075,MARION,375,Marion County,210,Lebanon Elementary School,375210,075375210,210378000967,CKEC,901,01,32,19,1,3,4,0,0,0,1,1,2,1,3,4,0,1,1,1,2,3,15,22,37,51
20192020,075,MARION,375,Marion County,210,Lebanon Elementary School,375210,075375210,210378000967,CKEC,901,02,30,28,1,3,4,0,0,0,0,1,1,7,4,11,1,0,1,1,4,5,18,18,36,58
20192020,075,MARION,375,Marion County,210,Lebanon Elementary School,375210,075375210,210378000967,CKEC,901,03,25,24,1,3,4,0,0,0,2,0,2,4,3,7,0,0,0,3,3,6,14,16,30,49
20192020,075,MARION,375,Marion County,210,Lebanon Elementary School,375210,075375210,210378000967,CKEC,901,05,37,34,1,4,5,0,0,0,1,2,3,10,2,12,0,0,0,1,0,1,21,29,50,71
20192020,075,MARION,375,Marion County,515,Marion County High School,375515,075375515,210378000970,CKEC,901,11,106,96,5,6,11,0,0,0,1,2,3,5,8,13,0,0,0,0,1,1,85,89,174,202
20192020,075,MARION,375,Marion County,515,Marion County High School,375515,075375515,210378000970,CKEC,901,14,0,2,0,0,0,0,0,0,0,0,0,0,0,0,0,0,0,0,0,0,2,0,2,2
20192020,075,MARION,375,Marion County,515,Marion County High School,375515,075375515,210378000970,CKEC,901,All Students,317,311,20,26,46,0,0,0,3,3,6,19,13,32,0,0,0,3,2,5,266,273,539,628
20192020,075,MARION,375,Marion County,515,Marion County High School,375515,075375515,210378000970,CKEC,901,10,121,114,8,12,20,0,0,0,1,0,1,8,4,12,0,0,0,3,1,4,94,104,198,235
20192020,075,MARION,375,Marion County,515,Marion County High School,375515,075375515,210378000970,CKEC,901,12,90,99,7,8,15,0,0,0,1,1,2,6,1,7,0,0,0,0,0,0,85,80,165,189
20192020,076,MARSHALL,381,Marshall County,"",---District Total---,381,"","",WKEC,908,11,158,156,1,1,2,0,1,1,1,2,3,2,3,5,0,0,0,2,1,3,150,150,300,314
20192020,076,MARSHALL,381,Marshall County,"",---District Total---,381,"","",WKEC,908,All Students,2165,2340,11,5,16,2,2,4,10,16,26,52,67,119,3,3,6,37,42,79,2225,2030,4255,4505
20192020,076,MARSHALL,381,Marshall County,"",---District Total---,381,"","",WKEC,908,PS,72,123,3,2,5,2,0,2,0,1,1,3,2,5,0,0,0,4,3,7,111,64,175,195
20192020,076,MARSHALL,381,Marshall County,"",---District Total---,381,"","",WKEC,908,KG,194,208,4,1,5,1,0,1,0,0,0,6,9,15,0,0,0,4,2,6,193,182,375,402
20192020,076,MARSHALL,381,Marshall County,"",---District Total---,381,"","",WKEC,908,01,154,183,0,0,0,0,0,0,1,0,1,1,5,6,0,0,0,3,3,6,178,146,324,337
20192020,076,MARSHALL,381,Marshall County,"",---District Total---,381,"","",WKEC,908,02,167,173,0,0,0,1,0,1,0,1,1,6,8,14,1,0,1,4,8,12,161,150,311,340
20192020,076,MARSHALL,381,Marshall County,"",---District Total---,381,"","",WKEC,908,03,142,162,1,1,2,0,0,0,2,0,2,1,6,7,0,0,0,5,2,7,153,133,286,304
20192020,076,MARSHALL,381,Marshall County,"",---District Total---,381,"","",WKEC,908,04,168,174,0,1,1,0,0,0,0,1,1,3,3,6,0,0,0,3,5,8,168,158,326,342
20192020,076,MARSHALL,381,Marshall County,"",---District Total---,381,"","",WKEC,908,05,152,169,0,0,0,0,0,0,0,1,1,6,4,10,0,1,1,4,5,9,159,141,300,321
20192020,076,MARSHALL,381,Marshall County,"",---District Total---,381,"","",WKEC,908,06,176,194,1,0,1,0,1,1,0,2,2,5,6,11,1,0,1,2,4,6,185,163,348,370
20192020,076,MARSHALL,381,Marshall County,"",---District Total---,381,"","",WKEC,908,07,167,173,2,0,2,0,0,0,3,1,4,2,2,4,1,0,1,4,5,9,161,159,320,340
20192020,076,MARSHALL,381,Marshall County,"",---District Total---,381,"","",WKEC,908,08,168,190,1,0,1,0,0,0,2,3,5,3,3,6,0,1,1,2,3,5,182,158,340,358
20192020,076,MARSHALL,381,Marshall County,"",---District Total---,381,"","",WKEC,908,09,181,189,0,1,1,0,0,0,1,3,4,8,6,14,0,0,0,0,2,2,180,169,349,370
20192020,076,MARSHALL,381,Marshall County,"",---District Total---,381,"","",WKEC,908,10,176,183,1,0,1,0,0,0,0,1,1,5,8,13,0,0,0,3,1,4,174,166,340,359
20192020,076,MARSHALL,381,Marshall County,"",---District Total---,381,"","",WKEC,908,12,162,184,0,0,0,0,0,0,0,1,1,4,4,8,0,1,1,1,1,2,179,155,334,346
20192020,076,MARSHALL,381,Marshall County,"",---District Total---,381,"","",WKEC,908,14,0,2,0,0,0,0,0,0,0,0,0,0,0,0,0,0,0,0,0,0,2,0,2,2
20192020,076,MARSHALL,381,Marshall County,005,Purchase Youth Village,381005,076381005,210381002445,WKEC,908,12,0,1,0,0,0,0,0,0,0,0,0,0,0,0,0,0,0,0,0,0,1,0,1,1
20192020,076,MARSHALL,381,Marshall County,005,Purchase Youth Village,381005,076381005,210381002445,WKEC,908,All Students,8,17,0,0,0,0,0,0,0,0,0,0,0,0,0,0,0,1,1,2,16,7,23,25
20192020,076,MARSHALL,381,Marshall County,005,Purchase Youth Village,381005,076381005,210381002445,WKEC,908,01,0,2,0,0,0,0,0,0,0,0,0,0,0,0,0,0,0,0,0,0,2,0,2,2
20192020,076,MARSHALL,381,Marshall County,005,Purchase Youth Village,381005,076381005,210381002445,WKEC,908,02,0,1,0,0,0,0,0,0,0,0,0,0,0,0,0,0,0,0,0,0,1,0,1,1
20192020,076,MARSHALL,381,Marshall County,005,Purchase Youth Village,381005,076381005,210381002445,WKEC,908,03,0,1,0,0,0,0,0,0,0,0,0,0,0,0,0,0,0,0,0,0,1,0,1,1
20192020,076,MARSHALL,381,Marshall County,005,Purchase Youth Village,381005,076381005,210381002445,WKEC,908,04,0,1,0,0,0,0,0,0,0,0,0,0,0,0,0,0,0,0,0,0,1,0,1,1
20192020,076,MARSHALL,381,Marshall County,005,Purchase Youth Village,381005,076381005,210381002445,WKEC,908,05,1,4,0,0,0,0,0,0,0,0,0,0,0,0,0,0,0,1,0,1,3,1,4,5
20192020,076,MARSHALL,381,Marshall County,005,Purchase Youth Village,381005,076381005,210381002445,WKEC,908,06,2,2,0,0,0,0,0,0,0,0,0,0,0,0,0,0,0,0,0,0,2,2,4,4
20192020,076,MARSHALL,381,Marshall County,005,Purchase Youth Village,381005,076381005,210381002445,WKEC,908,07,2,2,0,0,0,0,0,0,0,0,0,0,0,0,0,0,0,0,0,0,2,2,4,4
20192020,076,MARSHALL,381,Marshall County,005,Purchase Youth Village,381005,076381005,210381002445,WKEC,908,08,2,2,0,0,0,0,0,0,0,0,0,0,0,0,0,0,0,0,0,0,2,2,4,4
20192020,076,MARSHALL,381,Marshall County,005,Purchase Youth Village,381005,076381005,210381002445,WKEC,908,09,1,1,0,0,0,0,0,0,0,0,0,0,0,0,0,0,0,0,1,1,1,0,1,2
20192020,076,MARSHALL,381,Marshall County,010,Central Elementary School,381010,076381010,210381000272,WKEC,908,04,43,41,0,0,0,0,0,0,0,0,0,0,1,1,0,0,0,1,1,2,40,41,81,84
20192020,076,MARSHALL,381,Marshall County,010,Central Elementary School,381010,076381010,210381000272,WKEC,908,All Students,233,244,0,0,0,0,0,0,0,0,0,4,8,12,1,0,1,5,5,10,234,220,454,477
20192020,076,MARSHALL,381,Marshall County,010,Central Elementary School,381010,076381010,210381000272,WKEC,908,PS,13,21,2,0,2,0,0,0,0,0,0,0,0,0,0,0,0,0,0,0,19,13,32,34
20192020,076,MARSHALL,381,Marshall County,010,Central Elementary School,381010,076381010,210381000272,WKEC,908,KG,44,44,0,0,0,0,0,0,0,0,0,1,0,1,0,0,0,0,1,1,43,43,86,88
20192020,076,MARSHALL,381,Marshall County,010,Central Elementary School,381010,076381010,210381000272,WKEC,908,01,38,36,0,0,0,0,0,0,0,0,0,0,1,1,0,0,0,1,1,2,35,36,71,74
20192020,076,MARSHALL,381,Marshall County,010,Central Elementary School,381010,076381010,210381000272,WKEC,908,02,40,47,0,0,0,0,0,0,0,0,0,0,1,1,1,0,1,2,1,3,44,38,82,87
20192020,076,MARSHALL,381,Marshall County,010,Central Elementary School,381010,076381010,210381000272,WKEC,908,03,33,38,0,0,0,0,0,0,0,0,0,1,3,4,0,0,0,1,0,1,36,30,66,71
20192020,076,MARSHALL,381,Marshall County,010,Central Elementary School,381010,076381010,210381000272,WKEC,908,05,35,38,0,0,0,0,0,0,0,0,0,2,2,4,0,0,0,0,1,1,36,32,68,73
20192020,076,MARSHALL,381,Marshall County,011,Benton Elementary School,381011,076381011,210381000971,WKEC,908,04,40,48,0,0,0,0,0,0,0,0,0,1,0,1,0,0,0,2,2,4,45,38,83,88
20192020,076,MARSHALL,381,Marshall County,011,Benton Elementary School,381011,076381011,210381000971,WKEC,908,All Students,234,269,1,0,1,1,0,1,2,2,4,5,8,13,0,0,0,7,7,14,253,217,470,503
20192020,076,MARSHALL,381,Marshall County,011,Benton Elementary School,381011,076381011,210381000971,WKEC,908,PS,15,37,0,0,0,0,0,0,0,1,1,1,1,2,0,0,0,2,1,3,34,12,46,52
20192020,076,MARSHALL,381,Marshall County,011,Benton Elementary School,381011,076381011,210381000971,WKEC,908,KG,43,58,1,0,1,1,0,1,0,0,0,1,3,4,0,0,0,1,0,1,54,40,94,101
20192020,076,MARSHALL,381,Marshall County,011,Benton Elementary School,381011,076381011,210381000971,WKEC,908,01,35,42,0,0,0,0,0,0,0,0,0,0,1,1,0,0,0,0,0,0,42,34,76,77
20192020,076,MARSHALL,381,Marshall County,011,Benton Elementary School,381011,076381011,210381000971,WKEC,908,02,37,41,0,0,0,0,0,0,0,1,1,1,1,2,0,0,0,0,2,2,40,33,73,78
20192020,076,MARSHALL,381,Marshall County,011,Benton Elementary School,381011,076381011,210381000971,WKEC,908,03,44,39,0,0,0,0,0,0,2,0,2,0,2,2,0,0,0,3,1,4,34,41,75,83
20192020,076,MARSHALL,381,Marshall County,011,Benton Elementary School,381011,076381011,210381000971,WKEC,908,05,35,41,0,0,0,0,0,0,0,1,1,2,1,3,0,0,0,1,2,3,38,31,69,76
20192020,076,MARSHALL,381,Marshall County,018,Star Academy High School,381018,076381018,210381002073,WKEC,908,11,2,1,0,0,0,0,0,0,0,0,0,0,0,0,0,0,0,0,0,0,1,2,3,3
20192020,076,MARSHALL,381,Marshall County,018,Star Academy High School,381018,076381018,210381002073,WKEC,908,All Students,12,16,0,0,0,0,0,0,0,0,0,0,0,0,0,0,0,1,1,2,15,11,26,28
20192020,076,MARSHALL,381,Marshall County,018,Star Academy High School,381018,076381018,210381002073,WKEC,908,12,10,15,0,0,0,0,0,0,0,0,0,0,0,0,0,0,0,1,1,2,14,9,23,25
20192020,076,MARSHALL,381,Marshall County,025,MC@HOME,381025,076381025,210381002474,WKEC,908,11,19,5,0,0,0,0,1,1,0,0,0,0,1,1,0,0,0,1,0,1,4,17,21,24
20192020,076,MARSHALL,381,Marshall County,025,MC@HOME,381025,076381025,210381002474,WKEC,908,All Students,58,40,0,0,0,0,1,1,1,0,1,1,4,5,0,0,0,1,0,1,37,53,90,98
20192020,076,MARSHALL,381,Marshall County,025,MC@HOME,381025,076381025,210381002474,WKEC,908,06,0,1,0,0,0,0,0,0,0,0,0,0,0,0,0,0,0,0,0,0,1,0,1,1
20192020,076,MARSHALL,381,Marshall County,025,MC@HOME,381025,076381025,210381002474,WKEC,908,07,0,4,0,0,0,0,0,0,0,0,0,0,0,0,0,0,0,0,0,0,4,0,4,4
20192020,076,MARSHALL,381,Marshall County,025,MC@HOME,381025,076381025,210381002474,WKEC,908,08,3,4,0,0,0,0,0,0,1,0,1,0,0,0,0,0,0,0,0,0,3,3,6,7
20192020,076,MARSHALL,381,Marshall County,025,MC@HOME,381025,076381025,210381002474,WKEC,908,09,9,2,0,0,0,0,0,0,0,0,0,0,1,1,0,0,0,0,0,0,2,8,10,11
20192020,076,MARSHALL,381,Marshall County,025,MC@HOME,381025,076381025,210381002474,WKEC,908,10,4,3,0,0,0,0,0,0,0,0,0,0,0,0,0,0,0,0,0,0,3,4,7,7
20192020,076,MARSHALL,381,Marshall County,025,MC@HOME,381025,076381025,210381002474,WKEC,908,12,23,21,0,0,0,0,0,0,0,0,0,1,2,3,0,0,0,0,0,0,20,21,41,44
20192020,076,MARSHALL,381,Marshall County,040,Calvert City Elementary School,381040,076381040,210381000973,WKEC,908,04,22,20,0,1,1,0,0,0,0,1,1,0,0,0,0,0,0,0,1,1,20,19,39,42
20192020,076,MARSHALL,381,Marshall County,040,Calvert City Elementary School,381040,076381040,210381000973,WKEC,908,All Students,119,135,1,1,2,0,0,0,1,1,2,3,2,5,0,1,1,4,4,8,126,110,236,254
20192020,076,MARSHALL,381,Marshall County,040,Calvert City Elementary School,381040,076381040,210381000973,WKEC,908,PS,11,18,1,1,2,0,0,0,0,0,0,0,0,0,0,0,0,1,1,2,16,9,25,29
20192020,076,MARSHALL,381,Marshall County,040,Calvert City Elementary School,381040,076381040,210381000973,WKEC,908,KG,22,30,1,0,1,0,0,0,0,0,0,1,1,2,0,0,0,2,1,3,26,20,46,52
20192020,076,MARSHALL,381,Marshall County,040,Calvert City Elementary School,381040,076381040,210381000973,WKEC,908,01,20,26,0,0,0,0,0,0,1,0,1,1,0,1,0,0,0,0,0,0,24,20,44,46
20192020,076,MARSHALL,381,Marshall County,040,Calvert City Elementary School,381040,076381040,210381000973,WKEC,908,02,23,16,0,0,0,0,0,0,0,0,0,1,0,1,0,0,0,1,1,2,14,22,36,39
20192020,076,MARSHALL,381,Marshall County,040,Calvert City Elementary School,381040,076381040,210381000973,WKEC,908,03,11,23,0,0,0,0,0,0,0,0,0,0,0,0,0,0,0,1,1,2,22,10,32,34
20192020,076,MARSHALL,381,Marshall County,040,Calvert City Elementary School,381040,076381040,210381000973,WKEC,908,05,21,20,0,0,0,0,0,0,0,0,0,0,1,1,0,1,1,0,0,0,20,19,39,41
20192020,076,MARSHALL,381,Marshall County,085,Jonathan Elementary School,381085,076381085,210381000975,WKEC,908,05,18,14,0,0,0,0,0,0,0,0,0,0,0,0,0,0,0,0,2,2,14,16,30,32
20192020,076,MARSHALL,381,Marshall County,085,Jonathan Elementary School,381085,076381085,210381000975,WKEC,908,All Students,103,111,0,0,0,0,0,0,0,0,0,2,5,7,0,0,0,2,4,6,107,94,201,214
20192020,076,MARSHALL,381,Marshall County,085,Jonathan Elementary School,381085,076381085,210381000975,WKEC,908,PS,10,17,0,0,0,0,0,0,0,0,0,1,1,2,0,0,0,0,0,0,16,9,25,27
20192020,076,MARSHALL,381,Marshall County,085,Jonathan Elementary School,381085,076381085,210381000975,WKEC,908,KG,23,21,0,0,0,0,0,0,0,0,0,0,1,1,0,0,0,1,0,1,20,22,42,44
20192020,076,MARSHALL,381,Marshall County,085,Jonathan Elementary School,381085,076381085,210381000975,WKEC,908,01,16,22,0,0,0,0,0,0,0,0,0,0,1,1,0,0,0,0,1,1,22,14,36,38
20192020,076,MARSHALL,381,Marshall County,085,Jonathan Elementary School,381085,076381085,210381000975,WKEC,908,02,18,24,0,0,0,0,0,0,0,0,0,2,3,5,0,0,0,1,1,2,21,14,35,42
20192020,076,MARSHALL,381,Marshall County,085,Jonathan Elementary School,381085,076381085,210381000975,WKEC,908,03,12,14,0,0,0,0,0,0,0,0,0,0,0,0,0,0,0,0,0,0,14,12,26,26
20192020,076,MARSHALL,381,Marshall County,085,Jonathan Elementary School,381085,076381085,210381000975,WKEC,908,04,16,16,0,0,0,0,0,0,0,0,0,0,0,0,0,0,0,0,0,0,16,16,32,32
20192020,076,MARSHALL,381,Marshall County,088,Marshall County High School,381088,076381088,210381000976,WKEC,908,12,129,147,0,0,0,0,0,0,0,1,1,3,2,5,0,1,1,0,0,0,144,125,269,276
20192020,076,MARSHALL,381,Marshall County,088,Marshall County High School,381088,076381088,210381000976,WKEC,908,All Students,609,665,2,2,4,0,0,0,2,7,9,18,17,35,0,1,1,4,3,7,639,579,1218,1274
20192020,076,MARSHALL,381,Marshall County,088,Marshall County High School,381088,076381088,210381000976,WKEC,908,09,171,186,0,1,1,0,0,0,1,3,4,8,5,13,0,0,0,0,1,1,177,161,338,357
20192020,076,MARSHALL,381,Marshall County,088,Marshall County High School,381088,076381088,210381000976,WKEC,908,10,172,180,1,0,1,0,0,0,0,1,1,5,8,13,0,0,0,3,1,4,171,162,333,352
20192020,076,MARSHALL,381,Marshall County,088,Marshall County High School,381088,076381088,210381000976,WKEC,908,11,137,150,1,1,2,0,0,0,1,2,3,2,2,4,0,0,0,1,1,2,145,131,276,287
20192020,076,MARSHALL,381,Marshall County,088,Marshall County High School,381088,076381088,210381000976,WKEC,908,14,0,2,0,0,0,0,0,0,0,0,0,0,0,0,0,0,0,0,0,0,2,0,2,2
20192020,076,MARSHALL,381,Marshall County,090,North Marshall Middle School,381090,076381090,210381000977,WKEC,908,07,83,97,0,0,0,0,0,0,2,1,3,1,2,3,1,0,1,2,3,5,91,77,168,180
20192020,076,MARSHALL,381,Marshall County,090,North Marshall Middle School,381090,076381090,210381000977,WKEC,908,All Students,253,299,1,0,1,0,1,1,3,4,7,8,8,16,2,1,3,3,7,10,282,232,514,552
20192020,076,MARSHALL,381,Marshall County,090,North Marshall Middle School,381090,076381090,210381000977,WKEC,908,06,95,105,1,0,1,0,1,1,0,1,1,4,4,8,1,0,1,1,3,4,98,86,184,200
20192020,076,MARSHALL,381,Marshall County,090,North Marshall Middle School,381090,076381090,210381000977,WKEC,908,08,75,97,0,0,0,0,0,0,1,2,3,3,2,5,0,1,1,0,1,1,93,69,162,172
20192020,076,MARSHALL,381,Marshall County,100,Sharpe Elementary School,381100,076381100,210381000978,WKEC,908,01,26,25,0,0,0,0,0,0,0,0,0,0,2,2,0,0,0,1,1,2,24,23,47,51
20192020,076,MARSHALL,381,Marshall County,100,Sharpe Elementary School,381100,076381100,210381000978,WKEC,908,All Students,153,137,2,2,4,1,0,1,0,0,0,2,5,7,0,0,0,1,4,5,131,142,273,290
20192020,076,MARSHALL,381,Marshall County,100,Sharpe Elementary School,381100,076381100,210381000978,WKEC,908,PS,9,15,0,0,0,0,0,0,0,0,0,1,0,1,0,0,0,1,0,1,13,9,22,24
20192020,076,MARSHALL,381,Marshall County,100,Sharpe Elementary School,381100,076381100,210381000978,WKEC,908,KG,36,26,2,1,3,0,0,0,0,0,0,0,1,1,0,0,0,0,0,0,24,34,58,62
20192020,076,MARSHALL,381,Marshall County,100,Sharpe Elementary School,381100,076381100,210381000978,WKEC,908,02,25,20,0,0,0,1,0,1,0,0,0,0,0,0,0,0,0,0,2,2,19,23,42,45
20192020,076,MARSHALL,381,Marshall County,100,Sharpe Elementary School,381100,076381100,210381000978,WKEC,908,03,18,20,0,1,1,0,0,0,0,0,0,0,0,0,0,0,0,0,0,0,20,17,37,38
20192020,076,MARSHALL,381,Marshall County,100,Sharpe Elementary School,381100,076381100,210381000978,WKEC,908,04,26,24,0,0,0,0,0,0,0,0,0,2,2,4,0,0,0,0,1,1,22,23,45,50
20192020,076,MARSHALL,381,Marshall County,100,Sharpe Elementary School,381100,076381100,210381000978,WKEC,908,05,22,22,0,0,0,0,0,0,0,0,0,0,0,0,0,0,0,0,0,0,22,22,44,44
20192020,076,MARSHALL,381,Marshall County,105,South Marshall Elementary School,381105,076381105,210381000979,WKEC,908,05,20,30,0,0,0,0,0,0,0,0,0,2,0,2,0,0,0,2,0,2,26,20,46,50
20192020,076,MARSHALL,381,Marshall County,105,South Marshall Elementary School,381105,076381105,210381000979,WKEC,908,All Students,134,164,1,0,1,0,0,0,0,0,0,7,7,14,0,0,0,3,1,4,153,126,279,298
20192020,076,MARSHALL,381,Marshall County,105,South Marshall Elementary School,381105,076381105,210381000979,WKEC,908,PS,14,15,0,1,1,2,0,2,0,0,0,0,0,0,0,0,0,0,1,1,13,12,25,29
20192020,076,MARSHALL,381,Marshall County,105,South Marshall Elementary School,381105,076381105,210381000979,WKEC,908,KG,26,29,0,0,0,0,0,0,0,0,0,3,3,6,0,0,0,0,0,0,26,23,49,55
20192020,076,MARSHALL,381,Marshall County,105,South Marshall Elementary School,381105,076381105,210381000979,WKEC,908,01,19,30,0,0,0,0,0,0,0,0,0,0,0,0,0,0,0,1,0,1,29,19,48,49
20192020,076,MARSHALL,381,Marshall County,105,South Marshall Elementary School,381105,076381105,210381000979,WKEC,908,02,24,24,0,0,0,0,0,0,0,0,0,2,3,5,0,0,0,0,1,1,22,20,42,48
20192020,076,MARSHALL,381,Marshall County,105,South Marshall Elementary School,381105,076381105,210381000979,WKEC,908,03,24,27,1,0,1,0,0,0,0,0,0,0,1,1,0,0,0,0,0,0,26,23,49,51
20192020,076,MARSHALL,381,Marshall County,105,South Marshall Elementary School,381105,076381105,210381000979,WKEC,908,04,21,24,0,0,0,0,0,0,0,0,0,0,0,0,0,0,0,0,0,0,24,21,45,45
20192020,076,MARSHALL,381,Marshall County,111,South Marshall Middle,381111,076381111,210381002428,WKEC,908,07,82,70,2,0,2,0,0,0,1,0,1,1,0,1,0,0,0,2,2,4,64,80,144,152
20192020,076,MARSHALL,381,Marshall County,111,South Marshall Middle,381111,076381111,210381002428,WKEC,908,All Students,249,243,3,0,3,0,0,0,1,2,3,2,3,5,0,0,0,5,5,10,232,239,471,492
20192020,076,MARSHALL,381,Marshall County,111,South Marshall Middle,381111,076381111,210381002428,WKEC,908,06,79,86,0,0,0,0,0,0,0,1,1,1,2,3,0,0,0,1,1,2,84,75,159,165
20192020,076,MARSHALL,381,Marshall County,111,South Marshall Middle,381111,076381111,210381002428,WKEC,908,08,88,87,1,0,1,0,0,0,0,1,1,0,1,1,0,0,0,2,2,4,84,84,168,175
20192020,076,MARSHALL,381,Marshall County,904,Marshall County Technical Center,381904,076381904,210381001509,WKEC,908,11,0,0,0,0,0,0,0,0,0,0,0,0,0,0,0,0,0,0,0,0,0,0,0,0
20192020,076,MARSHALL,381,Marshall County,904,Marshall County Technical Center,381904,076381904,210381001509,WKEC,908,All Students,0,0,0,0,0,0,0,0,0,0,0,0,0,0,0,0,0,0,0,0,0,0,0,0
20192020,076,MARSHALL,381,Marshall County,904,Marshall County Technical Center,381904,076381904,210381001509,WKEC,908,14,0,0,0,0,0,0,0,0,0,0,0,0,0,0,0,0,0,0,0,0,0,0,0,0
20192020,076,MARSHALL,381,Marshall County,904,Marshall County Technical Center,381904,076381904,210381001509,WKEC,908,09,0,0,0,0,0,0,0,0,0,0,0,0,0,0,0,0,0,0,0,0,0,0,0,0
20192020,076,MARSHALL,381,Marshall County,904,Marshall County Technical Center,381904,076381904,210381001509,WKEC,908,10,0,0,0,0,0,0,0,0,0,0,0,0,0,0,0,0,0,0,0,0,0,0,0,0
20192020,076,MARSHALL,381,Marshall County,904,Marshall County Technical Center,381904,076381904,210381001509,WKEC,908,12,0,0,0,0,0,0,0,0,0,0,0,0,0,0,0,0,0,0,0,0,0,0,0,0
20192020,077,MARTIN,385,Martin County,"",---District Total---,385,"","",KEDC,903,10,57,82,0,0,0,0,0,0,0,0,0,2,0,2,0,0,0,2,0,2,78,57,135,139
20192020,077,MARTIN,385,Martin County,"",---District Total---,385,"","",KEDC,903,All Students,802,924,4,3,7,0,0,0,0,0,0,6,5,11,0,1,1,7,4,11,907,789,1696,1726
20192020,077,MARTIN,385,Martin County,"",---District Total---,385,"","",KEDC,903,PS,74,69,0,1,1,0,0,0,0,0,0,0,1,1,0,0,0,0,1,1,69,71,140,143
20192020,077,MARTIN,385,Martin County,"",---District Total---,385,"","",KEDC,903,KG,51,56,0,1,1,0,0,0,0,0,0,1,0,1,0,0,0,0,0,0,55,50,105,107
20192020,077,MARTIN,385,Martin County,"",---District Total---,385,"","",KEDC,903,01,65,66,1,1,2,0,0,0,0,0,0,1,1,2,0,0,0,0,0,0,64,63,127,131
20192020,077,MARTIN,385,Martin County,"",---District Total---,385,"","",KEDC,903,02,69,68,0,0,0,0,0,0,0,0,0,0,0,0,0,0,0,0,1,1,68,68,136,137
20192020,077,MARTIN,385,Martin County,"",---District Total---,385,"","",KEDC,903,03,57,69,0,0,0,0,0,0,0,0,0,1,0,1,0,0,0,0,0,0,68,57,125,126
20192020,077,MARTIN,385,Martin County,"",---District Total---,385,"","",KEDC,903,04,55,65,1,0,1,0,0,0,0,0,0,0,0,0,0,0,0,0,1,1,64,54,118,120
20192020,077,MARTIN,385,Martin County,"",---District Total---,385,"","",KEDC,903,05,67,85,0,0,0,0,0,0,0,0,0,0,0,0,0,0,0,1,1,2,84,66,150,152
20192020,077,MARTIN,385,Martin County,"",---District Total---,385,"","",KEDC,903,06,91,77,0,1,1,0,0,0,0,0,0,0,1,1,0,0,0,1,1,2,76,88,164,168
20192020,077,MARTIN,385,Martin County,"",---District Total---,385,"","",KEDC,903,07,69,70,0,0,0,0,0,0,0,0,0,1,1,2,0,0,0,1,0,1,68,68,136,139
20192020,077,MARTIN,385,Martin County,"",---District Total---,385,"","",KEDC,903,08,54,71,0,0,0,0,0,0,0,0,0,0,1,1,0,0,0,0,0,0,71,53,124,125
20192020,077,MARTIN,385,Martin County,"",---District Total---,385,"","",KEDC,903,09,58,76,0,0,0,0,0,0,0,0,0,0,0,0,0,0,0,0,0,0,76,58,134,134
20192020,077,MARTIN,385,Martin County,"",---District Total---,385,"","",KEDC,903,11,51,70,0,0,0,0,0,0,0,0,0,0,1,1,0,1,1,2,0,2,68,49,117,121
20192020,077,MARTIN,385,Martin County,"",---District Total---,385,"","",KEDC,903,12,57,69,2,0,2,0,0,0,0,0,0,0,0,0,0,0,0,0,0,0,67,57,124,126
20192020,077,MARTIN,385,Martin County,"",---District Total---,385,"","",KEDC,903,14,1,0,0,0,0,0,0,0,0,0,0,0,0,0,0,0,0,0,0,0,0,1,1,1
20192020,077,MARTIN,385,Martin County,051,Eden Elementary School,385051,077385051,210384001902,KEDC,903,06,25,26,0,0,0,0,0,0,0,0,0,0,1,1,0,0,0,1,0,1,25,24,49,51
20192020,077,MARTIN,385,Martin County,051,Eden Elementary School,385051,077385051,210384001902,KEDC,903,All Students,180,197,1,0,1,0,0,0,0,0,0,2,2,4,0,0,0,1,0,1,193,178,371,377
20192020,077,MARTIN,385,Martin County,051,Eden Elementary School,385051,077385051,210384001902,KEDC,903,PS,37,30,0,1,1,0,0,0,0,0,0,0,0,0,0,0,0,0,0,0,30,36,66,67
20192020,077,MARTIN,385,Martin County,051,Eden Elementary School,385051,077385051,210384001902,KEDC,903,KG,21,29,0,0,0,0,0,0,0,0,0,1,0,1,0,0,0,0,0,0,28,21,49,50
20192020,077,MARTIN,385,Martin County,051,Eden Elementary School,385051,077385051,210384001902,KEDC,903,01,32,25,1,0,1,0,0,0,0,0,0,1,1,2,0,0,0,0,0,0,23,31,54,57
20192020,077,MARTIN,385,Martin County,051,Eden Elementary School,385051,077385051,210384001902,KEDC,903,02,29,31,0,0,0,0,0,0,0,0,0,0,0,0,0,0,0,0,0,0,31,29,60,60
20192020,077,MARTIN,385,Martin County,051,Eden Elementary School,385051,077385051,210384001902,KEDC,903,03,27,31,0,0,0,0,0,0,0,0,0,0,0,0,0,0,0,0,0,0,31,27,58,58
20192020,077,MARTIN,385,Martin County,051,Eden Elementary School,385051,077385051,210384001902,KEDC,903,04,22,19,0,0,0,0,0,0,0,0,0,0,0,0,0,0,0,0,0,0,19,22,41,41
20192020,077,MARTIN,385,Martin County,051,Eden Elementary School,385051,077385051,210384001902,KEDC,903,05,24,36,0,0,0,0,0,0,0,0,0,0,0,0,0,0,0,0,0,0,36,24,60,60
20192020,077,MARTIN,385,Martin County,120,Inez Elementary School,385120,077385120,210384000982,KEDC,903,05,26,24,0,0,0,0,0,0,0,0,0,0,0,0,0,0,0,0,1,1,24,25,49,50
20192020,077,MARTIN,385,Martin County,120,Inez Elementary School,385120,077385120,210384000982,KEDC,903,All Students,142,136,1,1,2,0,0,0,0,0,0,0,0,0,0,0,0,0,3,3,135,138,273,278
20192020,077,MARTIN,385,Martin County,120,Inez Elementary School,385120,077385120,210384000982,KEDC,903,PS,14,21,0,0,0,0,0,0,0,0,0,0,0,0,0,0,0,0,1,1,21,13,34,35
20192020,077,MARTIN,385,Martin County,120,Inez Elementary School,385120,077385120,210384000982,KEDC,903,KG,15,11,0,0,0,0,0,0,0,0,0,0,0,0,0,0,0,0,0,0,11,15,26,26
20192020,077,MARTIN,385,Martin County,120,Inez Elementary School,385120,077385120,210384000982,KEDC,903,01,15,19,0,0,0,0,0,0,0,0,0,0,0,0,0,0,0,0,0,0,19,15,34,34
20192020,077,MARTIN,385,Martin County,120,Inez Elementary School,385120,077385120,210384000982,KEDC,903,02,25,15,0,0,0,0,0,0,0,0,0,0,0,0,0,0,0,0,1,1,15,24,39,40
20192020,077,MARTIN,385,Martin County,120,Inez Elementary School,385120,077385120,210384000982,KEDC,903,03,16,15,0,0,0,0,0,0,0,0,0,0,0,0,0,0,0,0,0,0,15,16,31,31
20192020,077,MARTIN,385,Martin County,120,Inez Elementary School,385120,077385120,210384000982,KEDC,903,04,9,23,1,0,1,0,0,0,0,0,0,0,0,0,0,0,0,0,0,0,22,9,31,32
20192020,077,MARTIN,385,Martin County,120,Inez Elementary School,385120,077385120,210384000982,KEDC,903,06,36,29,0,1,1,0,0,0,0,0,0,0,0,0,0,0,0,0,1,1,29,34,63,65
20192020,077,MARTIN,385,Martin County,250,Martin County High School,385250,077385250,210384000985,KEDC,903,12,57,69,2,0,2,0,0,0,0,0,0,0,0,0,0,0,0,0,0,0,67,57,124,126
20192020,077,MARTIN,385,Martin County,250,Martin County High School,385250,077385250,210384000985,KEDC,903,All Students,224,297,2,0,2,0,0,0,0,0,0,2,1,3,0,1,1,4,0,4,289,222,511,521
20192020,077,MARTIN,385,Martin County,250,Martin County High School,385250,077385250,210384000985,KEDC,903,09,58,76,0,0,0,0,0,0,0,0,0,0,0,0,0,0,0,0,0,0,76,58,134,134
20192020,077,MARTIN,385,Martin County,250,Martin County High School,385250,077385250,210384000985,KEDC,903,10,57,82,0,0,0,0,0,0,0,0,0,2,0,2,0,0,0,2,0,2,78,57,135,139
20192020,077,MARTIN,385,Martin County,250,Martin County High School,385250,077385250,210384000985,KEDC,903,11,51,70,0,0,0,0,0,0,0,0,0,0,1,1,0,1,1,2,0,2,68,49,117,121
20192020,077,MARTIN,385,Martin County,250,Martin County High School,385250,077385250,210384000985,KEDC,903,14,1,0,0,0,0,0,0,0,0,0,0,0,0,0,0,0,0,0,0,0,0,1,1,1
20192020,077,MARTIN,385,Martin County,300,Warfield Elementary School,385300,077385300,210384000988,KEDC,903,05,17,25,0,0,0,0,0,0,0,0,0,0,0,0,0,0,0,1,0,1,24,17,41,42
20192020,077,MARTIN,385,Martin County,300,Warfield Elementary School,385300,077385300,210384000988,KEDC,903,All Students,133,153,0,2,2,0,0,0,0,0,0,1,0,1,0,0,0,1,1,2,151,130,281,286
20192020,077,MARTIN,385,Martin County,300,Warfield Elementary School,385300,077385300,210384000988,KEDC,903,PS,23,18,0,0,0,0,0,0,0,0,0,0,1,1,0,0,0,0,0,0,18,22,40,41
20192020,077,MARTIN,385,Martin County,300,Warfield Elementary School,385300,077385300,210384000988,KEDC,903,KG,15,16,0,1,1,0,0,0,0,0,0,0,0,0,0,0,0,0,0,0,16,14,30,31
20192020,077,MARTIN,385,Martin County,300,Warfield Elementary School,385300,077385300,210384000988,KEDC,903,01,18,22,0,1,1,0,0,0,0,0,0,0,0,0,0,0,0,0,0,0,22,17,39,40
20192020,077,MARTIN,385,Martin County,300,Warfield Elementary School,385300,077385300,210384000988,KEDC,903,02,15,22,0,0,0,0,0,0,0,0,0,0,0,0,0,0,0,0,0,0,22,15,37,37
20192020,077,MARTIN,385,Martin County,300,Warfield Elementary School,385300,077385300,210384000988,KEDC,903,03,14,23,0,0,0,0,0,0,0,0,0,1,0,1,0,0,0,0,0,0,22,14,36,37
20192020,077,MARTIN,385,Martin County,300,Warfield Elementary School,385300,077385300,210384000988,KEDC,903,04,24,23,0,0,0,0,0,0,0,0,0,0,0,0,0,0,0,0,1,1,23,23,46,47
20192020,077,MARTIN,385,Martin County,300,Warfield Elementary School,385300,077385300,210384000988,KEDC,903,06,30,22,0,0,0,0,0,0,0,0,0,0,0,0,0,0,0,0,0,0,22,30,52,52
20192020,077,MARTIN,385,Martin County,330,Martin County Middle School,385330,077385330,210384002386,KEDC,903,07,69,70,0,0,0,0,0,0,0,0,0,1,1,2,0,0,0,1,0,1,68,68,136,139
20192020,077,MARTIN,385,Martin County,330,Martin County Middle School,385330,077385330,210384002386,KEDC,903,All Students,123,141,0,0,0,0,0,0,0,0,0,1,2,3,0,0,0,1,0,1,139,121,260,264
20192020,077,MARTIN,385,Martin County,330,Martin County Middle School,385330,077385330,210384002386,KEDC,903,08,54,71,0,0,0,0,0,0,0,0,0,0,1,1,0,0,0,0,0,0,71,53,124,125
20192020,078,MASON,391,Mason County,"",---District Total---,391,"","",KEDC,903,04,104,107,11,9,20,0,1,1,0,1,1,9,5,14,0,0,0,7,10,17,80,78,158,211
20192020,078,MASON,391,Mason County,"",---District Total---,391,"","",KEDC,903,All Students,1223,1350,89,110,199,3,3,6,6,6,12,61,49,110,0,0,0,98,104,202,1093,951,2044,2573
20192020,078,MASON,391,Mason County,"",---District Total---,391,"","",KEDC,903,PS,59,74,4,5,9,0,0,0,1,0,1,3,2,5,0,0,0,10,6,16,56,46,102,133
20192020,078,MASON,391,Mason County,"",---District Total---,391,"","",KEDC,903,KG,85,105,4,10,14,0,0,0,1,1,2,6,3,9,0,0,0,12,9,21,82,62,144,190
20192020,078,MASON,391,Mason County,"",---District Total---,391,"","",KEDC,903,01,92,115,13,3,16,0,1,1,1,0,1,7,5,12,0,0,0,15,5,20,79,78,157,207
20192020,078,MASON,391,Mason County,"",---District Total---,391,"","",KEDC,903,02,94,83,2,4,6,1,0,1,0,0,0,2,5,7,0,0,0,4,14,18,74,71,145,177
20192020,078,MASON,391,Mason County,"",---District Total---,391,"","",KEDC,903,03,94,92,4,12,16,0,0,0,0,1,1,5,3,8,0,0,0,9,8,17,74,70,144,186
20192020,078,MASON,391,Mason County,"",---District Total---,391,"","",KEDC,903,05,96,108,3,7,10,0,1,1,1,0,1,0,3,3,0,0,0,9,9,18,95,76,171,204
20192020,078,MASON,391,Mason County,"",---District Total---,391,"","",KEDC,903,06,102,116,9,13,22,0,0,0,1,0,1,7,4,11,0,0,0,6,11,17,93,74,167,218
20192020,078,MASON,391,Mason County,"",---District Total---,391,"","",KEDC,903,07,115,130,14,10,24,0,0,0,0,1,1,4,5,9,0,0,0,11,11,22,101,88,189,245
20192020,078,MASON,391,Mason County,"",---District Total---,391,"","",KEDC,903,08,96,103,7,10,17,0,0,0,0,0,0,6,4,10,0,0,0,6,5,11,84,77,161,199
20192020,078,MASON,391,Mason County,"",---District Total---,391,"","",KEDC,903,09,93,118,7,4,11,0,0,0,1,0,1,5,5,10,0,0,0,6,5,11,99,79,178,211
20192020,078,MASON,391,Mason County,"",---District Total---,391,"","",KEDC,903,10,94,108,4,12,16,1,0,1,0,1,1,4,1,5,0,0,0,3,9,12,96,71,167,202
20192020,078,MASON,391,Mason County,"",---District Total---,391,"","",KEDC,903,11,94,80,3,8,11,0,0,0,1,0,1,5,2,7,0,0,0,5,5,10,66,79,145,174
20192020,078,MASON,391,Mason County,"",---District Total---,391,"","",KEDC,903,12,63,85,8,8,16,1,0,1,0,1,1,1,4,5,0,0,0,5,3,8,70,47,117,148
20192020,078,MASON,391,Mason County,"",---District Total---,391,"","",KEDC,903,14,1,0,0,0,0,0,0,0,0,0,0,0,0,0,0,0,0,0,0,0,0,1,1,1
20192020,078,MASON,391,Mason County,011,Mason County Intermediate School,391011,078391011,210387002000,KEDC,903,03,94,92,4,12,16,0,0,0,0,1,1,5,3,8,0,0,0,9,8,17,74,70,144,186
20192020,078,MASON,391,Mason County,011,Mason County Intermediate School,391011,078391011,210387002000,KEDC,903,04,104,107,11,9,20,0,1,1,0,1,1,9,5,14,0,0,0,7,10,17,80,78,158,211
20192020,078,MASON,391,Mason County,011,Mason County Intermediate School,391011,078391011,210387002000,KEDC,903,05,96,108,3,7,10,0,1,1,1,0,1,0,3,3,0,0,0,9,9,18,95,76,171,204
20192020,078,MASON,391,Mason County,011,Mason County Intermediate School,391011,078391011,210387002000,KEDC,903,All Students,294,307,18,28,46,0,2,2,1,2,3,14,11,25,0,0,0,25,27,52,249,224,473,601
20192020,078,MASON,391,Mason County,030,Mason County High School,391030,078391030,210387000989,KEDC,903,11,94,80,3,8,11,0,0,0,1,0,1,5,2,7,0,0,0,5,5,10,66,79,145,174
20192020,078,MASON,391,Mason County,030,Mason County High School,391030,078391030,210387000989,KEDC,903,14,1,0,0,0,0,0,0,0,0,0,0,0,0,0,0,0,0,0,0,0,0,1,1,1
20192020,078,MASON,391,Mason County,030,Mason County High School,391030,078391030,210387000989,KEDC,903,12,63,85,8,8,16,1,0,1,0,1,1,1,4,5,0,0,0,5,3,8,70,47,117,148
20192020,078,MASON,391,Mason County,030,Mason County High School,391030,078391030,210387000989,KEDC,903,All Students,345,391,22,32,54,2,0,2,2,2,4,15,12,27,0,0,0,19,22,41,331,277,608,736
20192020,078,MASON,391,Mason County,030,Mason County High School,391030,078391030,210387000989,KEDC,903,09,93,118,7,4,11,0,0,0,1,0,1,5,5,10,0,0,0,6,5,11,99,79,178,211
20192020,078,MASON,391,Mason County,030,Mason County High School,391030,078391030,210387000989,KEDC,903,10,94,108,4,12,16,1,0,1,0,1,1,4,1,5,0,0,0,3,9,12,96,71,167,202
20192020,078,MASON,391,Mason County,050,Mason County Middle School,391050,078391050,210387000991,KEDC,903,07,115,130,14,10,24,0,0,0,0,1,1,4,5,9,0,0,0,11,11,22,101,88,189,245
20192020,078,MASON,391,Mason County,050,Mason County Middle School,391050,078391050,210387000991,KEDC,903,All Students,313,349,30,33,63,0,0,0,1,1,2,17,13,30,0,0,0,23,27,50,278,239,517,662
20192020,078,MASON,391,Mason County,050,Mason County Middle School,391050,078391050,210387000991,KEDC,903,06,102,116,9,13,22,0,0,0,1,0,1,7,4,11,0,0,0,6,11,17,93,74,167,218
20192020,078,MASON,391,Mason County,050,Mason County Middle School,391050,078391050,210387000991,KEDC,903,08,96,103,7,10,17,0,0,0,0,0,0,6,4,10,0,0,0,6,5,11,84,77,161,199
20192020,078,MASON,391,Mason County,080,Charles Straub Elementary School,391080,078391080,210387001460,KEDC,903,01,92,115,13,3,16,0,1,1,1,0,1,7,5,12,0,0,0,15,5,20,79,78,157,207
20192020,078,MASON,391,Mason County,080,Charles Straub Elementary School,391080,078391080,210387001460,KEDC,903,All Students,271,303,19,17,36,1,1,2,2,1,3,15,13,28,0,0,0,31,28,59,235,211,446,574
20192020,078,MASON,391,Mason County,080,Charles Straub Elementary School,391080,078391080,210387001460,KEDC,903,PS,59,74,4,5,9,0,0,0,1,0,1,3,2,5,0,0,0,10,6,16,56,46,102,133
20192020,078,MASON,391,Mason County,080,Charles Straub Elementary School,391080,078391080,210387001460,KEDC,903,KG,85,105,4,10,14,0,0,0,1,1,2,6,3,9,0,0,0,12,9,21,82,62,144,190
20192020,078,MASON,391,Mason County,080,Charles Straub Elementary School,391080,078391080,210387001460,KEDC,903,02,94,83,2,4,6,1,0,1,0,0,0,2,5,7,0,0,0,4,14,18,74,71,145,177
20192020,042,GRAVES,392,Mayfield Independent,"",---District Total---,392,"","",WKEC,908,11,55,47,8,11,19,0,0,0,0,0,0,15,15,30,0,0,0,3,2,5,21,27,48,102
20192020,042,GRAVES,392,Mayfield Independent,"",---District Total---,392,"","",WKEC,908,All Students,877,914,107,132,239,1,1,2,3,4,7,302,270,572,3,0,3,90,88,178,408,382,790,1791
20192020,042,GRAVES,392,Mayfield Independent,"",---District Total---,392,"","",WKEC,908,PS,73,111,14,9,23,0,0,0,0,2,2,38,27,65,0,0,0,14,11,25,45,24,69,184
20192020,042,GRAVES,392,Mayfield Independent,"",---District Total---,392,"","",WKEC,908,KG,74,79,6,7,13,1,0,1,1,1,2,26,25,51,1,0,1,12,6,18,32,35,67,153
20192020,042,GRAVES,392,Mayfield Independent,"",---District Total---,392,"","",WKEC,908,01,83,79,6,14,20,0,0,0,1,1,2,32,26,58,0,0,0,8,10,18,32,32,64,162
20192020,042,GRAVES,392,Mayfield Independent,"",---District Total---,392,"","",WKEC,908,02,61,81,10,7,17,0,0,0,0,1,1,21,19,40,0,0,0,13,6,19,37,28,65,142
20192020,042,GRAVES,392,Mayfield Independent,"",---District Total---,392,"","",WKEC,908,03,68,72,7,9,16,0,0,0,0,0,0,29,19,48,1,0,1,6,9,15,29,31,60,140
20192020,042,GRAVES,392,Mayfield Independent,"",---District Total---,392,"","",WKEC,908,14,2,0,0,0,0,0,0,0,0,0,0,0,2,2,0,0,0,0,0,0,0,0,0,2
20192020,042,GRAVES,392,Mayfield Independent,"",---District Total---,392,"","",WKEC,908,04,63,69,7,8,15,0,0,0,0,0,0,29,19,48,0,0,0,4,12,16,29,24,53,132
20192020,042,GRAVES,392,Mayfield Independent,"",---District Total---,392,"","",WKEC,908,05,77,84,9,10,19,0,0,0,1,0,1,30,23,53,1,0,1,5,7,12,38,37,75,161
20192020,042,GRAVES,392,Mayfield Independent,"",---District Total---,392,"","",WKEC,908,06,87,64,8,18,26,0,1,1,0,0,0,21,27,48,0,0,0,7,6,13,28,35,63,151
20192020,042,GRAVES,392,Mayfield Independent,"",---District Total---,392,"","",WKEC,908,07,66,64,8,12,20,0,0,0,0,0,0,18,19,37,0,0,0,5,5,10,33,30,63,130
20192020,042,GRAVES,392,Mayfield Independent,"",---District Total---,392,"","",WKEC,908,08,63,77,13,11,24,0,0,0,0,1,1,24,16,40,0,0,0,6,10,16,34,25,59,140
20192020,042,GRAVES,392,Mayfield Independent,"",---District Total---,392,"","",WKEC,908,09,64,74,10,12,22,0,0,0,0,0,0,26,21,47,0,0,0,8,8,16,30,23,53,138
20192020,042,GRAVES,392,Mayfield Independent,"",---District Total---,392,"","",WKEC,908,10,56,66,4,7,11,0,0,0,0,0,0,21,18,39,0,0,0,9,4,13,32,27,59,122
20192020,042,GRAVES,392,Mayfield Independent,"",---District Total---,392,"","",WKEC,908,12,58,58,11,6,17,0,0,0,0,0,0,10,21,31,0,0,0,4,3,7,33,28,61,116
20192020,042,GRAVES,392,Mayfield Independent,031,Mayfield Elementary School,392031,042392031,210390002001,WKEC,908,All Students,349,380,36,45,81,1,0,1,2,3,5,137,108,245,2,0,2,43,43,86,159,150,309,729
20192020,042,GRAVES,392,Mayfield Independent,031,Mayfield Elementary School,392031,042392031,210390002001,WKEC,908,PS,73,111,14,9,23,0,0,0,0,2,2,38,27,65,0,0,0,14,11,25,45,24,69,184
20192020,042,GRAVES,392,Mayfield Independent,031,Mayfield Elementary School,392031,042392031,210390002001,WKEC,908,KG,74,79,6,7,13,1,0,1,1,1,2,26,25,51,1,0,1,12,6,18,32,35,67,153
20192020,042,GRAVES,392,Mayfield Independent,031,Mayfield Elementary School,392031,042392031,210390002001,WKEC,908,01,83,79,6,14,20,0,0,0,1,1,2,32,26,58,0,0,0,8,10,18,32,32,64,162
20192020,042,GRAVES,392,Mayfield Independent,031,Mayfield Elementary School,392031,042392031,210390002001,WKEC,908,02,61,81,10,7,17,0,0,0,0,1,1,21,19,40,0,0,0,13,6,19,37,28,65,142
20192020,042,GRAVES,392,Mayfield Independent,031,Mayfield Elementary School,392031,042392031,210390002001,WKEC,908,03,68,72,7,9,16,0,0,0,0,0,0,29,19,48,1,0,1,6,9,15,29,31,60,140
20192020,042,GRAVES,392,Mayfield Independent,031,Mayfield Elementary School,392031,042392031,210390002001,WKEC,908,04,63,69,7,8,15,0,0,0,0,0,0,29,19,48,0,0,0,4,12,16,29,24,53,132
20192020,042,GRAVES,392,Mayfield Independent,060,Mayfield High School,392060,042392060,210390000995,WKEC,908,11,55,47,8,11,19,0,0,0,0,0,0,15,15,30,0,0,0,3,2,5,21,27,48,102
20192020,042,GRAVES,392,Mayfield Independent,060,Mayfield High School,392060,042392060,210390000995,WKEC,908,12,58,58,11,6,17,0,0,0,0,0,0,10,21,31,0,0,0,4,3,7,33,28,61,116
20192020,042,GRAVES,392,Mayfield Independent,060,Mayfield High School,392060,042392060,210390000995,WKEC,908,14,2,0,0,0,0,0,0,0,0,0,0,0,2,2,0,0,0,0,0,0,0,0,0,2
20192020,042,GRAVES,392,Mayfield Independent,060,Mayfield High School,392060,042392060,210390000995,WKEC,908,All Students,235,245,33,36,69,0,0,0,0,0,0,72,77,149,0,0,0,24,17,41,116,105,221,480
20192020,042,GRAVES,392,Mayfield Independent,060,Mayfield High School,392060,042392060,210390000995,WKEC,908,09,64,74,10,12,22,0,0,0,0,0,0,26,21,47,0,0,0,8,8,16,30,23,53,138
20192020,042,GRAVES,392,Mayfield Independent,060,Mayfield High School,392060,042392060,210390000995,WKEC,908,10,56,66,4,7,11,0,0,0,0,0,0,21,18,39,0,0,0,9,4,13,32,27,59,122
20192020,042,GRAVES,392,Mayfield Independent,065,Mayfield Middle School,392065,042392065,210390000996,WKEC,908,07,66,64,8,12,20,0,0,0,0,0,0,18,19,37,0,0,0,5,5,10,33,30,63,130
20192020,042,GRAVES,392,Mayfield Independent,065,Mayfield Middle School,392065,042392065,210390000996,WKEC,908,08,63,77,13,11,24,0,0,0,0,1,1,24,16,40,0,0,0,6,10,16,34,25,59,140
20192020,042,GRAVES,392,Mayfield Independent,065,Mayfield Middle School,392065,042392065,210390000996,WKEC,908,All Students,293,289,38,51,89,0,1,1,1,1,2,93,85,178,1,0,1,23,28,51,133,127,260,582
20192020,042,GRAVES,392,Mayfield Independent,065,Mayfield Middle School,392065,042392065,210390000996,WKEC,908,05,77,84,9,10,19,0,0,0,1,0,1,30,23,53,1,0,1,5,7,12,38,37,75,161
20192020,042,GRAVES,392,Mayfield Independent,065,Mayfield Middle School,392065,042392065,210390000996,WKEC,908,06,87,64,8,18,26,0,1,1,0,0,0,21,27,48,0,0,0,7,6,13,28,35,63,151
20192020,079,MCCRACKEN,395,McCracken County,"",---District Total---,395,"","",WKEC,908,08,258,288,11,12,23,2,0,2,4,5,9,11,19,30,0,0,0,11,14,25,249,208,457,546
20192020,079,MCCRACKEN,395,McCracken County,"",---District Total---,395,"","",WKEC,908,09,268,280,18,18,36,0,0,0,3,0,3,23,8,31,0,0,0,7,7,14,229,235,464,548
20192020,079,MCCRACKEN,395,McCracken County,"",---District Total---,395,"","",WKEC,908,10,242,246,24,8,32,2,1,3,2,5,7,10,10,20,0,0,0,8,9,17,200,209,409,488
20192020,079,MCCRACKEN,395,McCracken County,"",---District Total---,395,"","",WKEC,908,12,254,251,16,11,27,0,1,1,4,2,6,9,10,19,0,0,0,11,8,19,211,222,433,505
20192020,079,MCCRACKEN,395,McCracken County,"",---District Total---,395,"","",WKEC,908,11,259,250,12,11,23,0,0,0,3,6,9,9,17,26,1,0,1,5,7,12,220,218,438,509
20192020,079,MCCRACKEN,395,McCracken County,"",---District Total---,395,"","",WKEC,908,All Students,3328,3418,200,177,377,7,7,14,39,49,88,155,154,309,2,0,2,156,137,293,2859,2804,5663,6746
20192020,079,MCCRACKEN,395,McCracken County,"",---District Total---,395,"","",WKEC,908,PS,121,188,16,18,34,0,0,0,5,1,6,7,6,13,0,0,0,11,11,22,149,85,234,309
20192020,079,MCCRACKEN,395,McCracken County,"",---District Total---,395,"","",WKEC,908,KG,260,276,13,14,27,1,0,1,5,4,9,17,7,24,0,0,0,16,11,27,224,224,448,536
20192020,079,MCCRACKEN,395,McCracken County,"",---District Total---,395,"","",WKEC,908,01,277,272,20,18,38,0,1,1,3,7,10,12,10,22,0,0,0,20,12,32,217,229,446,549
20192020,079,MCCRACKEN,395,McCracken County,"",---District Total---,395,"","",WKEC,908,02,227,249,23,10,33,0,0,0,3,2,5,9,9,18,0,0,0,11,11,22,203,195,398,476
20192020,079,MCCRACKEN,395,McCracken County,"",---District Total---,395,"","",WKEC,908,03,239,256,13,12,25,1,1,2,3,2,5,10,11,21,0,0,0,20,15,35,209,198,407,495
20192020,079,MCCRACKEN,395,McCracken County,"",---District Total---,395,"","",WKEC,908,04,259,272,17,13,30,0,0,0,3,2,5,8,13,21,0,0,0,7,9,16,237,222,459,531
20192020,079,MCCRACKEN,395,McCracken County,"",---District Total---,395,"","",WKEC,908,05,249,272,15,12,27,1,1,2,2,4,6,13,13,26,0,0,0,12,18,30,229,201,430,521
20192020,079,MCCRACKEN,395,McCracken County,"",---District Total---,395,"","",WKEC,908,06,265,263,8,23,31,0,1,1,2,2,4,15,13,28,1,0,1,19,9,28,218,217,435,528
20192020,079,MCCRACKEN,395,McCracken County,"",---District Total---,395,"","",WKEC,908,07,271,243,10,15,25,0,1,1,2,8,10,9,14,23,0,0,0,9,7,16,213,226,439,514
20192020,079,MCCRACKEN,395,McCracken County,010,Concord Elementary School,395010,079395010,210396001001,WKEC,908,04,54,49,3,4,7,0,0,0,1,0,1,0,2,2,0,0,0,1,3,4,44,45,89,103
20192020,079,MCCRACKEN,395,McCracken County,010,Concord Elementary School,395010,079395010,210396001001,WKEC,908,All Students,293,308,23,14,37,0,1,1,7,8,15,10,9,19,0,0,0,21,18,39,247,243,490,601
20192020,079,MCCRACKEN,395,McCracken County,010,Concord Elementary School,395010,079395010,210396001001,WKEC,908,PS,17,35,6,5,11,0,0,0,3,0,3,2,1,3,0,0,0,1,0,1,23,11,34,52
20192020,079,MCCRACKEN,395,McCracken County,010,Concord Elementary School,395010,079395010,210396001001,WKEC,908,KG,50,55,4,1,5,0,0,0,3,4,7,1,1,2,0,0,0,4,3,7,43,41,84,105
20192020,079,MCCRACKEN,395,McCracken County,010,Concord Elementary School,395010,079395010,210396001001,WKEC,908,01,53,59,4,3,7,0,0,0,1,2,3,4,2,6,0,0,0,5,2,7,45,44,89,112
20192020,079,MCCRACKEN,395,McCracken County,010,Concord Elementary School,395010,079395010,210396001001,WKEC,908,02,48,41,5,2,7,0,0,0,0,1,1,1,2,3,0,0,0,3,2,5,32,41,73,89
20192020,079,MCCRACKEN,395,McCracken County,010,Concord Elementary School,395010,079395010,210396001001,WKEC,908,03,43,45,3,2,5,0,1,1,2,0,2,0,1,1,0,0,0,5,3,8,35,36,71,88
20192020,079,MCCRACKEN,395,McCracken County,010,Concord Elementary School,395010,079395010,210396001001,WKEC,908,05,45,59,4,2,6,0,0,0,0,1,1,4,1,5,0,0,0,3,5,8,48,36,84,104
20192020,079,MCCRACKEN,395,McCracken County,012,McCracken Open Campus School,395012,079395012,210396001801,WKEC,908,11,3,19,3,0,3,0,0,0,0,0,0,0,1,1,0,0,0,1,0,1,15,2,17,22
20192020,079,MCCRACKEN,395,McCracken County,012,McCracken Open Campus School,395012,079395012,210396001801,WKEC,908,All Students,42,75,7,5,12,1,0,1,1,0,1,1,2,3,0,0,0,5,1,6,60,34,94,117
20192020,079,MCCRACKEN,395,McCracken County,012,McCracken Open Campus School,395012,079395012,210396001801,WKEC,908,06,1,3,0,0,0,0,0,0,0,0,0,0,0,0,0,0,0,0,0,0,3,1,4,4
20192020,079,MCCRACKEN,395,McCracken County,012,McCracken Open Campus School,395012,079395012,210396001801,WKEC,908,07,2,3,0,0,0,0,0,0,0,0,0,0,0,0,0,0,0,0,0,0,3,2,5,5
20192020,079,MCCRACKEN,395,McCracken County,012,McCracken Open Campus School,395012,079395012,210396001801,WKEC,908,08,1,3,0,0,0,0,0,0,0,0,0,0,0,0,0,0,0,1,0,1,2,1,3,4
20192020,079,MCCRACKEN,395,McCracken County,012,McCracken Open Campus School,395012,079395012,210396001801,WKEC,908,09,3,6,0,3,3,0,0,0,0,0,0,0,0,0,0,0,0,0,0,0,6,0,6,9
20192020,079,MCCRACKEN,395,McCracken County,012,McCracken Open Campus School,395012,079395012,210396001801,WKEC,908,10,5,8,0,1,1,1,0,1,1,0,1,0,1,1,0,0,0,0,0,0,6,3,9,13
20192020,079,MCCRACKEN,395,McCracken County,012,McCracken Open Campus School,395012,079395012,210396001801,WKEC,908,12,27,33,4,1,5,0,0,0,0,0,0,1,0,1,0,0,0,3,1,4,25,25,50,60
20192020,079,MCCRACKEN,395,McCracken County,013,McCracken Regional School,395013,079395013,210396001862,WKEC,908,12,1,3,0,0,0,0,0,0,0,0,0,0,0,0,0,0,0,1,0,1,2,1,3,4
20192020,079,MCCRACKEN,395,McCracken County,013,McCracken Regional School,395013,079395013,210396001862,WKEC,908,All Students,3,17,6,0,6,0,0,0,0,0,0,0,0,0,0,0,0,3,0,3,8,3,11,20
20192020,079,MCCRACKEN,395,McCracken County,013,McCracken Regional School,395013,079395013,210396001862,WKEC,908,08,1,3,0,0,0,0,0,0,0,0,0,0,0,0,0,0,0,0,0,0,3,1,4,4
20192020,079,MCCRACKEN,395,McCracken County,013,McCracken Regional School,395013,079395013,210396001862,WKEC,908,09,0,3,3,0,3,0,0,0,0,0,0,0,0,0,0,0,0,0,0,0,0,0,0,3
20192020,079,MCCRACKEN,395,McCracken County,013,McCracken Regional School,395013,079395013,210396001862,WKEC,908,10,0,4,2,0,2,0,0,0,0,0,0,0,0,0,0,0,0,0,0,0,2,0,2,4
20192020,079,MCCRACKEN,395,McCracken County,013,McCracken Regional School,395013,079395013,210396001862,WKEC,908,11,1,4,1,0,1,0,0,0,0,0,0,0,0,0,0,0,0,2,0,2,1,1,2,5
20192020,079,MCCRACKEN,395,McCracken County,015,McCracken County High School,395015,079395015,210396002332,WKEC,908,11,255,227,8,11,19,0,0,0,3,6,9,9,16,25,1,0,1,2,7,9,204,215,419,482
20192020,079,MCCRACKEN,395,McCracken County,015,McCracken County High School,395015,079395015,210396002332,WKEC,908,All Students,983,947,57,43,100,1,2,3,11,13,24,50,43,93,1,0,1,24,30,54,803,852,1655,1930
20192020,079,MCCRACKEN,395,McCracken County,015,McCracken County High School,395015,079395015,210396002332,WKEC,908,09,265,271,15,15,30,0,0,0,3,0,3,23,8,31,0,0,0,7,7,14,223,235,458,536
20192020,079,MCCRACKEN,395,McCracken County,015,McCracken County High School,395015,079395015,210396002332,WKEC,908,10,237,234,22,7,29,1,1,2,1,5,6,10,9,19,0,0,0,8,9,17,192,206,398,471
20192020,079,MCCRACKEN,395,McCracken County,015,McCracken County High School,395015,079395015,210396002332,WKEC,908,12,226,215,12,10,22,0,1,1,4,2,6,8,10,18,0,0,0,7,7,14,184,196,380,441
20192020,079,MCCRACKEN,395,McCracken County,030,Reidland Intermediate School,395030,079395030,210396002419,WKEC,908,04,57,62,2,2,4,0,0,0,1,0,1,3,3,6,0,0,0,2,1,3,54,51,105,119
20192020,079,MCCRACKEN,395,McCracken County,030,Reidland Intermediate School,395030,079395030,210396002419,WKEC,908,All Students,110,114,6,3,9,0,0,0,1,1,2,4,7,11,0,0,0,5,7,12,98,92,190,224
20192020,079,MCCRACKEN,395,McCracken County,030,Reidland Intermediate School,395030,079395030,210396002419,WKEC,908,05,53,52,4,1,5,0,0,0,0,1,1,1,4,5,0,0,0,3,6,9,44,41,85,105
20192020,079,MCCRACKEN,395,McCracken County,055,Heath Middle School,395055,079395055,210396001006,WKEC,908,07,90,78,2,2,4,0,0,0,0,1,1,3,2,5,0,0,0,5,1,6,68,84,152,168
20192020,079,MCCRACKEN,395,McCracken County,055,Heath Middle School,395055,079395055,210396001006,WKEC,908,All Students,219,234,6,9,15,1,0,1,1,3,4,11,10,21,0,0,0,12,7,19,203,190,393,453
20192020,079,MCCRACKEN,395,McCracken County,055,Heath Middle School,395055,079395055,210396001006,WKEC,908,06,62,71,0,4,4,0,0,0,1,1,2,7,4,11,0,0,0,5,3,8,58,50,108,133
20192020,079,MCCRACKEN,395,McCracken County,055,Heath Middle School,395055,079395055,210396001006,WKEC,908,08,67,85,4,3,7,1,0,1,0,1,1,1,4,5,0,0,0,2,3,5,77,56,133,152
20192020,079,MCCRACKEN,395,McCracken County,065,Hendron Lone Oak Elementary School,395065,079395065,210396001431,WKEC,908,03,42,57,1,2,3,0,0,0,0,1,1,2,3,5,0,0,0,4,1,5,50,35,85,99
20192020,079,MCCRACKEN,395,McCracken County,065,Hendron Lone Oak Elementary School,395065,079395065,210396001431,WKEC,908,All Students,198,215,11,8,19,0,0,0,3,3,6,9,6,15,0,0,0,13,9,22,179,172,351,413
20192020,079,MCCRACKEN,395,McCracken County,065,Hendron Lone Oak Elementary School,395065,079395065,210396001431,WKEC,908,PS,19,39,2,2,4,0,0,0,1,0,1,1,2,3,0,0,0,2,2,4,33,13,46,58
20192020,079,MCCRACKEN,395,McCracken County,065,Hendron Lone Oak Elementary School,395065,079395065,210396001431,WKEC,908,KG,59,51,0,3,3,0,0,0,1,0,1,4,1,5,0,0,0,3,4,7,43,51,94,110
20192020,079,MCCRACKEN,395,McCracken County,065,Hendron Lone Oak Elementary School,395065,079395065,210396001431,WKEC,908,01,51,55,7,1,8,0,0,0,1,1,2,1,1,2,0,0,0,4,2,6,42,46,88,106
20192020,079,MCCRACKEN,395,McCracken County,065,Hendron Lone Oak Elementary School,395065,079395065,210396001431,WKEC,908,02,46,52,3,2,5,0,0,0,1,1,2,2,1,3,0,0,0,2,2,4,44,40,84,98
20192020,079,MCCRACKEN,395,McCracken County,075,Lone Oak Intermediate School,395075,079395075,210396002374,WKEC,908,04,113,127,11,7,18,0,0,0,1,1,2,5,7,12,0,0,0,3,5,8,107,93,200,240
20192020,079,MCCRACKEN,395,McCracken County,075,Lone Oak Intermediate School,395075,079395075,210396002374,WKEC,908,All Students,228,251,18,15,33,1,1,2,3,3,6,12,15,27,0,0,0,9,12,21,208,182,390,479
20192020,079,MCCRACKEN,395,McCracken County,075,Lone Oak Intermediate School,395075,079395075,210396002374,WKEC,908,02,0,1,0,0,0,0,0,0,0,0,0,0,0,0,0,0,0,0,0,0,1,0,1,1
20192020,079,MCCRACKEN,395,McCracken County,075,Lone Oak Intermediate School,395075,079395075,210396002374,WKEC,908,03,0,1,0,0,0,0,0,0,0,0,0,0,0,0,0,0,0,0,0,0,1,0,1,1
20192020,079,MCCRACKEN,395,McCracken County,075,Lone Oak Intermediate School,395075,079395075,210396002374,WKEC,908,05,115,122,7,8,15,1,1,2,2,2,4,7,8,15,0,0,0,6,7,13,99,89,188,237
20192020,079,MCCRACKEN,395,McCracken County,080,Lone Oak Elementary School,395080,079395080,210396001009,WKEC,908,02,46,53,8,2,10,0,0,0,1,0,1,1,2,3,0,0,0,1,1,2,42,41,83,99
20192020,079,MCCRACKEN,395,McCracken County,080,Lone Oak Elementary School,395080,079395080,210396001009,WKEC,908,All Students,236,239,21,25,46,0,0,0,3,3,6,12,11,23,0,0,0,15,14,29,188,183,371,475
20192020,079,MCCRACKEN,395,McCracken County,080,Lone Oak Elementary School,395080,079395080,210396001009,WKEC,908,PS,27,34,5,7,12,0,0,0,0,0,0,3,0,3,0,0,0,2,5,7,24,15,39,61
20192020,079,MCCRACKEN,395,McCracken County,080,Lone Oak Elementary School,395080,079395080,210396001009,WKEC,908,KG,53,57,4,7,11,0,0,0,1,0,1,5,2,7,0,0,0,3,3,6,44,41,85,110
20192020,079,MCCRACKEN,395,McCracken County,080,Lone Oak Elementary School,395080,079395080,210396001009,WKEC,908,01,76,64,3,11,14,0,0,0,1,3,4,1,1,2,0,0,0,5,4,9,54,57,111,140
20192020,079,MCCRACKEN,395,McCracken County,080,Lone Oak Elementary School,395080,079395080,210396001009,WKEC,908,03,61,65,6,5,11,0,0,0,0,0,0,5,6,11,0,0,0,6,6,12,48,44,92,126
20192020,079,MCCRACKEN,395,McCracken County,085,Lone Oak Middle School,395085,079395085,210396001010,WKEC,908,07,123,115,8,12,20,0,0,0,2,7,9,1,7,8,0,0,0,3,2,5,101,95,196,238
20192020,079,MCCRACKEN,395,McCracken County,085,Lone Oak Middle School,395085,079395085,210396001010,WKEC,908,08,132,132,4,6,10,1,0,1,2,4,6,8,9,17,0,0,0,5,7,12,112,106,218,264
20192020,079,MCCRACKEN,395,McCracken County,085,Lone Oak Middle School,395085,079395085,210396001010,WKEC,908,All Students,389,378,19,28,47,1,0,1,4,12,16,12,21,33,1,0,1,17,13,30,324,315,639,767
20192020,079,MCCRACKEN,395,McCracken County,085,Lone Oak Middle School,395085,079395085,210396001010,WKEC,908,05,1,1,0,0,0,0,0,0,0,0,0,0,0,0,0,0,0,0,0,0,1,1,2,2
20192020,079,MCCRACKEN,395,McCracken County,085,Lone Oak Middle School,395085,079395085,210396001010,WKEC,908,06,133,130,7,10,17,0,0,0,0,1,1,3,5,8,1,0,1,9,4,13,110,113,223,263
20192020,079,MCCRACKEN,395,McCracken County,100,Reidland Elementary School,395100,079395100,210396001011,WKEC,908,02,59,63,6,2,8,0,0,0,1,0,1,3,4,7,0,0,0,4,2,6,49,51,100,122
20192020,079,MCCRACKEN,395,McCracken County,100,Reidland Elementary School,395100,079395100,210396001011,WKEC,908,All Students,243,255,19,10,29,2,1,3,1,1,2,16,10,26,0,0,0,16,8,24,201,213,414,498
20192020,079,MCCRACKEN,395,McCracken County,100,Reidland Elementary School,395100,079395100,210396001011,WKEC,908,PS,37,51,2,3,5,0,0,0,0,1,1,1,0,1,0,0,0,6,4,10,42,29,71,88
20192020,079,MCCRACKEN,395,McCracken County,100,Reidland Elementary School,395100,079395100,210396001011,WKEC,908,KG,61,75,5,2,7,1,0,1,0,0,0,5,1,6,0,0,0,2,0,2,62,58,120,136
20192020,079,MCCRACKEN,395,McCracken County,100,Reidland Elementary School,395100,079395100,210396001011,WKEC,908,01,63,67,6,3,9,0,1,1,0,0,0,6,4,10,0,0,0,5,2,7,50,53,103,130
20192020,079,MCCRACKEN,395,McCracken County,100,Reidland Elementary School,395100,079395100,210396001011,WKEC,908,03,60,50,2,3,5,1,0,1,0,1,1,2,1,3,0,0,0,5,4,9,40,51,91,110
20192020,079,MCCRACKEN,395,McCracken County,115,Reidland Middle School,395115,079395115,210396001013,WKEC,908,08,57,65,3,3,6,0,0,0,2,0,2,2,6,8,0,0,0,3,4,7,55,44,99,122
20192020,079,MCCRACKEN,395,McCracken County,115,Reidland Middle School,395115,079395115,210396001013,WKEC,908,All Students,182,171,4,13,17,0,2,2,3,0,3,12,15,27,0,0,0,9,10,19,143,142,285,353
20192020,079,MCCRACKEN,395,McCracken County,115,Reidland Middle School,395115,079395115,210396001013,WKEC,908,06,69,59,1,9,10,0,1,1,1,0,1,5,4,9,0,0,0,5,2,7,47,53,100,128
20192020,079,MCCRACKEN,395,McCracken County,115,Reidland Middle School,395115,079395115,210396001013,WKEC,908,07,56,47,0,1,1,0,1,1,0,0,0,5,5,10,0,0,0,1,4,5,41,45,86,103
20192020,079,MCCRACKEN,395,McCracken County,120,Heath Elementary School,395120,079395120,210396001461,WKEC,908,01,34,27,0,0,0,0,0,0,0,1,1,0,2,2,0,0,0,1,2,3,26,29,55,61
20192020,079,MCCRACKEN,395,McCracken County,120,Heath Elementary School,395120,079395120,210396001461,WKEC,908,02,28,39,1,2,3,0,0,0,0,0,0,2,0,2,0,0,0,1,4,5,35,22,57,67
20192020,079,MCCRACKEN,395,McCracken County,120,Heath Elementary School,395120,079395120,210396001461,WKEC,908,03,33,38,1,0,1,0,0,0,1,0,1,1,0,1,0,0,0,0,1,1,35,32,67,71
20192020,079,MCCRACKEN,395,McCracken County,120,Heath Elementary School,395120,079395120,210396001461,WKEC,908,04,35,34,1,0,1,0,0,0,0,1,1,0,1,1,0,0,0,1,0,1,32,33,65,69
20192020,079,MCCRACKEN,395,McCracken County,120,Heath Elementary School,395120,079395120,210396001461,WKEC,908,05,35,38,0,1,1,0,0,0,0,0,0,1,0,1,0,0,0,0,0,0,37,34,71,73
20192020,079,MCCRACKEN,395,McCracken County,120,Heath Elementary School,395120,079395120,210396001461,WKEC,908,All Students,202,214,3,4,7,0,0,0,1,2,3,6,5,11,0,0,0,7,8,15,197,183,380,416
20192020,079,MCCRACKEN,395,McCracken County,120,Heath Elementary School,395120,079395120,210396001461,WKEC,908,PS,21,29,1,1,2,0,0,0,1,0,1,0,3,3,0,0,0,0,0,0,27,17,44,50
20192020,079,MCCRACKEN,395,McCracken County,120,Heath Elementary School,395120,079395120,210396001461,WKEC,908,KG,37,38,0,1,1,0,0,0,0,0,0,2,2,4,0,0,0,4,1,5,32,33,65,75
20192020,080,MCCREARY,401,McCreary County,"",---District Total---,401,"","",SESC,907,09,106,105,1,1,2,0,0,0,0,0,0,4,0,4,0,0,0,2,0,2,98,105,203,211
20192020,080,MCCREARY,401,McCreary County,"",---District Total---,401,"","",SESC,907,10,99,125,1,0,1,0,0,0,0,0,0,2,0,2,0,0,0,0,0,0,122,99,221,224
20192020,080,MCCREARY,401,McCreary County,"",---District Total---,401,"","",SESC,907,11,83,102,1,1,2,1,0,1,0,0,0,2,2,4,0,0,0,2,1,3,96,79,175,185
20192020,080,MCCREARY,401,McCreary County,"",---District Total---,401,"","",SESC,907,14,2,3,0,0,0,0,0,0,0,0,0,0,1,1,0,0,0,0,0,0,3,1,4,5
20192020,080,MCCREARY,401,McCreary County,"",---District Total---,401,"","",SESC,907,12,74,114,2,0,2,0,0,0,0,0,0,1,1,2,0,0,0,0,0,0,111,73,184,188
20192020,080,MCCREARY,401,McCreary County,"",---District Total---,401,"","",SESC,907,All Students,1294,1439,9,5,14,1,1,2,3,0,3,17,17,34,0,0,0,16,3,19,1393,1268,2661,2733
20192020,080,MCCREARY,401,McCreary County,"",---District Total---,401,"","",SESC,907,PS,72,94,0,0,0,0,0,0,0,0,0,0,1,1,0,0,0,0,1,1,94,70,164,166
20192020,080,MCCREARY,401,McCreary County,"",---District Total---,401,"","",SESC,907,KG,117,102,0,1,1,0,1,1,0,0,0,2,0,2,0,0,0,1,0,1,99,115,214,219
20192020,080,MCCREARY,401,McCreary County,"",---District Total---,401,"","",SESC,907,01,113,123,0,1,1,0,0,0,1,0,1,2,4,6,0,0,0,2,1,3,118,107,225,236
20192020,080,MCCREARY,401,McCreary County,"",---District Total---,401,"","",SESC,907,02,98,122,0,0,0,0,0,0,0,0,0,1,2,3,0,0,0,2,0,2,119,96,215,220
20192020,080,MCCREARY,401,McCreary County,"",---District Total---,401,"","",SESC,907,03,118,120,1,0,1,0,0,0,0,0,0,0,1,1,0,0,0,3,0,3,116,117,233,238
20192020,080,MCCREARY,401,McCreary County,"",---District Total---,401,"","",SESC,907,04,92,102,0,0,0,0,0,0,0,0,0,0,0,0,0,0,0,2,0,2,100,92,192,194
20192020,080,MCCREARY,401,McCreary County,"",---District Total---,401,"","",SESC,907,05,94,104,0,0,0,0,0,0,2,0,2,2,3,5,0,0,0,0,0,0,100,91,191,198
20192020,080,MCCREARY,401,McCreary County,"",---District Total---,401,"","",SESC,907,06,98,87,0,0,0,0,0,0,0,0,0,0,0,0,0,0,0,2,0,2,85,98,183,185
20192020,080,MCCREARY,401,McCreary County,"",---District Total---,401,"","",SESC,907,07,103,105,0,0,0,0,0,0,0,0,0,0,2,2,0,0,0,0,0,0,105,101,206,208
20192020,080,MCCREARY,401,McCreary County,"",---District Total---,401,"","",SESC,907,08,97,125,3,1,4,0,0,0,0,0,0,1,1,2,0,0,0,0,1,1,121,94,215,222
20192020,080,MCCREARY,401,McCreary County,010,McCreary Central High School,401010,080401010,210399001014,SESC,907,12,72,102,1,0,1,0,0,0,0,0,0,1,1,2,0,0,0,0,0,0,100,71,171,174
20192020,080,MCCREARY,401,McCreary County,010,McCreary Central High School,401010,080401010,210399001014,SESC,907,All Students,345,405,4,1,5,1,0,1,0,0,0,6,4,10,0,0,0,2,1,3,392,339,731,750
20192020,080,MCCREARY,401,McCreary County,010,McCreary Central High School,401010,080401010,210399001014,SESC,907,09,102,96,1,0,1,0,0,0,0,0,0,3,0,3,0,0,0,1,0,1,91,102,193,198
20192020,080,MCCREARY,401,McCreary County,010,McCreary Central High School,401010,080401010,210399001014,SESC,907,10,94,113,1,0,1,0,0,0,0,0,0,2,0,2,0,0,0,0,0,0,110,94,204,207
20192020,080,MCCREARY,401,McCreary County,010,McCreary Central High School,401010,080401010,210399001014,SESC,907,11,75,91,1,1,2,1,0,1,0,0,0,0,2,2,0,0,0,1,1,2,88,71,159,166
20192020,080,MCCREARY,401,McCreary County,010,McCreary Central High School,401010,080401010,210399001014,SESC,907,14,2,3,0,0,0,0,0,0,0,0,0,0,1,1,0,0,0,0,0,0,3,1,4,5
20192020,080,MCCREARY,401,McCreary County,011,McCreary County Preschool South,401011,080401011,210399001548,SESC,907,All Students,0,0,0,0,0,0,0,0,0,0,0,0,0,0,0,0,0,0,0,0,0,0,0,0
20192020,080,MCCREARY,401,McCreary County,011,McCreary County Preschool South,401011,080401011,210399001548,SESC,907,PS,47,55,0,0,0,0,0,0,0,0,0,0,0,0,0,0,0,0,1,1,55,46,101,102
20192020,080,MCCREARY,401,McCreary County,012,McCreary Academy,401012,080401012,210399001805,SESC,907,12,2,12,1,0,1,0,0,0,0,0,0,0,0,0,0,0,0,0,0,0,11,2,13,14
20192020,080,MCCREARY,401,McCreary County,012,McCreary Academy,401012,080401012,210399001805,SESC,907,All Students,20,52,2,1,3,0,0,0,0,0,0,3,0,3,0,0,0,2,0,2,45,19,64,72
20192020,080,MCCREARY,401,McCreary County,012,McCreary Academy,401012,080401012,210399001805,SESC,907,07,0,3,0,0,0,0,0,0,0,0,0,0,0,0,0,0,0,0,0,0,3,0,3,3
20192020,080,MCCREARY,401,McCreary County,012,McCreary Academy,401012,080401012,210399001805,SESC,907,08,1,5,1,0,1,0,0,0,0,0,0,0,0,0,0,0,0,0,0,0,4,1,5,6
20192020,080,MCCREARY,401,McCreary County,012,McCreary Academy,401012,080401012,210399001805,SESC,907,09,4,9,0,1,1,0,0,0,0,0,0,1,0,1,0,0,0,1,0,1,7,3,10,13
20192020,080,MCCREARY,401,McCreary County,012,McCreary Academy,401012,080401012,210399001805,SESC,907,10,5,12,0,0,0,0,0,0,0,0,0,0,0,0,0,0,0,0,0,0,12,5,17,17
20192020,080,MCCREARY,401,McCreary County,012,McCreary Academy,401012,080401012,210399001805,SESC,907,11,8,11,0,0,0,0,0,0,0,0,0,2,0,2,0,0,0,1,0,1,8,8,16,19
20192020,080,MCCREARY,401,McCreary County,014,McCreary County Middle School,401014,080401014,210399002002,SESC,907,All Students,297,309,2,1,3,0,0,0,0,0,0,1,3,4,0,0,0,2,1,3,304,292,596,606
20192020,080,MCCREARY,401,McCreary County,014,McCreary County Middle School,401014,080401014,210399002002,SESC,907,06,98,87,0,0,0,0,0,0,0,0,0,0,0,0,0,0,0,2,0,2,85,98,183,185
20192020,080,MCCREARY,401,McCreary County,014,McCreary County Middle School,401014,080401014,210399002002,SESC,907,07,103,102,0,0,0,0,0,0,0,0,0,0,2,2,0,0,0,0,0,0,102,101,203,205
20192020,080,MCCREARY,401,McCreary County,014,McCreary County Middle School,401014,080401014,210399002002,SESC,907,08,96,120,2,1,3,0,0,0,0,0,0,1,1,2,0,0,0,0,1,1,117,93,210,216
20192020,080,MCCREARY,401,McCreary County,017,McCreary County Preschool North,401017,080401017,210399002437,SESC,907,All Students,0,0,0,0,0,0,0,0,0,0,0,0,0,0,0,0,0,0,0,0,0,0,0,0
20192020,080,MCCREARY,401,McCreary County,017,McCreary County Preschool North,401017,080401017,210399002437,SESC,907,PS,25,39,0,0,0,0,0,0,0,0,0,0,1,1,0,0,0,0,0,0,39,24,63,64
20192020,080,MCCREARY,401,McCreary County,020,Pine Knot Elementary School,401020,080401020,210399002451,SESC,907,05,54,69,0,0,0,0,0,0,2,0,2,0,1,1,0,0,0,0,0,0,67,53,120,123
20192020,080,MCCREARY,401,McCreary County,020,Pine Knot Elementary School,401020,080401020,210399002451,SESC,907,04,48,74,0,0,0,0,0,0,0,0,0,0,0,0,0,0,0,1,0,1,73,48,121,122
20192020,080,MCCREARY,401,McCreary County,020,Pine Knot Elementary School,401020,080401020,210399002451,SESC,907,All Students,361,434,1,1,2,0,1,1,3,0,3,3,6,9,0,0,0,6,1,7,421,352,773,795
20192020,080,MCCREARY,401,McCreary County,020,Pine Knot Elementary School,401020,080401020,210399002451,SESC,907,KG,62,63,0,0,0,0,1,1,0,0,0,1,0,1,0,0,0,1,0,1,61,61,122,125
20192020,080,MCCREARY,401,McCreary County,020,Pine Knot Elementary School,401020,080401020,210399002451,SESC,907,01,72,79,0,1,1,0,0,0,1,0,1,1,3,4,0,0,0,1,1,2,76,67,143,151
20192020,080,MCCREARY,401,McCreary County,020,Pine Knot Elementary School,401020,080401020,210399002451,SESC,907,02,58,79,0,0,0,0,0,0,0,0,0,1,1,2,0,0,0,1,0,1,77,57,134,137
20192020,080,MCCREARY,401,McCreary County,020,Pine Knot Elementary School,401020,080401020,210399002451,SESC,907,03,67,70,1,0,1,0,0,0,0,0,0,0,1,1,0,0,0,2,0,2,67,66,133,137
20192020,080,MCCREARY,401,McCreary County,330,Whitley City Elementary School,401330,080401330,210399001021,SESC,907,04,44,28,0,0,0,0,0,0,0,0,0,0,0,0,0,0,0,1,0,1,27,44,71,72
20192020,080,MCCREARY,401,McCreary County,330,Whitley City Elementary School,401330,080401330,210399001021,SESC,907,All Students,271,239,0,1,1,0,0,0,0,0,0,4,4,8,0,0,0,4,0,4,231,266,497,510
20192020,080,MCCREARY,401,McCreary County,330,Whitley City Elementary School,401330,080401330,210399001021,SESC,907,KG,55,39,0,1,1,0,0,0,0,0,0,1,0,1,0,0,0,0,0,0,38,54,92,94
20192020,080,MCCREARY,401,McCreary County,330,Whitley City Elementary School,401330,080401330,210399001021,SESC,907,01,41,44,0,0,0,0,0,0,0,0,0,1,1,2,0,0,0,1,0,1,42,40,82,85
20192020,080,MCCREARY,401,McCreary County,330,Whitley City Elementary School,401330,080401330,210399001021,SESC,907,02,40,43,0,0,0,0,0,0,0,0,0,0,1,1,0,0,0,1,0,1,42,39,81,83
20192020,080,MCCREARY,401,McCreary County,330,Whitley City Elementary School,401330,080401330,210399001021,SESC,907,03,51,50,0,0,0,0,0,0,0,0,0,0,0,0,0,0,0,1,0,1,49,51,100,101
20192020,080,MCCREARY,401,McCreary County,330,Whitley City Elementary School,401330,080401330,210399001021,SESC,907,05,40,35,0,0,0,0,0,0,0,0,0,2,2,4,0,0,0,0,0,0,33,38,71,75
20192020,081,MCLEAN,405,McLean County,"",---District Total---,405,"","",GRREC,902,03,42,55,0,1,1,0,0,0,0,0,0,2,0,2,0,0,0,0,1,1,53,40,93,97
20192020,081,MCLEAN,405,McLean County,"",---District Total---,405,"","",GRREC,902,All Students,684,736,7,7,14,1,0,1,2,5,7,29,24,53,0,0,0,9,2,11,688,646,1334,1420
20192020,081,MCLEAN,405,McLean County,"",---District Total---,405,"","",GRREC,902,PS,33,47,0,0,0,0,0,0,0,0,0,5,0,5,0,0,0,1,3,4,41,30,71,80
20192020,081,MCLEAN,405,McLean County,"",---District Total---,405,"","",GRREC,902,KG,51,66,1,1,2,0,0,0,0,2,2,5,1,6,0,0,0,0,0,0,60,47,107,117
20192020,081,MCLEAN,405,McLean County,"",---District Total---,405,"","",GRREC,902,01,46,53,0,1,1,0,0,0,0,0,0,4,2,6,0,0,0,0,0,0,49,43,92,99
20192020,081,MCLEAN,405,McLean County,"",---District Total---,405,"","",GRREC,902,02,41,63,0,0,0,0,0,0,0,0,0,0,1,1,0,0,0,2,0,2,61,40,101,104
20192020,081,MCLEAN,405,McLean County,"",---District Total---,405,"","",GRREC,902,05,46,53,0,1,1,0,0,0,0,0,0,3,2,5,0,0,0,0,0,0,50,43,93,99
20192020,081,MCLEAN,405,McLean County,"",---District Total---,405,"","",GRREC,902,06,48,55,0,1,1,0,0,0,1,2,3,2,3,5,0,0,0,1,0,1,51,42,93,103
20192020,081,MCLEAN,405,McLean County,"",---District Total---,405,"","",GRREC,902,07,72,58,0,1,1,0,0,0,0,0,0,1,3,4,0,0,0,1,1,2,56,67,123,130
20192020,081,MCLEAN,405,McLean County,"",---District Total---,405,"","",GRREC,902,08,58,50,0,1,1,0,0,0,0,0,0,0,3,3,0,0,0,0,0,0,50,54,104,108
20192020,081,MCLEAN,405,McLean County,"",---District Total---,405,"","",GRREC,902,09,49,52,0,0,0,0,0,0,1,0,1,0,5,5,0,0,0,0,0,0,51,44,95,101
20192020,081,MCLEAN,405,McLean County,"",---District Total---,405,"","",GRREC,902,10,59,64,1,0,1,0,0,0,0,0,0,4,0,4,0,0,0,2,0,2,57,59,116,123
20192020,081,MCLEAN,405,McLean County,"",---District Total---,405,"","",GRREC,902,11,52,52,1,0,1,0,0,0,0,1,1,2,0,2,0,0,0,2,0,2,47,51,98,104
20192020,081,MCLEAN,405,McLean County,"",---District Total---,405,"","",GRREC,902,12,58,57,2,0,2,0,0,0,0,0,0,4,1,5,0,0,0,1,0,1,50,57,107,115
20192020,081,MCLEAN,405,McLean County,"",---District Total---,405,"","",GRREC,902,04,62,58,2,0,2,1,0,1,0,0,0,2,3,5,0,0,0,0,0,0,53,59,112,120
20192020,081,MCLEAN,405,McLean County,020,Calhoun Elementary School,405020,081405020,210402001023,GRREC,902,05,15,20,0,0,0,0,0,0,0,0,0,2,0,2,0,0,0,0,0,0,18,15,33,35
20192020,081,MCLEAN,405,McLean County,020,Calhoun Elementary School,405020,081405020,210402001023,GRREC,902,03,17,26,0,0,0,0,0,0,0,0,0,0,0,0,0,0,0,0,0,0,26,17,43,43
20192020,081,MCLEAN,405,McLean County,020,Calhoun Elementary School,405020,081405020,210402001023,GRREC,902,04,36,26,1,0,1,0,0,0,0,0,0,0,2,2,0,0,0,0,0,0,25,34,59,62
20192020,081,MCLEAN,405,McLean County,020,Calhoun Elementary School,405020,081405020,210402001023,GRREC,902,All Students,134,149,2,1,3,0,0,0,0,0,0,3,5,8,0,0,0,0,0,0,144,128,272,283
20192020,081,MCLEAN,405,McLean County,020,Calhoun Elementary School,405020,081405020,210402001023,GRREC,902,PS,15,17,0,0,0,0,0,0,0,0,0,2,0,2,0,0,0,1,3,4,14,12,26,32
20192020,081,MCLEAN,405,McLean County,020,Calhoun Elementary School,405020,081405020,210402001023,GRREC,902,KG,25,25,1,0,1,0,0,0,0,0,0,0,1,1,0,0,0,0,0,0,24,24,48,50
20192020,081,MCLEAN,405,McLean County,020,Calhoun Elementary School,405020,081405020,210402001023,GRREC,902,01,21,22,0,1,1,0,0,0,0,0,0,1,2,3,0,0,0,0,0,0,21,18,39,43
20192020,081,MCLEAN,405,McLean County,020,Calhoun Elementary School,405020,081405020,210402001023,GRREC,902,02,20,30,0,0,0,0,0,0,0,0,0,0,0,0,0,0,0,0,0,0,30,20,50,50
20192020,081,MCLEAN,405,McLean County,050,Livermore Elementary School,405050,081405050,210402001025,GRREC,902,01,16,22,0,0,0,0,0,0,0,0,0,2,0,2,0,0,0,0,0,0,20,16,36,38
20192020,081,MCLEAN,405,McLean County,050,Livermore Elementary School,405050,081405050,210402001025,GRREC,902,All Students,107,131,1,3,4,1,0,1,0,2,2,11,3,14,0,0,0,1,1,2,117,98,215,238
20192020,081,MCLEAN,405,McLean County,050,Livermore Elementary School,405050,081405050,210402001025,GRREC,902,PS,14,20,0,0,0,0,0,0,0,0,0,2,0,2,0,0,0,0,0,0,18,14,32,34
20192020,081,MCLEAN,405,McLean County,050,Livermore Elementary School,405050,081405050,210402001025,GRREC,902,KG,20,32,0,1,1,0,0,0,0,2,2,4,0,4,0,0,0,0,0,0,28,17,45,52
20192020,081,MCLEAN,405,McLean County,050,Livermore Elementary School,405050,081405050,210402001025,GRREC,902,02,15,16,0,0,0,0,0,0,0,0,0,0,1,1,0,0,0,1,0,1,15,14,29,31
20192020,081,MCLEAN,405,McLean County,050,Livermore Elementary School,405050,081405050,210402001025,GRREC,902,03,20,17,0,1,1,0,0,0,0,0,0,2,0,2,0,0,0,0,1,1,15,18,33,37
20192020,081,MCLEAN,405,McLean County,050,Livermore Elementary School,405050,081405050,210402001025,GRREC,902,04,16,23,1,0,1,1,0,1,0,0,0,2,1,3,0,0,0,0,0,0,19,15,34,39
20192020,081,MCLEAN,405,McLean County,050,Livermore Elementary School,405050,081405050,210402001025,GRREC,902,05,20,21,0,1,1,0,0,0,0,0,0,1,1,2,0,0,0,0,0,0,20,18,38,41
20192020,081,MCLEAN,405,McLean County,065,McLean County High School,405065,081405065,210402001026,GRREC,902,10,59,64,1,0,1,0,0,0,0,0,0,4,0,4,0,0,0,2,0,2,57,59,116,123
20192020,081,MCLEAN,405,McLean County,065,McLean County High School,405065,081405065,210402001026,GRREC,902,11,52,52,1,0,1,0,0,0,0,1,1,2,0,2,0,0,0,2,0,2,47,51,98,104
20192020,081,MCLEAN,405,McLean County,065,McLean County High School,405065,081405065,210402001026,GRREC,902,12,58,57,2,0,2,0,0,0,0,0,0,4,1,5,0,0,0,1,0,1,50,57,107,115
20192020,081,MCLEAN,405,McLean County,065,McLean County High School,405065,081405065,210402001026,GRREC,902,All Students,218,225,4,0,4,0,0,0,1,1,2,10,6,16,0,0,0,5,0,5,205,211,416,443
20192020,081,MCLEAN,405,McLean County,065,McLean County High School,405065,081405065,210402001026,GRREC,902,09,49,52,0,0,0,0,0,0,1,0,1,0,5,5,0,0,0,0,0,0,51,44,95,101
20192020,081,MCLEAN,405,McLean County,070,Marie Gatton Phillips Elementary,405070,081405070,210402001027,GRREC,902,02,6,17,0,0,0,0,0,0,0,0,0,0,0,0,0,0,0,1,0,1,16,6,22,23
20192020,081,MCLEAN,405,McLean County,070,Marie Gatton Phillips Elementary,405070,081405070,210402001027,GRREC,902,03,5,12,0,0,0,0,0,0,0,0,0,0,0,0,0,0,0,0,0,0,12,5,17,17
20192020,081,MCLEAN,405,McLean County,070,Marie Gatton Phillips Elementary,405070,081405070,210402001027,GRREC,902,05,11,12,0,0,0,0,0,0,0,0,0,0,1,1,0,0,0,0,0,0,12,10,22,23
20192020,081,MCLEAN,405,McLean County,070,Marie Gatton Phillips Elementary,405070,081405070,210402001027,GRREC,902,04,10,9,0,0,0,0,0,0,0,0,0,0,0,0,0,0,0,0,0,0,9,10,19,19
20192020,081,MCLEAN,405,McLean County,070,Marie Gatton Phillips Elementary,405070,081405070,210402001027,GRREC,902,All Students,47,68,0,0,0,0,0,0,0,0,0,2,1,3,0,0,0,1,0,1,65,46,111,115
20192020,081,MCLEAN,405,McLean County,070,Marie Gatton Phillips Elementary,405070,081405070,210402001027,GRREC,902,PS,4,10,0,0,0,0,0,0,0,0,0,1,0,1,0,0,0,0,0,0,9,4,13,14
20192020,081,MCLEAN,405,McLean County,070,Marie Gatton Phillips Elementary,405070,081405070,210402001027,GRREC,902,KG,6,9,0,0,0,0,0,0,0,0,0,1,0,1,0,0,0,0,0,0,8,6,14,15
20192020,081,MCLEAN,405,McLean County,070,Marie Gatton Phillips Elementary,405070,081405070,210402001027,GRREC,902,01,9,9,0,0,0,0,0,0,0,0,0,1,0,1,0,0,0,0,0,0,8,9,17,18
20192020,081,MCLEAN,405,McLean County,075,McLean County Middle School,405075,081405075,210402001140,GRREC,902,07,72,58,0,1,1,0,0,0,0,0,0,1,3,4,0,0,0,1,1,2,56,67,123,130
20192020,081,MCLEAN,405,McLean County,075,McLean County Middle School,405075,081405075,210402001140,GRREC,902,All Students,178,163,0,3,3,0,0,0,1,2,3,3,9,12,0,0,0,2,1,3,157,163,320,341
20192020,081,MCLEAN,405,McLean County,075,McLean County Middle School,405075,081405075,210402001140,GRREC,902,06,48,55,0,1,1,0,0,0,1,2,3,2,3,5,0,0,0,1,0,1,51,42,93,103
20192020,081,MCLEAN,405,McLean County,075,McLean County Middle School,405075,081405075,210402001140,GRREC,902,08,58,50,0,1,1,0,0,0,0,0,0,0,3,3,0,0,0,0,0,0,50,54,104,108
20192020,082,MEADE,411,Meade County,"",---District Total---,411,"","",GRREC,902,12,167,189,2,1,3,2,0,2,0,0,0,8,5,13,0,0,0,3,4,7,174,157,331,356
20192020,082,MEADE,411,Meade County,"",---District Total---,411,"","",GRREC,902,All Students,2282,2478,42,38,80,5,3,8,8,17,25,108,100,208,4,2,6,113,113,226,2198,2009,4207,4760
20192020,082,MEADE,411,Meade County,"",---District Total---,411,"","",GRREC,902,PS,94,100,0,0,0,0,0,0,1,0,1,4,2,6,0,0,0,4,2,6,91,90,181,194
20192020,082,MEADE,411,Meade County,"",---District Total---,411,"","",GRREC,902,KG,171,154,3,6,9,1,0,1,1,1,2,6,8,14,0,0,0,11,6,17,132,150,282,325
20192020,082,MEADE,411,Meade County,"",---District Total---,411,"","",GRREC,902,01,183,206,2,3,5,1,1,2,1,3,4,11,14,25,0,0,0,12,8,20,179,154,333,389
20192020,082,MEADE,411,Meade County,"",---District Total---,411,"","",GRREC,902,02,162,170,4,5,9,0,0,0,0,2,2,9,8,17,0,0,0,4,11,15,153,136,289,332
20192020,082,MEADE,411,Meade County,"",---District Total---,411,"","",GRREC,902,03,163,190,1,2,3,0,0,0,1,0,1,7,7,14,0,0,0,18,5,23,163,149,312,353
20192020,082,MEADE,411,Meade County,"",---District Total---,411,"","",GRREC,902,04,161,185,5,3,8,0,0,0,0,0,0,8,10,18,1,1,2,9,10,19,162,137,299,346
20192020,082,MEADE,411,Meade County,"",---District Total---,411,"","",GRREC,902,05,176,189,4,4,8,0,0,0,1,0,1,7,5,12,0,0,0,11,10,21,166,157,323,365
20192020,082,MEADE,411,Meade County,"",---District Total---,411,"","",GRREC,902,06,181,200,5,4,9,0,1,1,0,0,0,7,11,18,0,0,0,13,16,29,175,149,324,381
20192020,082,MEADE,411,Meade County,"",---District Total---,411,"","",GRREC,902,07,180,170,3,1,4,0,0,0,1,1,2,5,10,15,0,0,0,7,14,21,154,154,308,350
20192020,082,MEADE,411,Meade County,"",---District Total---,411,"","",GRREC,902,08,174,205,3,2,5,1,0,1,0,3,3,8,9,17,0,0,0,11,11,22,182,149,331,379
20192020,082,MEADE,411,Meade County,"",---District Total---,411,"","",GRREC,902,09,191,212,4,1,5,0,1,1,1,0,1,12,5,17,0,0,0,5,8,13,190,176,366,403
20192020,082,MEADE,411,Meade County,"",---District Total---,411,"","",GRREC,902,10,194,207,1,0,1,0,0,0,1,3,4,9,5,14,3,1,4,3,5,8,190,180,370,401
20192020,082,MEADE,411,Meade County,"",---District Total---,411,"","",GRREC,902,11,174,197,5,6,11,0,0,0,1,4,5,11,2,13,0,0,0,6,5,11,174,157,331,371
20192020,082,MEADE,411,Meade County,"",---District Total---,411,"","",GRREC,902,14,5,4,0,0,0,0,0,0,0,0,0,0,1,1,0,0,0,0,0,0,4,4,8,9
20192020,082,MEADE,411,Meade County,011,David T. Wilson Elementary,411011,082411011,210405001644,GRREC,902,05,74,94,1,1,2,0,0,0,1,0,1,4,2,6,0,0,0,4,4,8,84,67,151,168
20192020,082,MEADE,411,Meade County,011,David T. Wilson Elementary,411011,082411011,210405001644,GRREC,902,All Students,233,264,3,7,10,0,0,0,1,0,1,11,11,22,0,0,0,12,18,30,237,197,434,497
20192020,082,MEADE,411,Meade County,011,David T. Wilson Elementary,411011,082411011,210405001644,GRREC,902,04,83,78,2,3,5,0,0,0,0,0,0,4,4,8,0,0,0,1,6,7,71,70,141,161
20192020,082,MEADE,411,Meade County,011,David T. Wilson Elementary,411011,082411011,210405001644,GRREC,902,06,76,92,0,3,3,0,0,0,0,0,0,3,5,8,0,0,0,7,8,15,82,60,142,168
20192020,082,MEADE,411,Meade County,012,Brandenburg High School,411012,082411012,210405001930,GRREC,902,11,2,3,0,0,0,0,0,0,0,0,0,0,0,0,0,0,0,0,0,0,3,2,5,5
20192020,082,MEADE,411,Meade County,012,Brandenburg High School,411012,082411012,210405001930,GRREC,902,All Students,8,6,0,0,0,0,0,0,0,0,0,0,0,0,0,0,0,0,0,0,6,8,14,14
20192020,082,MEADE,411,Meade County,012,Brandenburg High School,411012,082411012,210405001930,GRREC,902,12,6,3,0,0,0,0,0,0,0,0,0,0,0,0,0,0,0,0,0,0,3,6,9,9
20192020,082,MEADE,411,Meade County,013,James R. Allen High School,411013,082411013,210405002202,GRREC,902,08,0,2,0,0,0,0,0,0,0,0,0,0,0,0,0,0,0,1,0,1,1,0,1,2
20192020,082,MEADE,411,Meade County,013,James R. Allen High School,411013,082411013,210405002202,GRREC,902,All Students,0,15,1,0,1,0,0,0,0,0,0,1,0,1,0,0,0,2,0,2,11,0,11,15
20192020,082,MEADE,411,Meade County,013,James R. Allen High School,411013,082411013,210405002202,GRREC,902,07,0,3,0,0,0,0,0,0,0,0,0,0,0,0,0,0,0,0,0,0,3,0,3,3
20192020,082,MEADE,411,Meade County,013,James R. Allen High School,411013,082411013,210405002202,GRREC,902,09,0,3,0,0,0,0,0,0,0,0,0,0,0,0,0,0,0,0,0,0,3,0,3,3
20192020,082,MEADE,411,Meade County,013,James R. Allen High School,411013,082411013,210405002202,GRREC,902,10,0,6,1,0,1,0,0,0,0,0,0,1,0,1,0,0,0,1,0,1,3,0,3,6
20192020,082,MEADE,411,Meade County,013,James R. Allen High School,411013,082411013,210405002202,GRREC,902,11,0,1,0,0,0,0,0,0,0,0,0,0,0,0,0,0,0,0,0,0,1,0,1,1
20192020,082,MEADE,411,Meade County,015,Stuart Pepper Middle School,411015,082411015,210405001029,GRREC,902,07,180,167,3,1,4,0,0,0,1,1,2,5,10,15,0,0,0,7,14,21,151,154,305,347
20192020,082,MEADE,411,Meade County,015,Stuart Pepper Middle School,411015,082411015,210405001029,GRREC,902,08,174,203,3,2,5,1,0,1,0,3,3,8,9,17,0,0,0,10,11,21,181,149,330,377
20192020,082,MEADE,411,Meade County,015,Stuart Pepper Middle School,411015,082411015,210405001029,GRREC,902,All Students,354,370,6,3,9,1,0,1,1,4,5,13,19,32,0,0,0,17,25,42,332,303,635,724
20192020,082,MEADE,411,Meade County,030,Flaherty Primary School,411030,082411030,210405002295,GRREC,902,01,53,56,0,2,2,0,0,0,0,0,0,6,9,15,0,0,0,5,1,6,45,41,86,109
20192020,082,MEADE,411,Meade County,030,Flaherty Primary School,411030,082411030,210405002295,GRREC,902,03,42,53,0,1,1,0,0,0,0,0,0,2,2,4,0,0,0,4,2,6,47,37,84,95
20192020,082,MEADE,411,Meade County,030,Flaherty Primary School,411030,082411030,210405002295,GRREC,902,02,42,45,0,1,1,0,0,0,0,1,1,3,4,7,0,0,0,2,4,6,40,32,72,87
20192020,082,MEADE,411,Meade County,030,Flaherty Primary School,411030,082411030,210405002295,GRREC,902,All Students,181,199,2,5,7,0,0,0,0,1,1,13,16,29,0,0,0,13,10,23,171,149,320,380
20192020,082,MEADE,411,Meade County,030,Flaherty Primary School,411030,082411030,210405002295,GRREC,902,KG,44,45,2,1,3,0,0,0,0,0,0,2,1,3,0,0,0,2,3,5,39,39,78,89
20192020,082,MEADE,411,Meade County,040,Ekron Elementary School,411040,082411040,210405001032,GRREC,902,05,21,25,0,0,0,0,0,0,0,0,0,0,0,0,0,0,0,1,0,1,24,21,45,46
20192020,082,MEADE,411,Meade County,040,Ekron Elementary School,411040,082411040,210405001032,GRREC,902,All Students,173,195,4,3,7,1,0,1,2,0,2,3,6,9,0,0,0,13,5,18,172,159,331,368
20192020,082,MEADE,411,Meade County,040,Ekron Elementary School,411040,082411040,210405001032,GRREC,902,KG,23,29,1,2,3,0,0,0,0,0,0,0,0,0,0,0,0,3,1,4,25,20,45,52
20192020,082,MEADE,411,Meade County,040,Ekron Elementary School,411040,082411040,210405001032,GRREC,902,01,23,31,1,0,1,1,0,1,1,0,1,0,2,2,0,0,0,1,1,2,27,20,47,54
20192020,082,MEADE,411,Meade County,040,Ekron Elementary School,411040,082411040,210405001032,GRREC,902,02,22,28,1,0,1,0,0,0,0,0,0,1,0,1,0,0,0,1,1,2,25,21,46,50
20192020,082,MEADE,411,Meade County,040,Ekron Elementary School,411040,082411040,210405001032,GRREC,902,03,30,28,0,1,1,0,0,0,1,0,1,0,1,1,0,0,0,4,0,4,23,28,51,58
20192020,082,MEADE,411,Meade County,040,Ekron Elementary School,411040,082411040,210405001032,GRREC,902,04,21,18,0,0,0,0,0,0,0,0,0,1,1,2,0,0,0,1,0,1,16,20,36,39
20192020,082,MEADE,411,Meade County,040,Ekron Elementary School,411040,082411040,210405001032,GRREC,902,06,33,36,1,0,1,0,0,0,0,0,0,1,2,3,0,0,0,2,2,4,32,29,61,69
20192020,082,MEADE,411,Meade County,050,Flaherty Elementary School,411050,082411050,210405001033,GRREC,902,05,69,54,3,3,6,0,0,0,0,0,0,1,2,3,0,0,0,6,6,12,44,58,102,123
20192020,082,MEADE,411,Meade County,050,Flaherty Elementary School,411050,082411050,210405001033,GRREC,902,All Students,164,176,10,4,14,0,1,1,0,0,0,7,10,17,0,0,0,16,16,32,143,133,276,340
20192020,082,MEADE,411,Meade County,050,Flaherty Elementary School,411050,082411050,210405001033,GRREC,902,04,42,69,3,0,3,0,0,0,0,0,0,3,5,8,0,0,0,6,4,10,57,33,90,111
20192020,082,MEADE,411,Meade County,050,Flaherty Elementary School,411050,082411050,210405001033,GRREC,902,06,53,53,4,1,5,0,1,1,0,0,0,3,3,6,0,0,0,4,6,10,42,42,84,106
20192020,082,MEADE,411,Meade County,060,Brandenburg Primary School,411060,082411060,210405001034,GRREC,902,02,78,81,3,4,7,0,0,0,0,1,1,5,3,8,0,0,0,1,6,7,72,64,136,159
20192020,082,MEADE,411,Meade County,060,Brandenburg Primary School,411060,082411060,210405001034,GRREC,902,All Students,339,329,5,8,13,1,1,2,1,5,6,17,16,33,0,0,0,22,16,38,283,293,576,668
20192020,082,MEADE,411,Meade County,060,Brandenburg Primary School,411060,082411060,210405001034,GRREC,902,PS,94,100,0,0,0,0,0,0,1,0,1,4,2,6,0,0,0,4,2,6,91,90,181,194
20192020,082,MEADE,411,Meade County,060,Brandenburg Primary School,411060,082411060,210405001034,GRREC,902,KG,89,64,0,3,3,1,0,1,1,1,2,4,6,10,0,0,0,6,2,8,52,77,129,153
20192020,082,MEADE,411,Meade County,060,Brandenburg Primary School,411060,082411060,210405001034,GRREC,902,01,94,95,1,1,2,0,1,1,0,3,3,5,3,8,0,0,0,5,5,10,84,81,165,189
20192020,082,MEADE,411,Meade County,060,Brandenburg Primary School,411060,082411060,210405001034,GRREC,902,03,78,89,1,0,1,0,0,0,0,0,0,3,4,7,0,0,0,10,3,13,75,71,146,167
20192020,082,MEADE,411,Meade County,070,Meade County High School,411070,082411070,210405001035,GRREC,902,12,161,186,2,1,3,2,0,2,0,0,0,8,5,13,0,0,0,3,4,7,171,151,322,347
20192020,082,MEADE,411,Meade County,070,Meade County High School,411070,082411070,210405001035,GRREC,902,All Students,723,793,11,8,19,2,1,3,3,7,10,39,18,57,3,1,4,16,22,38,719,666,1385,1516
20192020,082,MEADE,411,Meade County,070,Meade County High School,411070,082411070,210405001035,GRREC,902,09,191,209,4,1,5,0,1,1,1,0,1,12,5,17,0,0,0,5,8,13,187,176,363,400
20192020,082,MEADE,411,Meade County,070,Meade County High School,411070,082411070,210405001035,GRREC,902,10,194,201,0,0,0,0,0,0,1,3,4,8,5,13,3,1,4,2,5,7,187,180,367,395
20192020,082,MEADE,411,Meade County,070,Meade County High School,411070,082411070,210405001035,GRREC,902,11,172,193,5,6,11,0,0,0,1,4,5,11,2,13,0,0,0,6,5,11,170,155,325,365
20192020,082,MEADE,411,Meade County,070,Meade County High School,411070,082411070,210405001035,GRREC,902,14,5,4,0,0,0,0,0,0,0,0,0,0,1,1,0,0,0,0,0,0,4,4,8,9
20192020,082,MEADE,411,Meade County,090,Payneville Elementary School,411090,082411090,210405001037,GRREC,902,03,13,20,0,0,0,0,0,0,0,0,0,2,0,2,0,0,0,0,0,0,18,13,31,33
20192020,082,MEADE,411,Meade County,090,Payneville Elementary School,411090,082411090,210405001037,GRREC,902,All Students,107,131,0,0,0,0,0,0,0,0,0,4,4,8,1,1,2,2,1,3,124,101,225,238
20192020,082,MEADE,411,Meade County,090,Payneville Elementary School,411090,082411090,210405001037,GRREC,902,KG,15,16,0,0,0,0,0,0,0,0,0,0,1,1,0,0,0,0,0,0,16,14,30,31
20192020,082,MEADE,411,Meade County,090,Payneville Elementary School,411090,082411090,210405001037,GRREC,902,01,13,24,0,0,0,0,0,0,0,0,0,0,0,0,0,0,0,1,1,2,23,12,35,37
20192020,082,MEADE,411,Meade County,090,Payneville Elementary School,411090,082411090,210405001037,GRREC,902,05,12,16,0,0,0,0,0,0,0,0,0,2,1,3,0,0,0,0,0,0,14,11,25,28
20192020,082,MEADE,411,Meade County,090,Payneville Elementary School,411090,082411090,210405001037,GRREC,902,06,19,19,0,0,0,0,0,0,0,0,0,0,1,1,0,0,0,0,0,0,19,18,37,38
20192020,082,MEADE,411,Meade County,090,Payneville Elementary School,411090,082411090,210405001037,GRREC,902,02,20,16,0,0,0,0,0,0,0,0,0,0,1,1,0,0,0,0,0,0,16,19,35,36
20192020,082,MEADE,411,Meade County,090,Payneville Elementary School,411090,082411090,210405001037,GRREC,902,04,15,20,0,0,0,0,0,0,0,0,0,0,0,0,1,1,2,1,0,1,18,14,32,35
20192020,083,MENIFEE,415,Menifee County,"",---District Total---,415,"","",KEDC,903,12,29,30,0,0,0,0,0,0,0,0,0,0,1,1,0,0,0,0,0,0,30,28,58,59
20192020,083,MENIFEE,415,Menifee County,"",---District Total---,415,"","",KEDC,903,All Students,465,470,0,2,2,0,0,0,0,0,0,9,8,17,0,1,1,4,4,8,457,450,907,935
20192020,083,MENIFEE,415,Menifee County,"",---District Total---,415,"","",KEDC,903,PS,1,6,0,0,0,0,0,0,0,0,0,0,0,0,0,0,0,0,0,0,6,1,7,7
20192020,083,MENIFEE,415,Menifee County,"",---District Total---,415,"","",KEDC,903,KG,34,36,0,0,0,0,0,0,0,0,0,0,0,0,0,0,0,0,0,0,36,34,70,70
20192020,083,MENIFEE,415,Menifee County,"",---District Total---,415,"","",KEDC,903,01,29,38,0,0,0,0,0,0,0,0,0,2,0,2,0,0,0,0,0,0,36,29,65,67
20192020,083,MENIFEE,415,Menifee County,"",---District Total---,415,"","",KEDC,903,02,39,19,0,0,0,0,0,0,0,0,0,0,1,1,0,0,0,0,0,0,19,38,57,58
20192020,083,MENIFEE,415,Menifee County,"",---District Total---,415,"","",KEDC,903,03,33,45,0,1,1,0,0,0,0,0,0,2,1,3,0,0,0,0,1,1,43,30,73,78
20192020,083,MENIFEE,415,Menifee County,"",---District Total---,415,"","",KEDC,903,04,42,32,0,0,0,0,0,0,0,0,0,1,1,2,0,0,0,0,0,0,31,41,72,74
20192020,083,MENIFEE,415,Menifee County,"",---District Total---,415,"","",KEDC,903,05,36,35,0,0,0,0,0,0,0,0,0,0,1,1,0,0,0,1,0,1,34,35,69,71
20192020,083,MENIFEE,415,Menifee County,"",---District Total---,415,"","",KEDC,903,06,36,39,0,0,0,0,0,0,0,0,0,0,1,1,0,0,0,0,0,0,39,35,74,75
20192020,083,MENIFEE,415,Menifee County,"",---District Total---,415,"","",KEDC,903,07,47,45,0,1,1,0,0,0,0,0,0,1,0,1,0,0,0,1,1,2,43,45,88,92
20192020,083,MENIFEE,415,Menifee County,"",---District Total---,415,"","",KEDC,903,08,31,24,0,0,0,0,0,0,0,0,0,2,2,4,0,0,0,0,0,0,22,29,51,55
20192020,083,MENIFEE,415,Menifee County,"",---District Total---,415,"","",KEDC,903,09,41,44,0,0,0,0,0,0,0,0,0,1,0,1,0,1,1,0,1,1,43,39,82,85
20192020,083,MENIFEE,415,Menifee County,"",---District Total---,415,"","",KEDC,903,10,29,39,0,0,0,0,0,0,0,0,0,0,0,0,0,0,0,2,1,3,37,28,65,68
20192020,083,MENIFEE,415,Menifee County,"",---District Total---,415,"","",KEDC,903,11,39,44,0,0,0,0,0,0,0,0,0,0,0,0,0,0,0,0,0,0,44,39,83,83
20192020,083,MENIFEE,415,Menifee County,"",---District Total---,415,"","",KEDC,903,14,0,0,0,0,0,0,0,0,0,0,0,0,0,0,0,0,0,0,0,0,0,0,0,0
20192020,083,MENIFEE,415,Menifee County,005,Frenchburg Group Home,415005,083415005,210408002496,KEDC,903,14,0,0,0,0,0,0,0,0,0,0,0,0,0,0,0,0,0,0,0,0,0,0,0,0
20192020,083,MENIFEE,415,Menifee County,005,Frenchburg Group Home,415005,083415005,210408002496,KEDC,903,All Students,0,0,0,0,0,0,0,0,0,0,0,0,0,0,0,0,0,0,0,0,0,0,0,0
20192020,083,MENIFEE,415,Menifee County,005,Frenchburg Group Home,415005,083415005,210408002496,KEDC,903,06,0,0,0,0,0,0,0,0,0,0,0,0,0,0,0,0,0,0,0,0,0,0,0,0
20192020,083,MENIFEE,415,Menifee County,005,Frenchburg Group Home,415005,083415005,210408002496,KEDC,903,07,0,0,0,0,0,0,0,0,0,0,0,0,0,0,0,0,0,0,0,0,0,0,0,0
20192020,083,MENIFEE,415,Menifee County,005,Frenchburg Group Home,415005,083415005,210408002496,KEDC,903,08,0,0,0,0,0,0,0,0,0,0,0,0,0,0,0,0,0,0,0,0,0,0,0,0
20192020,083,MENIFEE,415,Menifee County,005,Frenchburg Group Home,415005,083415005,210408002496,KEDC,903,09,0,0,0,0,0,0,0,0,0,0,0,0,0,0,0,0,0,0,0,0,0,0,0,0
20192020,083,MENIFEE,415,Menifee County,005,Frenchburg Group Home,415005,083415005,210408002496,KEDC,903,10,0,0,0,0,0,0,0,0,0,0,0,0,0,0,0,0,0,0,0,0,0,0,0,0
20192020,083,MENIFEE,415,Menifee County,005,Frenchburg Group Home,415005,083415005,210408002496,KEDC,903,11,0,0,0,0,0,0,0,0,0,0,0,0,0,0,0,0,0,0,0,0,0,0,0,0
20192020,083,MENIFEE,415,Menifee County,005,Frenchburg Group Home,415005,083415005,210408002496,KEDC,903,12,0,0,0,0,0,0,0,0,0,0,0,0,0,0,0,0,0,0,0,0,0,0,0,0
20192020,083,MENIFEE,415,Menifee County,020,Botts Elementary School,415020,083415020,210408001038,KEDC,903,04,14,13,0,0,0,0,0,0,0,0,0,1,1,2,0,0,0,0,0,0,12,13,25,27
20192020,083,MENIFEE,415,Menifee County,020,Botts Elementary School,415020,083415020,210408001038,KEDC,903,All Students,86,86,0,0,0,0,0,0,0,0,0,3,3,6,0,0,0,1,1,2,82,82,164,172
20192020,083,MENIFEE,415,Menifee County,020,Botts Elementary School,415020,083415020,210408001038,KEDC,903,PS,1,5,0,0,0,0,0,0,0,0,0,0,0,0,0,0,0,0,0,0,5,1,6,6
20192020,083,MENIFEE,415,Menifee County,020,Botts Elementary School,415020,083415020,210408001038,KEDC,903,KG,17,18,0,0,0,0,0,0,0,0,0,0,0,0,0,0,0,0,0,0,18,17,35,35
20192020,083,MENIFEE,415,Menifee County,020,Botts Elementary School,415020,083415020,210408001038,KEDC,903,01,12,19,0,0,0,0,0,0,0,0,0,1,0,1,0,0,0,0,0,0,18,12,30,31
20192020,083,MENIFEE,415,Menifee County,020,Botts Elementary School,415020,083415020,210408001038,KEDC,903,02,16,8,0,0,0,0,0,0,0,0,0,0,1,1,0,0,0,0,0,0,8,15,23,24
20192020,083,MENIFEE,415,Menifee County,020,Botts Elementary School,415020,083415020,210408001038,KEDC,903,03,14,14,0,0,0,0,0,0,0,0,0,1,0,1,0,0,0,0,1,1,13,13,26,28
20192020,083,MENIFEE,415,Menifee County,020,Botts Elementary School,415020,083415020,210408001038,KEDC,903,05,13,14,0,0,0,0,0,0,0,0,0,0,1,1,0,0,0,1,0,1,13,12,25,27
20192020,083,MENIFEE,415,Menifee County,080,Menifee Elementary School,415080,083415080,210408001039,KEDC,903,07,47,45,0,1,1,0,0,0,0,0,0,1,0,1,0,0,0,1,1,2,43,45,88,92
20192020,083,MENIFEE,415,Menifee County,080,Menifee Elementary School,415080,083415080,210408001039,KEDC,903,All Students,241,226,0,2,2,0,0,0,0,0,0,5,4,9,0,0,0,1,1,2,220,234,454,467
20192020,083,MENIFEE,415,Menifee County,080,Menifee Elementary School,415080,083415080,210408001039,KEDC,903,PS,0,1,0,0,0,0,0,0,0,0,0,0,0,0,0,0,0,0,0,0,1,0,1,1
20192020,083,MENIFEE,415,Menifee County,080,Menifee Elementary School,415080,083415080,210408001039,KEDC,903,KG,17,18,0,0,0,0,0,0,0,0,0,0,0,0,0,0,0,0,0,0,18,17,35,35
20192020,083,MENIFEE,415,Menifee County,080,Menifee Elementary School,415080,083415080,210408001039,KEDC,903,01,17,19,0,0,0,0,0,0,0,0,0,1,0,1,0,0,0,0,0,0,18,17,35,36
20192020,083,MENIFEE,415,Menifee County,080,Menifee Elementary School,415080,083415080,210408001039,KEDC,903,02,23,11,0,0,0,0,0,0,0,0,0,0,0,0,0,0,0,0,0,0,11,23,34,34
20192020,083,MENIFEE,415,Menifee County,080,Menifee Elementary School,415080,083415080,210408001039,KEDC,903,03,19,31,0,1,1,0,0,0,0,0,0,1,1,2,0,0,0,0,0,0,30,17,47,50
20192020,083,MENIFEE,415,Menifee County,080,Menifee Elementary School,415080,083415080,210408001039,KEDC,903,04,28,19,0,0,0,0,0,0,0,0,0,0,0,0,0,0,0,0,0,0,19,28,47,47
20192020,083,MENIFEE,415,Menifee County,080,Menifee Elementary School,415080,083415080,210408001039,KEDC,903,05,23,21,0,0,0,0,0,0,0,0,0,0,0,0,0,0,0,0,0,0,21,23,44,44
20192020,083,MENIFEE,415,Menifee County,080,Menifee Elementary School,415080,083415080,210408001039,KEDC,903,06,36,39,0,0,0,0,0,0,0,0,0,0,1,1,0,0,0,0,0,0,39,35,74,75
20192020,083,MENIFEE,415,Menifee County,080,Menifee Elementary School,415080,083415080,210408001039,KEDC,903,08,31,23,0,0,0,0,0,0,0,0,0,2,2,4,0,0,0,0,0,0,21,29,50,54
20192020,083,MENIFEE,415,Menifee County,090,Menifee County High School,415090,083415090,210408001040,KEDC,903,11,39,44,0,0,0,0,0,0,0,0,0,0,0,0,0,0,0,0,0,0,44,39,83,83
20192020,083,MENIFEE,415,Menifee County,090,Menifee County High School,415090,083415090,210408001040,KEDC,903,All Students,138,158,0,0,0,0,0,0,0,0,0,1,1,2,0,1,1,2,2,4,155,134,289,296
20192020,083,MENIFEE,415,Menifee County,090,Menifee County High School,415090,083415090,210408001040,KEDC,903,08,0,1,0,0,0,0,0,0,0,0,0,0,0,0,0,0,0,0,0,0,1,0,1,1
20192020,083,MENIFEE,415,Menifee County,090,Menifee County High School,415090,083415090,210408001040,KEDC,903,09,41,44,0,0,0,0,0,0,0,0,0,1,0,1,0,1,1,0,1,1,43,39,82,85
20192020,083,MENIFEE,415,Menifee County,090,Menifee County High School,415090,083415090,210408001040,KEDC,903,10,29,39,0,0,0,0,0,0,0,0,0,0,0,0,0,0,0,2,1,3,37,28,65,68
20192020,083,MENIFEE,415,Menifee County,090,Menifee County High School,415090,083415090,210408001040,KEDC,903,12,29,30,0,0,0,0,0,0,0,0,0,0,1,1,0,0,0,0,0,0,30,28,58,59
20192020,084,MERCER,421,Mercer County,"",---District Total---,421,"","",CKEC,901,10,105,101,4,3,7,0,0,0,0,0,0,7,5,12,0,0,0,7,8,15,83,89,172,206
20192020,084,MERCER,421,Mercer County,"",---District Total---,421,"","",CKEC,901,All Students,1263,1381,44,53,97,0,0,0,7,13,20,82,79,161,3,0,3,93,74,167,1152,1044,2196,2644
20192020,084,MERCER,421,Mercer County,"",---District Total---,421,"","",CKEC,901,PS,60,88,6,1,7,0,0,0,0,0,0,1,3,4,0,0,0,3,5,8,78,51,129,148
20192020,084,MERCER,421,Mercer County,"",---District Total---,421,"","",CKEC,901,KG,100,102,2,2,4,0,0,0,0,2,2,4,8,12,0,0,0,9,8,17,87,80,167,202
20192020,084,MERCER,421,Mercer County,"",---District Total---,421,"","",CKEC,901,01,86,103,3,4,7,0,0,0,0,0,0,5,3,8,0,0,0,7,7,14,88,72,160,189
20192020,084,MERCER,421,Mercer County,"",---District Total---,421,"","",CKEC,901,02,86,109,3,2,5,0,0,0,2,0,2,7,2,9,0,0,0,5,8,13,92,74,166,195
20192020,084,MERCER,421,Mercer County,"",---District Total---,421,"","",CKEC,901,03,98,93,4,3,7,0,0,0,0,1,1,4,7,11,0,0,0,6,5,11,79,82,161,191
20192020,084,MERCER,421,Mercer County,"",---District Total---,421,"","",CKEC,901,04,115,103,1,2,3,0,0,0,0,2,2,8,7,15,1,0,1,8,6,14,85,98,183,218
20192020,084,MERCER,421,Mercer County,"",---District Total---,421,"","",CKEC,901,05,96,112,3,8,11,0,0,0,0,1,1,8,6,14,0,0,0,10,8,18,91,73,164,208
20192020,084,MERCER,421,Mercer County,"",---District Total---,421,"","",CKEC,901,06,100,113,3,4,7,0,0,0,1,1,2,9,8,17,1,0,1,8,3,11,91,84,175,213
20192020,084,MERCER,421,Mercer County,"",---District Total---,421,"","",CKEC,901,07,100,126,5,7,12,0,0,0,2,0,2,10,1,11,0,0,0,9,1,10,100,91,191,226
20192020,084,MERCER,421,Mercer County,"",---District Total---,421,"","",CKEC,901,08,97,86,2,3,5,0,0,0,0,1,1,3,8,11,0,0,0,5,7,12,76,78,154,183
20192020,084,MERCER,421,Mercer County,"",---District Total---,421,"","",CKEC,901,09,96,118,6,3,9,0,0,0,0,3,3,6,14,20,0,0,0,13,5,18,93,71,164,214
20192020,084,MERCER,421,Mercer County,"",---District Total---,421,"","",CKEC,901,11,91,103,2,5,7,0,0,0,0,1,1,5,3,8,1,0,1,1,5,6,94,77,171,194
20192020,084,MERCER,421,Mercer County,"",---District Total---,421,"","",CKEC,901,12,93,112,6,7,13,0,0,0,2,1,3,6,7,13,0,0,0,5,3,8,93,75,168,205
20192020,084,MERCER,421,Mercer County,015,Mercer County Senior High School,421015,084421015,210411002168,CKEC,901,12,85,99,6,7,13,0,0,0,1,1,2,6,7,13,0,0,0,4,3,7,82,67,149,184
20192020,084,MERCER,421,Mercer County,015,Mercer County Senior High School,421015,084421015,210411002168,CKEC,901,All Students,357,395,16,18,34,0,0,0,1,5,6,22,28,50,1,0,1,20,19,39,335,287,622,752
20192020,084,MERCER,421,Mercer County,015,Mercer County Senior High School,421015,084421015,210411002168,CKEC,901,09,85,103,4,3,7,0,0,0,0,3,3,4,13,17,0,0,0,9,4,13,86,62,148,188
20192020,084,MERCER,421,Mercer County,015,Mercer County Senior High School,421015,084421015,210411002168,CKEC,901,10,97,93,4,3,7,0,0,0,0,0,0,7,5,12,0,0,0,6,7,13,76,82,158,190
20192020,084,MERCER,421,Mercer County,015,Mercer County Senior High School,421015,084421015,210411002168,CKEC,901,11,90,100,2,5,7,0,0,0,0,1,1,5,3,8,1,0,1,1,5,6,91,76,167,190
20192020,084,MERCER,421,Mercer County,027,Mercer County Day Treatment,421027,084421027,210411001491,CKEC,901,09,0,7,2,0,2,0,0,0,0,0,0,1,0,1,0,0,0,0,0,0,4,0,4,7
20192020,084,MERCER,421,Mercer County,027,Mercer County Day Treatment,421027,084421027,210411001491,CKEC,901,All Students,1,12,2,0,2,0,0,0,0,0,0,1,0,1,0,0,0,1,0,1,8,1,9,13
20192020,084,MERCER,421,Mercer County,027,Mercer County Day Treatment,421027,084421027,210411001491,CKEC,901,07,0,1,0,0,0,0,0,0,0,0,0,0,0,0,0,0,0,0,0,0,1,0,1,1
20192020,084,MERCER,421,Mercer County,027,Mercer County Day Treatment,421027,084421027,210411001491,CKEC,901,08,0,2,0,0,0,0,0,0,0,0,0,0,0,0,0,0,0,0,0,0,2,0,2,2
20192020,084,MERCER,421,Mercer County,027,Mercer County Day Treatment,421027,084421027,210411001491,CKEC,901,10,1,2,0,0,0,0,0,0,0,0,0,0,0,0,0,0,0,1,0,1,1,1,2,3
20192020,084,MERCER,421,Mercer County,035,Kenneth D. King Middle School,421035,084421035,210411000482,CKEC,901,07,100,125,5,7,12,0,0,0,2,0,2,10,1,11,0,0,0,9,1,10,99,91,190,225
20192020,084,MERCER,421,Mercer County,035,Kenneth D. King Middle School,421035,084421035,210411000482,CKEC,901,All Students,297,322,10,14,24,0,0,0,3,2,5,22,17,39,1,0,1,22,11,33,264,253,517,619
20192020,084,MERCER,421,Mercer County,035,Kenneth D. King Middle School,421035,084421035,210411000482,CKEC,901,06,100,113,3,4,7,0,0,0,1,1,2,9,8,17,1,0,1,8,3,11,91,84,175,213
20192020,084,MERCER,421,Mercer County,035,Kenneth D. King Middle School,421035,084421035,210411000482,CKEC,901,08,97,84,2,3,5,0,0,0,0,1,1,3,8,11,0,0,0,5,7,12,74,78,152,181
20192020,084,MERCER,421,Mercer County,040,Mercer Central,421040,084421040,210411002285,CKEC,901,11,1,3,0,0,0,0,0,0,0,0,0,0,0,0,0,0,0,0,0,0,3,1,4,4
20192020,084,MERCER,421,Mercer County,040,Mercer Central,421040,084421040,210411002285,CKEC,901,All Students,27,30,0,0,0,0,0,0,1,0,1,1,1,2,0,0,0,5,2,7,23,24,47,57
20192020,084,MERCER,421,Mercer County,040,Mercer Central,421040,084421040,210411002285,CKEC,901,09,11,8,0,0,0,0,0,0,0,0,0,1,1,2,0,0,0,4,1,5,3,9,12,19
20192020,084,MERCER,421,Mercer County,040,Mercer Central,421040,084421040,210411002285,CKEC,901,10,7,6,0,0,0,0,0,0,0,0,0,0,0,0,0,0,0,0,1,1,6,6,12,13
20192020,084,MERCER,421,Mercer County,040,Mercer Central,421040,084421040,210411002285,CKEC,901,12,8,13,0,0,0,0,0,0,1,0,1,0,0,0,0,0,0,1,0,1,11,8,19,21
20192020,084,MERCER,421,Mercer County,050,Mercer County Intermediate School,421050,084421050,210411002273,CKEC,901,04,115,103,1,2,3,0,0,0,0,2,2,8,7,15,1,0,1,8,6,14,85,98,183,218
20192020,084,MERCER,421,Mercer County,050,Mercer County Intermediate School,421050,084421050,210411002273,CKEC,901,All Students,309,308,8,13,21,0,0,0,0,4,4,20,20,40,1,0,1,24,19,43,255,253,508,617
20192020,084,MERCER,421,Mercer County,050,Mercer County Intermediate School,421050,084421050,210411002273,CKEC,901,03,98,93,4,3,7,0,0,0,0,1,1,4,7,11,0,0,0,6,5,11,79,82,161,191
20192020,084,MERCER,421,Mercer County,050,Mercer County Intermediate School,421050,084421050,210411002273,CKEC,901,05,96,112,3,8,11,0,0,0,0,1,1,8,6,14,0,0,0,10,8,18,91,73,164,208
20192020,084,MERCER,421,Mercer County,070,Mercer County Elementary School,421070,084421070,210411001042,CKEC,901,KG,100,102,2,2,4,0,0,0,0,2,2,4,8,12,0,0,0,9,8,17,87,80,167,202
20192020,084,MERCER,421,Mercer County,070,Mercer County Elementary School,421070,084421070,210411001042,CKEC,901,All Students,272,314,8,8,16,0,0,0,2,2,4,16,13,29,0,0,0,21,23,44,267,226,493,586
20192020,084,MERCER,421,Mercer County,070,Mercer County Elementary School,421070,084421070,210411001042,CKEC,901,PS,60,88,6,1,7,0,0,0,0,0,0,1,3,4,0,0,0,3,5,8,78,51,129,148
20192020,084,MERCER,421,Mercer County,070,Mercer County Elementary School,421070,084421070,210411001042,CKEC,901,02,86,109,3,2,5,0,0,0,2,0,2,7,2,9,0,0,0,5,8,13,92,74,166,195
20192020,084,MERCER,421,Mercer County,070,Mercer County Elementary School,421070,084421070,210411001042,CKEC,901,01,86,103,3,4,7,0,0,0,0,0,0,5,3,8,0,0,0,7,7,14,88,72,160,189
20192020,085,METCALFE,425,Metcalfe County,"",---District Total---,425,"","",GRREC,902,10,56,61,0,0,0,0,0,0,0,1,1,0,3,3,0,0,0,0,0,0,61,52,113,117
20192020,085,METCALFE,425,Metcalfe County,"",---District Total---,425,"","",GRREC,902,All Students,650,779,9,4,13,0,0,0,2,2,4,22,25,47,0,0,0,7,2,9,739,617,1356,1429
20192020,085,METCALFE,425,Metcalfe County,"",---District Total---,425,"","",GRREC,902,PS,50,51,0,0,0,0,0,0,0,0,0,2,0,2,0,0,0,0,1,1,49,49,98,101
20192020,085,METCALFE,425,Metcalfe County,"",---District Total---,425,"","",GRREC,902,KG,41,53,0,0,0,0,0,0,0,0,0,2,1,3,0,0,0,1,0,1,50,40,90,94
20192020,085,METCALFE,425,Metcalfe County,"",---District Total---,425,"","",GRREC,902,01,48,60,1,0,1,0,0,0,0,0,0,3,1,4,0,0,0,0,1,1,56,46,102,108
20192020,085,METCALFE,425,Metcalfe County,"",---District Total---,425,"","",GRREC,902,02,39,52,0,0,0,0,0,0,0,0,0,0,3,3,0,0,0,2,0,2,50,36,86,91
20192020,085,METCALFE,425,Metcalfe County,"",---District Total---,425,"","",GRREC,902,03,54,66,0,1,1,0,0,0,0,0,0,1,2,3,0,0,0,0,0,0,65,51,116,120
20192020,085,METCALFE,425,Metcalfe County,"",---District Total---,425,"","",GRREC,902,04,49,66,1,0,1,0,0,0,1,0,1,4,2,6,0,0,0,0,0,0,60,47,107,115
20192020,085,METCALFE,425,Metcalfe County,"",---District Total---,425,"","",GRREC,902,05,54,55,0,1,1,0,0,0,1,0,1,2,3,5,0,0,0,0,0,0,52,50,102,109
20192020,085,METCALFE,425,Metcalfe County,"",---District Total---,425,"","",GRREC,902,06,52,59,1,0,1,0,0,0,0,0,0,4,2,6,0,0,0,0,0,0,54,50,104,111
20192020,085,METCALFE,425,Metcalfe County,"",---District Total---,425,"","",GRREC,902,07,58,61,1,0,1,0,0,0,0,0,0,2,3,5,0,0,0,0,1,1,58,54,112,119
20192020,085,METCALFE,425,Metcalfe County,"",---District Total---,425,"","",GRREC,902,08,43,67,1,0,1,0,0,0,0,0,0,1,1,2,0,0,0,1,0,1,64,42,106,110
20192020,085,METCALFE,425,Metcalfe County,"",---District Total---,425,"","",GRREC,902,09,54,56,0,0,0,0,0,0,0,0,0,1,1,2,0,0,0,1,0,1,54,53,107,110
20192020,085,METCALFE,425,Metcalfe County,"",---District Total---,425,"","",GRREC,902,11,58,56,0,2,2,0,0,0,0,0,0,2,0,2,0,0,0,2,0,2,52,56,108,114
20192020,085,METCALFE,425,Metcalfe County,"",---District Total---,425,"","",GRREC,902,12,44,66,4,0,4,0,0,0,0,1,1,0,3,3,0,0,0,0,0,0,62,40,102,110
20192020,085,METCALFE,425,Metcalfe County,"",---District Total---,425,"","",GRREC,902,14,0,1,0,0,0,0,0,0,0,0,0,0,0,0,0,0,0,0,0,0,1,0,1,1
20192020,085,METCALFE,425,Metcalfe County,010,Metcalfe County Middle School,425010,085425010,210414000729,GRREC,902,06,52,59,1,0,1,0,0,0,0,0,0,4,2,6,0,0,0,0,0,0,54,50,104,111
20192020,085,METCALFE,425,Metcalfe County,010,Metcalfe County Middle School,425010,085425010,210414000729,GRREC,902,07,58,61,1,0,1,0,0,0,0,0,0,2,3,5,0,0,0,0,1,1,58,54,112,119
20192020,085,METCALFE,425,Metcalfe County,010,Metcalfe County Middle School,425010,085425010,210414000729,GRREC,902,08,43,67,1,0,1,0,0,0,0,0,0,1,1,2,0,0,0,1,0,1,64,42,106,110
20192020,085,METCALFE,425,Metcalfe County,010,Metcalfe County Middle School,425010,085425010,210414000729,GRREC,902,All Students,153,187,3,0,3,0,0,0,0,0,0,7,6,13,0,0,0,1,1,2,176,146,322,340
20192020,085,METCALFE,425,Metcalfe County,050,Metcalfe County High School,425050,085425050,210414001044,GRREC,902,11,58,56,0,2,2,0,0,0,0,0,0,2,0,2,0,0,0,2,0,2,52,56,108,114
20192020,085,METCALFE,425,Metcalfe County,050,Metcalfe County High School,425050,085425050,210414001044,GRREC,902,14,0,1,0,0,0,0,0,0,0,0,0,0,0,0,0,0,0,0,0,0,1,0,1,1
20192020,085,METCALFE,425,Metcalfe County,050,Metcalfe County High School,425050,085425050,210414001044,GRREC,902,12,44,66,4,0,4,0,0,0,0,1,1,0,3,3,0,0,0,0,0,0,62,40,102,110
20192020,085,METCALFE,425,Metcalfe County,050,Metcalfe County High School,425050,085425050,210414001044,GRREC,902,All Students,212,240,4,2,6,0,0,0,0,2,2,3,7,10,0,0,0,3,0,3,230,201,431,452
20192020,085,METCALFE,425,Metcalfe County,050,Metcalfe County High School,425050,085425050,210414001044,GRREC,902,09,54,56,0,0,0,0,0,0,0,0,0,1,1,2,0,0,0,1,0,1,54,53,107,110
20192020,085,METCALFE,425,Metcalfe County,050,Metcalfe County High School,425050,085425050,210414001044,GRREC,902,10,56,61,0,0,0,0,0,0,0,1,1,0,3,3,0,0,0,0,0,0,61,52,113,117
20192020,085,METCALFE,425,Metcalfe County,060,Metcalfe County Elementary School,425060,085425060,210414002383,GRREC,902,04,49,66,1,0,1,0,0,0,1,0,1,4,2,6,0,0,0,0,0,0,60,47,107,115
20192020,085,METCALFE,425,Metcalfe County,060,Metcalfe County Elementary School,425060,085425060,210414002383,GRREC,902,All Students,285,352,2,2,4,0,0,0,2,0,2,12,12,24,0,0,0,3,1,4,333,270,603,637
20192020,085,METCALFE,425,Metcalfe County,060,Metcalfe County Elementary School,425060,085425060,210414002383,GRREC,902,PS,50,51,0,0,0,0,0,0,0,0,0,2,0,2,0,0,0,0,1,1,49,49,98,101
20192020,085,METCALFE,425,Metcalfe County,060,Metcalfe County Elementary School,425060,085425060,210414002383,GRREC,902,KG,41,53,0,0,0,0,0,0,0,0,0,2,1,3,0,0,0,1,0,1,50,40,90,94
20192020,085,METCALFE,425,Metcalfe County,060,Metcalfe County Elementary School,425060,085425060,210414002383,GRREC,902,01,48,60,1,0,1,0,0,0,0,0,0,3,1,4,0,0,0,0,1,1,56,46,102,108
20192020,085,METCALFE,425,Metcalfe County,060,Metcalfe County Elementary School,425060,085425060,210414002383,GRREC,902,02,39,52,0,0,0,0,0,0,0,0,0,0,3,3,0,0,0,2,0,2,50,36,86,91
20192020,085,METCALFE,425,Metcalfe County,060,Metcalfe County Elementary School,425060,085425060,210414002383,GRREC,902,03,54,66,0,1,1,0,0,0,0,0,0,1,2,3,0,0,0,0,0,0,65,51,116,120
20192020,085,METCALFE,425,Metcalfe County,060,Metcalfe County Elementary School,425060,085425060,210414002383,GRREC,902,05,54,55,0,1,1,0,0,0,1,0,1,2,3,5,0,0,0,0,0,0,52,50,102,109
20192020,007,BELL,426,Middlesboro Independent,"",---District Total---,426,"","",SESC,907,04,27,35,1,2,3,0,0,0,0,0,0,0,0,0,0,1,1,3,3,6,31,21,52,62
20192020,007,BELL,426,Middlesboro Independent,"",---District Total---,426,"","",SESC,907,All Students,514,568,32,26,58,2,0,2,6,3,9,12,8,20,0,1,1,44,36,80,472,440,912,1082
20192020,007,BELL,426,Middlesboro Independent,"",---District Total---,426,"","",SESC,907,PS,56,36,3,1,4,0,0,0,0,0,0,0,4,4,0,0,0,1,2,3,32,49,81,92
20192020,007,BELL,426,Middlesboro Independent,"",---District Total---,426,"","",SESC,907,KG,40,38,2,2,4,0,0,0,1,0,1,0,1,1,0,0,0,3,4,7,32,33,65,78
20192020,007,BELL,426,Middlesboro Independent,"",---District Total---,426,"","",SESC,907,01,29,44,3,2,5,0,0,0,0,0,0,3,1,4,0,0,0,5,1,6,33,25,58,73
20192020,007,BELL,426,Middlesboro Independent,"",---District Total---,426,"","",SESC,907,02,25,50,1,2,3,0,0,0,0,0,0,2,0,2,0,0,0,4,2,6,43,21,64,75
20192020,007,BELL,426,Middlesboro Independent,"",---District Total---,426,"","",SESC,907,03,36,30,1,1,2,0,0,0,0,0,0,2,0,2,0,0,0,3,5,8,24,30,54,66
20192020,007,BELL,426,Middlesboro Independent,"",---District Total---,426,"","",SESC,907,07,44,44,2,4,6,2,0,2,0,1,1,0,2,2,0,0,0,3,1,4,37,36,73,88
20192020,007,BELL,426,Middlesboro Independent,"",---District Total---,426,"","",SESC,907,08,51,40,3,4,7,0,0,0,0,0,0,0,0,0,0,0,0,2,2,4,35,45,80,91
20192020,007,BELL,426,Middlesboro Independent,"",---District Total---,426,"","",SESC,907,09,47,55,3,2,5,0,0,0,2,0,2,0,3,3,0,0,0,1,2,3,49,40,89,102
20192020,007,BELL,426,Middlesboro Independent,"",---District Total---,426,"","",SESC,907,10,48,42,3,0,3,0,0,0,0,2,2,1,0,1,0,0,0,5,3,8,33,43,76,90
20192020,007,BELL,426,Middlesboro Independent,"",---District Total---,426,"","",SESC,907,11,43,54,2,2,4,0,0,0,1,0,1,1,0,1,0,0,0,2,3,5,48,38,86,97
20192020,007,BELL,426,Middlesboro Independent,"",---District Total---,426,"","",SESC,907,12,32,46,6,2,8,0,0,0,0,0,0,0,0,0,0,0,0,0,0,0,40,30,70,78
20192020,007,BELL,426,Middlesboro Independent,"",---District Total---,426,"","",SESC,907,14,1,0,0,0,0,0,0,0,0,0,0,0,0,0,0,0,0,0,0,0,0,1,1,1
20192020,007,BELL,426,Middlesboro Independent,"",---District Total---,426,"","",SESC,907,05,48,38,3,2,5,0,0,0,0,0,0,2,0,2,0,0,0,3,5,8,30,41,71,86
20192020,007,BELL,426,Middlesboro Independent,"",---District Total---,426,"","",SESC,907,06,43,52,2,1,3,0,0,0,2,0,2,1,1,2,0,0,0,10,5,15,37,36,73,95
20192020,007,BELL,426,Middlesboro Independent,023,Middlesboro Alternative School,426023,007426023,210417001680,SESC,907,12,3,7,2,1,3,0,0,0,0,0,0,0,0,0,0,0,0,0,0,0,5,2,7,10
20192020,007,BELL,426,Middlesboro Independent,023,Middlesboro Alternative School,426023,007426023,210417001680,SESC,907,09,0,5,0,0,0,0,0,0,0,0,0,0,0,0,0,0,0,0,0,0,5,0,5,5
20192020,007,BELL,426,Middlesboro Independent,023,Middlesboro Alternative School,426023,007426023,210417001680,SESC,907,10,2,5,0,0,0,0,0,0,0,0,0,1,0,1,0,0,0,1,0,1,3,2,5,7
20192020,007,BELL,426,Middlesboro Independent,023,Middlesboro Alternative School,426023,007426023,210417001680,SESC,907,11,0,4,1,0,1,0,0,0,0,0,0,0,0,0,0,0,0,0,0,0,3,0,3,4
20192020,007,BELL,426,Middlesboro Independent,023,Middlesboro Alternative School,426023,007426023,210417001680,SESC,907,All Students,5,24,3,1,4,0,0,0,0,0,0,1,0,1,0,0,0,1,0,1,19,4,23,29
20192020,007,BELL,426,Middlesboro Independent,023,Middlesboro Alternative School,426023,007426023,210417001680,SESC,907,07,0,1,0,0,0,0,0,0,0,0,0,0,0,0,0,0,0,0,0,0,1,0,1,1
20192020,007,BELL,426,Middlesboro Independent,023,Middlesboro Alternative School,426023,007426023,210417001680,SESC,907,08,0,2,0,0,0,0,0,0,0,0,0,0,0,0,0,0,0,0,0,0,2,0,2,2
20192020,007,BELL,426,Middlesboro Independent,030,Middlesboro Elementary School,426030,007426030,210417001048,SESC,907,PS,56,36,3,1,4,0,0,0,0,0,0,0,4,4,0,0,0,1,2,3,32,49,81,92
20192020,007,BELL,426,Middlesboro Independent,030,Middlesboro Elementary School,426030,007426030,210417001048,SESC,907,All Students,157,197,8,9,17,0,0,0,1,0,1,7,2,9,0,1,1,18,15,33,163,130,293,354
20192020,007,BELL,426,Middlesboro Independent,030,Middlesboro Elementary School,426030,007426030,210417001048,SESC,907,KG,40,38,2,2,4,0,0,0,1,0,1,0,1,1,0,0,0,3,4,7,32,33,65,78
20192020,007,BELL,426,Middlesboro Independent,030,Middlesboro Elementary School,426030,007426030,210417001048,SESC,907,01,29,44,3,2,5,0,0,0,0,0,0,3,1,4,0,0,0,5,1,6,33,25,58,73
20192020,007,BELL,426,Middlesboro Independent,030,Middlesboro Elementary School,426030,007426030,210417001048,SESC,907,02,25,50,1,2,3,0,0,0,0,0,0,2,0,2,0,0,0,4,2,6,43,21,64,75
20192020,007,BELL,426,Middlesboro Independent,030,Middlesboro Elementary School,426030,007426030,210417001048,SESC,907,03,36,30,1,1,2,0,0,0,0,0,0,2,0,2,0,0,0,3,5,8,24,30,54,66
20192020,007,BELL,426,Middlesboro Independent,030,Middlesboro Elementary School,426030,007426030,210417001048,SESC,907,04,27,35,1,2,3,0,0,0,0,0,0,0,0,0,0,1,1,3,3,6,31,21,52,62
20192020,007,BELL,426,Middlesboro Independent,040,Middlesboro Middle School,426040,007426040,210417001049,SESC,907,All Students,186,171,10,11,21,2,0,2,2,1,3,3,3,6,0,0,0,18,13,31,136,158,294,357
20192020,007,BELL,426,Middlesboro Independent,040,Middlesboro Middle School,426040,007426040,210417001049,SESC,907,05,48,38,3,2,5,0,0,0,0,0,0,2,0,2,0,0,0,3,5,8,30,41,71,86
20192020,007,BELL,426,Middlesboro Independent,040,Middlesboro Middle School,426040,007426040,210417001049,SESC,907,06,43,52,2,1,3,0,0,0,2,0,2,1,1,2,0,0,0,10,5,15,37,36,73,95
20192020,007,BELL,426,Middlesboro Independent,040,Middlesboro Middle School,426040,007426040,210417001049,SESC,907,07,44,43,2,4,6,2,0,2,0,1,1,0,2,2,0,0,0,3,1,4,36,36,72,87
20192020,007,BELL,426,Middlesboro Independent,040,Middlesboro Middle School,426040,007426040,210417001049,SESC,907,08,51,38,3,4,7,0,0,0,0,0,0,0,0,0,0,0,0,2,2,4,33,45,78,89
20192020,007,BELL,426,Middlesboro Independent,080,Middlesboro High School,426080,007426080,210417001050,SESC,907,14,1,0,0,0,0,0,0,0,0,0,0,0,0,0,0,0,0,0,0,0,0,1,1,1
20192020,007,BELL,426,Middlesboro Independent,080,Middlesboro High School,426080,007426080,210417001050,SESC,907,12,29,39,4,1,5,0,0,0,0,0,0,0,0,0,0,0,0,0,0,0,35,28,63,68
20192020,007,BELL,426,Middlesboro Independent,080,Middlesboro High School,426080,007426080,210417001050,SESC,907,All Students,166,176,11,5,16,0,0,0,3,2,5,1,3,4,0,0,0,7,8,15,154,148,302,342
20192020,007,BELL,426,Middlesboro Independent,080,Middlesboro High School,426080,007426080,210417001050,SESC,907,09,47,50,3,2,5,0,0,0,2,0,2,0,3,3,0,0,0,1,2,3,44,40,84,97
20192020,007,BELL,426,Middlesboro Independent,080,Middlesboro High School,426080,007426080,210417001050,SESC,907,10,46,37,3,0,3,0,0,0,0,2,2,0,0,0,0,0,0,4,3,7,30,41,71,83
20192020,007,BELL,426,Middlesboro Independent,080,Middlesboro High School,426080,007426080,210417001050,SESC,907,11,43,50,1,2,3,0,0,0,1,0,1,1,0,1,0,0,0,2,3,5,45,38,83,93
20192020,086,MONROE,431,Monroe County,"",---District Total---,431,"","",GRREC,902,03,67,65,0,2,2,0,1,1,1,0,1,9,4,13,0,0,0,2,0,2,53,60,113,132
20192020,086,MONROE,431,Monroe County,"",---District Total---,431,"","",GRREC,902,All Students,824,948,14,17,31,2,4,6,4,3,7,73,57,130,0,0,0,19,22,41,836,721,1557,1772
20192020,086,MONROE,431,Monroe County,"",---District Total---,431,"","",GRREC,902,PS,44,57,2,0,2,0,0,0,0,0,0,3,3,6,0,0,0,0,2,2,52,39,91,101
20192020,086,MONROE,431,Monroe County,"",---District Total---,431,"","",GRREC,902,KG,67,85,2,2,4,0,0,0,0,0,0,3,5,8,0,0,0,1,3,4,79,57,136,152
20192020,086,MONROE,431,Monroe County,"",---District Total---,431,"","",GRREC,902,01,69,81,2,3,5,0,1,1,1,1,2,9,4,13,0,0,0,3,1,4,66,59,125,150
20192020,086,MONROE,431,Monroe County,"",---District Total---,431,"","",GRREC,902,02,51,68,0,2,2,0,0,0,0,1,1,3,3,6,0,0,0,0,1,1,65,44,109,119
20192020,086,MONROE,431,Monroe County,"",---District Total---,431,"","",GRREC,902,06,82,76,2,0,2,0,0,0,0,0,0,7,7,14,0,0,0,1,3,4,66,72,138,158
20192020,086,MONROE,431,Monroe County,"",---District Total---,431,"","",GRREC,902,07,62,67,0,1,1,1,0,1,0,0,0,6,6,12,0,0,0,0,2,2,60,53,113,129
20192020,086,MONROE,431,Monroe County,"",---District Total---,431,"","",GRREC,902,08,52,68,1,1,2,0,1,1,0,0,0,6,2,8,0,0,0,2,3,5,59,45,104,120
20192020,086,MONROE,431,Monroe County,"",---District Total---,431,"","",GRREC,902,09,67,87,2,0,2,0,0,0,0,0,0,4,8,12,0,0,0,3,4,7,78,55,133,154
20192020,086,MONROE,431,Monroe County,"",---District Total---,431,"","",GRREC,902,10,63,76,0,1,1,0,0,0,1,0,1,6,6,12,0,0,0,0,0,0,69,56,125,139
20192020,086,MONROE,431,Monroe County,"",---District Total---,431,"","",GRREC,902,11,55,65,1,1,2,0,0,0,1,0,1,4,1,5,0,0,0,2,1,3,57,52,109,120
20192020,086,MONROE,431,Monroe County,"",---District Total---,431,"","",GRREC,902,12,71,72,1,2,3,1,0,1,0,1,1,4,2,6,0,0,0,2,2,4,64,64,128,143
20192020,086,MONROE,431,Monroe County,"",---District Total---,431,"","",GRREC,902,14,1,1,0,0,0,0,0,0,0,0,0,0,0,0,0,0,0,0,0,0,1,1,2,2
20192020,086,MONROE,431,Monroe County,"",---District Total---,431,"","",GRREC,902,04,55,64,2,2,4,0,1,1,0,0,0,7,5,12,0,0,0,0,1,1,55,46,101,119
20192020,086,MONROE,431,Monroe County,"",---District Total---,431,"","",GRREC,902,05,62,73,1,0,1,0,0,0,0,0,0,5,4,9,0,0,0,3,1,4,64,57,121,135
20192020,086,MONROE,431,Monroe County,150,Gamaliel Elementary,431150,086431150,210420001052,GRREC,902,04,20,17,0,0,0,0,1,1,0,0,0,3,2,5,0,0,0,0,1,1,14,16,30,37
20192020,086,MONROE,431,Monroe County,150,Gamaliel Elementary,431150,086431150,210420001052,GRREC,902,02,10,20,0,0,0,0,0,0,0,0,0,2,1,3,0,0,0,0,0,0,18,9,27,30
20192020,086,MONROE,431,Monroe County,150,Gamaliel Elementary,431150,086431150,210420001052,GRREC,902,03,21,20,0,0,0,0,0,0,0,0,0,3,1,4,0,0,0,0,0,0,17,20,37,41
20192020,086,MONROE,431,Monroe County,150,Gamaliel Elementary,431150,086431150,210420001052,GRREC,902,05,14,16,0,0,0,0,0,0,0,0,0,3,0,3,0,0,0,0,0,0,13,14,27,30
20192020,086,MONROE,431,Monroe County,150,Gamaliel Elementary,431150,086431150,210420001052,GRREC,902,All Students,108,121,0,1,1,0,2,2,0,0,0,14,9,23,0,0,0,0,1,1,107,95,202,229
20192020,086,MONROE,431,Monroe County,150,Gamaliel Elementary,431150,086431150,210420001052,GRREC,902,PS,15,12,0,0,0,0,0,0,0,0,0,1,1,2,0,0,0,0,2,2,11,12,23,27
20192020,086,MONROE,431,Monroe County,150,Gamaliel Elementary,431150,086431150,210420001052,GRREC,902,KG,25,21,0,1,1,0,0,0,0,0,0,1,3,4,0,0,0,0,0,0,20,21,41,46
20192020,086,MONROE,431,Monroe County,150,Gamaliel Elementary,431150,086431150,210420001052,GRREC,902,01,18,27,0,0,0,0,1,1,0,0,0,2,2,4,0,0,0,0,0,0,25,15,40,45
20192020,086,MONROE,431,Monroe County,160,Monroe Co Middle,431160,086431160,210420001053,GRREC,902,All Students,196,211,3,2,5,1,1,2,0,0,0,19,15,34,0,0,0,3,8,11,185,170,355,407
20192020,086,MONROE,431,Monroe County,160,Monroe Co Middle,431160,086431160,210420001053,GRREC,902,07,62,67,0,1,1,1,0,1,0,0,0,6,6,12,0,0,0,0,2,2,60,53,113,129
20192020,086,MONROE,431,Monroe County,160,Monroe Co Middle,431160,086431160,210420001053,GRREC,902,08,52,68,1,1,2,0,1,1,0,0,0,6,2,8,0,0,0,2,3,5,59,45,104,120
20192020,086,MONROE,431,Monroe County,160,Monroe Co Middle,431160,086431160,210420001053,GRREC,902,06,82,76,2,0,2,0,0,0,0,0,0,7,7,14,0,0,0,1,3,4,66,72,138,158
20192020,086,MONROE,431,Monroe County,212,Joe Harrison Carter,431212,086431212,210420001054,GRREC,902,05,19,24,0,0,0,0,0,0,0,0,0,1,1,2,0,0,0,1,0,1,22,18,40,43
20192020,086,MONROE,431,Monroe County,212,Joe Harrison Carter,431212,086431212,210420001054,GRREC,902,All Students,119,123,0,0,0,0,0,0,0,1,1,4,3,7,0,0,0,3,0,3,116,115,231,242
20192020,086,MONROE,431,Monroe County,212,Joe Harrison Carter,431212,086431212,210420001054,GRREC,902,PS,8,11,0,0,0,0,0,0,0,0,0,0,0,0,0,0,0,0,0,0,11,8,19,19
20192020,086,MONROE,431,Monroe County,212,Joe Harrison Carter,431212,086431212,210420001054,GRREC,902,KG,22,26,0,0,0,0,0,0,0,0,0,1,1,2,0,0,0,1,0,1,24,21,45,48
20192020,086,MONROE,431,Monroe County,212,Joe Harrison Carter,431212,086431212,210420001054,GRREC,902,01,23,17,0,0,0,0,0,0,0,1,1,0,1,1,0,0,0,1,0,1,16,21,37,40
20192020,086,MONROE,431,Monroe County,212,Joe Harrison Carter,431212,086431212,210420001054,GRREC,902,02,18,27,0,0,0,0,0,0,0,0,0,0,0,0,0,0,0,0,0,0,27,18,45,45
20192020,086,MONROE,431,Monroe County,212,Joe Harrison Carter,431212,086431212,210420001054,GRREC,902,03,25,21,0,0,0,0,0,0,0,0,0,1,0,1,0,0,0,0,0,0,20,25,45,46
20192020,086,MONROE,431,Monroe County,212,Joe Harrison Carter,431212,086431212,210420001054,GRREC,902,04,12,8,0,0,0,0,0,0,0,0,0,1,0,1,0,0,0,0,0,0,7,12,19,20
20192020,086,MONROE,431,Monroe County,440,Tompkinsville Elem,431440,086431440,210420001055,GRREC,902,All Students,144,192,7,10,17,0,1,1,2,1,3,18,13,31,0,0,0,6,6,12,159,113,272,336
20192020,086,MONROE,431,Monroe County,440,Tompkinsville Elem,431440,086431440,210420001055,GRREC,902,PS,21,34,2,0,2,0,0,0,0,0,0,2,2,4,0,0,0,0,0,0,30,19,49,55
20192020,086,MONROE,431,Monroe County,440,Tompkinsville Elem,431440,086431440,210420001055,GRREC,902,KG,20,38,2,1,3,0,0,0,0,0,0,1,1,2,0,0,0,0,3,3,35,15,50,58
20192020,086,MONROE,431,Monroe County,440,Tompkinsville Elem,431440,086431440,210420001055,GRREC,902,01,28,37,2,3,5,0,0,0,1,0,1,7,1,8,0,0,0,2,1,3,25,23,48,65
20192020,086,MONROE,431,Monroe County,440,Tompkinsville Elem,431440,086431440,210420001055,GRREC,902,02,23,21,0,2,2,0,0,0,0,1,1,1,2,3,0,0,0,0,1,1,20,17,37,44
20192020,086,MONROE,431,Monroe County,440,Tompkinsville Elem,431440,086431440,210420001055,GRREC,902,03,21,24,0,2,2,0,1,1,1,0,1,5,3,8,0,0,0,2,0,2,16,15,31,45
20192020,086,MONROE,431,Monroe County,440,Tompkinsville Elem,431440,086431440,210420001055,GRREC,902,04,23,39,2,2,4,0,0,0,0,0,0,3,3,6,0,0,0,0,0,0,34,18,52,62
20192020,086,MONROE,431,Monroe County,440,Tompkinsville Elem,431440,086431440,210420001055,GRREC,902,05,29,33,1,0,1,0,0,0,0,0,0,1,3,4,0,0,0,2,1,3,29,25,54,62
20192020,086,MONROE,431,Monroe County,450,Monroe Co High,431450,086431450,210420001056,GRREC,902,All Students,257,301,4,4,8,1,0,1,2,1,3,18,17,35,0,0,0,7,7,14,269,228,497,558
20192020,086,MONROE,431,Monroe County,450,Monroe Co High,431450,086431450,210420001056,GRREC,902,09,67,87,2,0,2,0,0,0,0,0,0,4,8,12,0,0,0,3,4,7,78,55,133,154
20192020,086,MONROE,431,Monroe County,450,Monroe Co High,431450,086431450,210420001056,GRREC,902,10,63,76,0,1,1,0,0,0,1,0,1,6,6,12,0,0,0,0,0,0,69,56,125,139
20192020,086,MONROE,431,Monroe County,450,Monroe Co High,431450,086431450,210420001056,GRREC,902,11,55,65,1,1,2,0,0,0,1,0,1,4,1,5,0,0,0,2,1,3,57,52,109,120
20192020,086,MONROE,431,Monroe County,450,Monroe Co High,431450,086431450,210420001056,GRREC,902,12,71,72,1,2,3,1,0,1,0,1,1,4,2,6,0,0,0,2,2,4,64,64,128,143
20192020,086,MONROE,431,Monroe County,450,Monroe Co High,431450,086431450,210420001056,GRREC,902,14,1,1,0,0,0,0,0,0,0,0,0,0,0,0,0,0,0,0,0,0,1,1,2,2
20192020,087,MONTGOMERY,435,Montgomery County,"",---District Total---,435,"","",CKEC,901,12,163,159,5,8,13,0,0,0,0,1,1,10,12,22,0,0,0,2,6,8,142,136,278,322
20192020,087,MONTGOMERY,435,Montgomery County,"",---District Total---,435,"","",CKEC,901,11,156,171,5,0,5,0,0,0,1,2,3,10,10,20,0,0,0,4,4,8,151,140,291,327
20192020,087,MONTGOMERY,435,Montgomery County,"",---District Total---,435,"","",CKEC,901,All Students,2110,2270,41,38,79,2,2,4,13,11,24,152,115,267,0,0,0,52,54,106,2010,1890,3900,4380
20192020,087,MONTGOMERY,435,Montgomery County,"",---District Total---,435,"","",CKEC,901,PS,102,114,5,0,5,0,0,0,1,1,2,6,6,12,0,0,0,2,0,2,100,95,195,216
20192020,087,MONTGOMERY,435,Montgomery County,"",---District Total---,435,"","",CKEC,901,KG,164,164,0,0,0,0,0,0,1,1,2,16,10,26,0,0,0,6,4,10,141,149,290,328
20192020,087,MONTGOMERY,435,Montgomery County,"",---District Total---,435,"","",CKEC,901,01,136,192,2,1,3,0,0,0,2,0,2,6,6,12,0,0,0,2,2,4,180,127,307,328
20192020,087,MONTGOMERY,435,Montgomery County,"",---District Total---,435,"","",CKEC,901,02,152,162,2,3,5,0,0,0,1,0,1,6,10,16,0,0,0,6,4,10,147,135,282,314
20192020,087,MONTGOMERY,435,Montgomery County,"",---District Total---,435,"","",CKEC,901,03,130,181,3,2,5,0,0,0,0,1,1,12,10,22,0,0,0,4,0,4,162,117,279,311
20192020,087,MONTGOMERY,435,Montgomery County,"",---District Total---,435,"","",CKEC,901,04,185,163,0,3,3,0,0,0,1,1,2,17,11,28,0,0,0,3,4,7,142,166,308,348
20192020,087,MONTGOMERY,435,Montgomery County,"",---District Total---,435,"","",CKEC,901,05,182,190,4,3,7,0,1,1,2,3,5,11,7,18,0,0,0,3,7,10,170,161,331,372
20192020,087,MONTGOMERY,435,Montgomery County,"",---District Total---,435,"","",CKEC,901,06,168,157,2,5,7,1,0,1,1,0,1,12,8,20,0,0,0,2,7,9,139,148,287,325
20192020,087,MONTGOMERY,435,Montgomery County,"",---District Total---,435,"","",CKEC,901,07,188,199,6,5,11,0,0,0,1,2,3,15,8,23,0,0,0,9,1,10,168,172,340,387
20192020,087,MONTGOMERY,435,Montgomery County,"",---District Total---,435,"","",CKEC,901,08,166,165,2,4,6,0,1,1,0,0,0,11,9,20,0,0,0,7,6,13,145,146,291,331
20192020,087,MONTGOMERY,435,Montgomery County,"",---District Total---,435,"","",CKEC,901,09,166,196,7,3,10,1,0,1,3,0,3,16,9,25,0,0,0,4,6,10,165,148,313,362
20192020,087,MONTGOMERY,435,Montgomery County,"",---District Total---,435,"","",CKEC,901,10,154,171,3,1,4,0,0,0,0,0,0,10,5,15,0,0,0,0,3,3,158,145,303,325
20192020,087,MONTGOMERY,435,Montgomery County,010,Camargo Elementary School,435010,087435010,210425001057,CKEC,901,04,54,52,0,0,0,0,0,0,1,0,1,3,2,5,0,0,0,1,1,2,47,51,98,106
20192020,087,MONTGOMERY,435,Montgomery County,010,Camargo Elementary School,435010,087435010,210425001057,CKEC,901,All Students,257,297,2,1,3,0,0,0,2,1,3,16,7,23,0,0,0,6,5,11,271,243,514,554
20192020,087,MONTGOMERY,435,Montgomery County,010,Camargo Elementary School,435010,087435010,210425001057,CKEC,901,PS,33,35,1,0,1,0,0,0,0,0,0,2,0,2,0,0,0,1,0,1,31,33,64,68
20192020,087,MONTGOMERY,435,Montgomery County,010,Camargo Elementary School,435010,087435010,210425001057,CKEC,901,KG,39,54,0,0,0,0,0,0,0,0,0,5,0,5,0,0,0,3,0,3,46,39,85,93
20192020,087,MONTGOMERY,435,Montgomery County,010,Camargo Elementary School,435010,087435010,210425001057,CKEC,901,01,37,58,1,0,1,0,0,0,0,0,0,0,2,2,0,0,0,0,0,0,57,35,92,95
20192020,087,MONTGOMERY,435,Montgomery County,010,Camargo Elementary School,435010,087435010,210425001057,CKEC,901,02,38,39,1,0,1,0,0,0,0,0,0,0,1,1,0,0,0,0,1,1,38,36,74,77
20192020,087,MONTGOMERY,435,Montgomery County,010,Camargo Elementary School,435010,087435010,210425001057,CKEC,901,03,31,49,0,0,0,0,0,0,0,1,1,4,1,5,0,0,0,2,0,2,43,29,72,80
20192020,087,MONTGOMERY,435,Montgomery County,010,Camargo Elementary School,435010,087435010,210425001057,CKEC,901,05,58,45,0,1,1,0,0,0,1,0,1,4,1,5,0,0,0,0,3,3,40,53,93,103
20192020,087,MONTGOMERY,435,Montgomery County,013,Hillcrest Hall Treatment Center,435013,087435013,210425001867,CKEC,901,All Students,0,1,0,0,0,0,0,0,0,0,0,0,0,0,0,0,0,0,0,0,1,0,1,1
20192020,087,MONTGOMERY,435,Montgomery County,013,Hillcrest Hall Treatment Center,435013,087435013,210425001867,CKEC,901,12,0,1,0,0,0,0,0,0,0,0,0,0,0,0,0,0,0,0,0,0,1,0,1,1
20192020,087,MONTGOMERY,435,Montgomery County,014,Gateway Children's Services,435014,087435014,210425001868,CKEC,901,09,2,2,0,0,0,0,0,0,0,0,0,0,1,1,0,0,0,0,0,0,2,1,3,4
20192020,087,MONTGOMERY,435,Montgomery County,014,Gateway Children's Services,435014,087435014,210425001868,CKEC,901,All Students,8,8,0,0,0,0,0,0,0,0,0,0,2,2,0,0,0,1,2,3,7,4,11,16
20192020,087,MONTGOMERY,435,Montgomery County,014,Gateway Children's Services,435014,087435014,210425001868,CKEC,901,07,1,1,0,0,0,0,0,0,0,0,0,0,0,0,0,0,0,0,0,0,1,1,2,2
20192020,087,MONTGOMERY,435,Montgomery County,014,Gateway Children's Services,435014,087435014,210425001868,CKEC,901,08,1,0,0,0,0,0,0,0,0,0,0,0,1,1,0,0,0,0,0,0,0,0,0,1
20192020,087,MONTGOMERY,435,Montgomery County,014,Gateway Children's Services,435014,087435014,210425001868,CKEC,901,10,0,1,0,0,0,0,0,0,0,0,0,0,0,0,0,0,0,0,0,0,1,0,1,1
20192020,087,MONTGOMERY,435,Montgomery County,014,Gateway Children's Services,435014,087435014,210425001868,CKEC,901,11,2,1,0,0,0,0,0,0,0,0,0,0,0,0,0,0,0,0,1,1,1,1,2,3
20192020,087,MONTGOMERY,435,Montgomery County,014,Gateway Children's Services,435014,087435014,210425001868,CKEC,901,12,2,3,0,0,0,0,0,0,0,0,0,0,0,0,0,0,0,1,1,2,2,1,3,5
20192020,087,MONTGOMERY,435,Montgomery County,025,Northview Elementary,435025,087435025,210425002472,CKEC,901,05,40,52,2,0,2,0,0,0,0,2,2,0,1,1,0,0,0,1,2,3,49,35,84,92
20192020,087,MONTGOMERY,435,Montgomery County,025,Northview Elementary,435025,087435025,210425002472,CKEC,901,All Students,266,300,4,5,9,0,0,0,2,3,5,16,15,31,0,0,0,4,4,8,274,239,513,566
20192020,087,MONTGOMERY,435,Montgomery County,025,Northview Elementary,435025,087435025,210425002472,CKEC,901,PS,29,36,2,0,2,0,0,0,1,1,2,1,2,3,0,0,0,1,0,1,31,26,57,65
20192020,087,MONTGOMERY,435,Montgomery County,025,Northview Elementary,435025,087435025,210425002472,CKEC,901,KG,46,45,0,0,0,0,0,0,0,0,0,6,3,9,0,0,0,0,1,1,39,42,81,91
20192020,087,MONTGOMERY,435,Montgomery County,025,Northview Elementary,435025,087435025,210425002472,CKEC,901,01,46,57,0,1,1,0,0,0,1,0,1,0,2,2,0,0,0,0,0,0,56,43,99,103
20192020,087,MONTGOMERY,435,Montgomery County,025,Northview Elementary,435025,087435025,210425002472,CKEC,901,02,54,49,0,1,1,0,0,0,1,0,1,2,4,6,0,0,0,1,0,1,45,49,94,103
20192020,087,MONTGOMERY,435,Montgomery County,025,Northview Elementary,435025,087435025,210425002472,CKEC,901,03,36,49,2,2,4,0,0,0,0,0,0,2,4,6,0,0,0,1,0,1,44,30,74,85
20192020,087,MONTGOMERY,435,Montgomery County,025,Northview Elementary,435025,087435025,210425002472,CKEC,901,04,44,48,0,1,1,0,0,0,0,1,1,6,1,7,0,0,0,1,1,2,41,40,81,92
20192020,087,MONTGOMERY,435,Montgomery County,030,Mapleton Elementary School,435030,087435030,210425001058,CKEC,901,04,48,29,0,2,2,0,0,0,0,0,0,1,4,5,0,0,0,1,1,2,27,41,68,77
20192020,087,MONTGOMERY,435,Montgomery County,030,Mapleton Elementary School,435030,087435030,210425001058,CKEC,901,All Students,209,234,1,3,4,0,1,1,3,1,4,9,12,21,0,0,0,8,4,12,213,188,401,443
20192020,087,MONTGOMERY,435,Montgomery County,030,Mapleton Elementary School,435030,087435030,210425001058,CKEC,901,PS,18,14,0,0,0,0,0,0,0,0,0,0,1,1,0,0,0,0,0,0,14,17,31,32
20192020,087,MONTGOMERY,435,Montgomery County,030,Mapleton Elementary School,435030,087435030,210425001058,CKEC,901,KG,32,37,0,0,0,0,0,0,1,1,2,1,2,3,0,0,0,1,1,2,34,28,62,69
20192020,087,MONTGOMERY,435,Montgomery County,030,Mapleton Elementary School,435030,087435030,210425001058,CKEC,901,01,24,39,1,0,1,0,0,0,1,0,1,4,2,6,0,0,0,0,1,1,33,21,54,63
20192020,087,MONTGOMERY,435,Montgomery County,030,Mapleton Elementary School,435030,087435030,210425001058,CKEC,901,02,33,36,0,1,1,0,0,0,0,0,0,1,1,2,0,0,0,3,1,4,32,30,62,69
20192020,087,MONTGOMERY,435,Montgomery County,030,Mapleton Elementary School,435030,087435030,210425001058,CKEC,901,03,34,42,0,0,0,0,0,0,0,0,0,0,2,2,0,0,0,1,0,1,41,32,73,76
20192020,087,MONTGOMERY,435,Montgomery County,030,Mapleton Elementary School,435030,087435030,210425001058,CKEC,901,05,38,51,0,0,0,0,1,1,1,0,1,2,1,3,0,0,0,2,0,2,46,36,82,89
20192020,087,MONTGOMERY,435,Montgomery County,040,Montgomery County High School,435040,087435040,210425001059,CKEC,901,11,148,166,5,0,5,0,0,0,1,2,3,10,10,20,0,0,0,4,3,7,146,133,279,314
20192020,087,MONTGOMERY,435,Montgomery County,040,Montgomery County High School,435040,087435040,210425001059,CKEC,901,All Students,604,657,20,11,31,1,0,1,4,3,7,45,35,80,0,0,0,8,16,24,579,539,1118,1261
20192020,087,MONTGOMERY,435,Montgomery County,040,Montgomery County High School,435040,087435040,210425001059,CKEC,901,09,158,187,7,3,10,1,0,1,3,0,3,16,8,24,0,0,0,4,6,10,156,141,297,345
20192020,087,MONTGOMERY,435,Montgomery County,040,Montgomery County High School,435040,087435040,210425001059,CKEC,901,10,150,161,3,1,4,0,0,0,0,0,0,10,5,15,0,0,0,0,3,3,148,141,289,311
20192020,087,MONTGOMERY,435,Montgomery County,040,Montgomery County High School,435040,087435040,210425001059,CKEC,901,12,148,143,5,7,12,0,0,0,0,1,1,9,12,21,0,0,0,0,4,4,129,124,253,291
20192020,087,MONTGOMERY,435,Montgomery County,050,Mount Sterling Elementary School,435050,087435050,210425001060,CKEC,901,04,39,34,0,0,0,0,0,0,0,0,0,7,4,11,0,0,0,0,1,1,27,34,61,73
20192020,087,MONTGOMERY,435,Montgomery County,050,Mount Sterling Elementary School,435050,087435050,210425001060,CKEC,901,All Students,217,221,4,3,7,0,0,0,0,1,1,27,20,47,0,0,0,6,8,14,184,185,369,438
20192020,087,MONTGOMERY,435,Montgomery County,050,Mount Sterling Elementary School,435050,087435050,210425001060,CKEC,901,PS,22,29,2,0,2,0,0,0,0,0,0,3,3,6,0,0,0,0,0,0,24,19,43,51
20192020,087,MONTGOMERY,435,Montgomery County,050,Mount Sterling Elementary School,435050,087435050,210425001060,CKEC,901,KG,47,28,0,0,0,0,0,0,0,0,0,4,5,9,0,0,0,2,2,4,22,40,62,75
20192020,087,MONTGOMERY,435,Montgomery County,050,Mount Sterling Elementary School,435050,087435050,210425001060,CKEC,901,01,29,38,0,0,0,0,0,0,0,0,0,2,0,2,0,0,0,2,1,3,34,28,62,67
20192020,087,MONTGOMERY,435,Montgomery County,050,Mount Sterling Elementary School,435050,087435050,210425001060,CKEC,901,02,27,38,1,1,2,0,0,0,0,0,0,3,4,7,0,0,0,2,2,4,32,20,52,65
20192020,087,MONTGOMERY,435,Montgomery County,050,Mount Sterling Elementary School,435050,087435050,210425001060,CKEC,901,03,29,41,1,0,1,0,0,0,0,0,0,6,3,9,0,0,0,0,0,0,34,26,60,70
20192020,087,MONTGOMERY,435,Montgomery County,050,Mount Sterling Elementary School,435050,087435050,210425001060,CKEC,901,05,46,42,2,2,4,0,0,0,0,1,1,5,4,9,0,0,0,0,2,2,35,37,72,88
20192020,087,MONTGOMERY,435,Montgomery County,070,McNabb Middle School,435070,087435070,210425001538,CKEC,901,07,185,193,6,5,11,0,0,0,1,2,3,13,8,21,0,0,0,9,1,10,164,169,333,378
20192020,087,MONTGOMERY,435,Montgomery County,070,McNabb Middle School,435070,087435070,210425001538,CKEC,901,All Students,516,515,10,13,23,1,1,2,2,2,4,36,23,59,0,0,0,18,14,32,448,463,911,1031
20192020,087,MONTGOMERY,435,Montgomery County,070,McNabb Middle School,435070,087435070,210425001538,CKEC,901,06,168,157,2,5,7,1,0,1,1,0,1,12,8,20,0,0,0,2,7,9,139,148,287,325
20192020,087,MONTGOMERY,435,Montgomery County,070,McNabb Middle School,435070,087435070,210425001538,CKEC,901,08,163,165,2,3,5,0,1,1,0,0,0,11,7,18,0,0,0,7,6,13,145,146,291,328
20192020,087,MONTGOMERY,435,Montgomery County,080,The Sterling School,435080,087435080,210425002317,CKEC,901,10,4,9,0,0,0,0,0,0,0,0,0,0,0,0,0,0,0,0,0,0,9,4,13,13
20192020,087,MONTGOMERY,435,Montgomery County,080,The Sterling School,435080,087435080,210425002317,CKEC,901,All Students,33,37,0,2,2,0,0,0,0,0,0,3,1,4,0,0,0,1,1,2,33,29,62,70
20192020,087,MONTGOMERY,435,Montgomery County,080,The Sterling School,435080,087435080,210425002317,CKEC,901,07,2,5,0,0,0,0,0,0,0,0,0,2,0,2,0,0,0,0,0,0,3,2,5,7
20192020,087,MONTGOMERY,435,Montgomery County,080,The Sterling School,435080,087435080,210425002317,CKEC,901,08,2,0,0,1,1,0,0,0,0,0,0,0,1,1,0,0,0,0,0,0,0,0,0,2
20192020,087,MONTGOMERY,435,Montgomery County,080,The Sterling School,435080,087435080,210425002317,CKEC,901,12,13,12,0,1,1,0,0,0,0,0,0,1,0,1,0,0,0,1,1,2,10,11,21,25
20192020,087,MONTGOMERY,435,Montgomery County,080,The Sterling School,435080,087435080,210425002317,CKEC,901,09,6,7,0,0,0,0,0,0,0,0,0,0,0,0,0,0,0,0,0,0,7,6,13,13
20192020,087,MONTGOMERY,435,Montgomery County,080,The Sterling School,435080,087435080,210425002317,CKEC,901,11,6,4,0,0,0,0,0,0,0,0,0,0,0,0,0,0,0,0,0,0,4,6,10,10
20192020,088,MORGAN,441,Morgan County,"",---District Total---,441,"","",KEDC,903,05,70,76,2,2,4,0,0,0,0,0,0,0,0,0,0,0,0,0,0,0,74,68,142,146
20192020,088,MORGAN,441,Morgan County,"",---District Total---,441,"","",KEDC,903,All Students,866,1042,16,7,23,1,1,2,0,2,2,3,6,9,0,0,0,0,3,3,1022,847,1869,1908
20192020,088,MORGAN,441,Morgan County,"",---District Total---,441,"","",KEDC,903,PS,11,34,0,0,0,0,0,0,0,0,0,0,0,0,0,0,0,0,0,0,34,11,45,45
20192020,088,MORGAN,441,Morgan County,"",---District Total---,441,"","",KEDC,903,KG,60,92,0,0,0,0,0,0,0,0,0,0,0,0,0,0,0,0,0,0,92,60,152,152
20192020,088,MORGAN,441,Morgan County,"",---District Total---,441,"","",KEDC,903,01,57,77,1,1,2,0,0,0,0,0,0,0,0,0,0,0,0,0,0,0,76,56,132,134
20192020,088,MORGAN,441,Morgan County,"",---District Total---,441,"","",KEDC,903,02,70,73,1,1,2,0,0,0,0,0,0,0,1,1,0,0,0,0,0,0,72,68,140,143
20192020,088,MORGAN,441,Morgan County,"",---District Total---,441,"","",KEDC,903,03,60,72,0,2,2,0,0,0,0,0,0,1,0,1,0,0,0,0,0,0,71,58,129,132
20192020,088,MORGAN,441,Morgan County,"",---District Total---,441,"","",KEDC,903,04,57,87,0,0,0,0,0,0,0,0,0,0,0,0,0,0,0,0,0,0,87,57,144,144
20192020,088,MORGAN,441,Morgan County,"",---District Total---,441,"","",KEDC,903,06,74,80,1,0,1,0,0,0,0,0,0,0,1,1,0,0,0,0,0,0,79,73,152,154
20192020,088,MORGAN,441,Morgan County,"",---District Total---,441,"","",KEDC,903,07,74,79,0,1,1,0,0,0,0,0,0,1,2,3,0,0,0,0,2,2,78,69,147,153
20192020,088,MORGAN,441,Morgan County,"",---District Total---,441,"","",KEDC,903,08,70,88,0,0,0,0,0,0,0,1,1,0,0,0,0,0,0,0,0,0,88,69,157,158
20192020,088,MORGAN,441,Morgan County,"",---District Total---,441,"","",KEDC,903,09,75,94,7,0,7,1,0,1,0,0,0,0,0,0,0,0,0,0,0,0,86,75,161,169
20192020,088,MORGAN,441,Morgan County,"",---District Total---,441,"","",KEDC,903,10,68,66,0,0,0,0,0,0,0,1,1,0,1,1,0,0,0,0,0,0,66,66,132,134
20192020,088,MORGAN,441,Morgan County,"",---District Total---,441,"","",KEDC,903,11,62,76,0,0,0,0,1,1,0,0,0,0,0,0,0,0,0,0,1,1,76,60,136,138
20192020,088,MORGAN,441,Morgan County,"",---District Total---,441,"","",KEDC,903,12,69,82,4,0,4,0,0,0,0,0,0,1,1,2,0,0,0,0,0,0,77,68,145,151
20192020,088,MORGAN,441,Morgan County,015,Morgan Central Elementary School,441015,088441015,210429002194,KEDC,903,05,24,30,0,2,2,0,0,0,0,0,0,0,0,0,0,0,0,0,0,0,30,22,52,54
20192020,088,MORGAN,441,Morgan County,015,Morgan Central Elementary School,441015,088441015,210429002194,KEDC,903,All Students,124,164,1,5,6,0,0,0,0,0,0,0,1,1,0,0,0,0,0,0,163,118,281,288
20192020,088,MORGAN,441,Morgan County,015,Morgan Central Elementary School,441015,088441015,210429002194,KEDC,903,PS,5,14,0,0,0,0,0,0,0,0,0,0,0,0,0,0,0,0,0,0,14,5,19,19
20192020,088,MORGAN,441,Morgan County,015,Morgan Central Elementary School,441015,088441015,210429002194,KEDC,903,KG,24,29,0,0,0,0,0,0,0,0,0,0,0,0,0,0,0,0,0,0,29,24,53,53
20192020,088,MORGAN,441,Morgan County,015,Morgan Central Elementary School,441015,088441015,210429002194,KEDC,903,01,17,25,1,0,1,0,0,0,0,0,0,0,0,0,0,0,0,0,0,0,24,17,41,42
20192020,088,MORGAN,441,Morgan County,015,Morgan Central Elementary School,441015,088441015,210429002194,KEDC,903,02,28,29,0,1,1,0,0,0,0,0,0,0,1,1,0,0,0,0,0,0,29,26,55,57
20192020,088,MORGAN,441,Morgan County,015,Morgan Central Elementary School,441015,088441015,210429002194,KEDC,903,03,16,30,0,2,2,0,0,0,0,0,0,0,0,0,0,0,0,0,0,0,30,14,44,46
20192020,088,MORGAN,441,Morgan County,015,Morgan Central Elementary School,441015,088441015,210429002194,KEDC,903,04,15,21,0,0,0,0,0,0,0,0,0,0,0,0,0,0,0,0,0,0,21,15,36,36
20192020,088,MORGAN,441,Morgan County,018,Wrigley Elementary School,441018,088441018,210429002214,KEDC,903,04,21,33,0,0,0,0,0,0,0,0,0,0,0,0,0,0,0,0,0,0,33,21,54,54
20192020,088,MORGAN,441,Morgan County,018,Wrigley Elementary School,441018,088441018,210429002214,KEDC,903,All Students,144,172,1,0,1,0,0,0,0,0,0,1,0,1,0,0,0,0,0,0,170,144,314,316
20192020,088,MORGAN,441,Morgan County,018,Wrigley Elementary School,441018,088441018,210429002214,KEDC,903,PS,6,18,0,0,0,0,0,0,0,0,0,0,0,0,0,0,0,0,0,0,18,6,24,24
20192020,088,MORGAN,441,Morgan County,018,Wrigley Elementary School,441018,088441018,210429002214,KEDC,903,KG,21,36,0,0,0,0,0,0,0,0,0,0,0,0,0,0,0,0,0,0,36,21,57,57
20192020,088,MORGAN,441,Morgan County,018,Wrigley Elementary School,441018,088441018,210429002214,KEDC,903,01,29,27,0,0,0,0,0,0,0,0,0,0,0,0,0,0,0,0,0,0,27,29,56,56
20192020,088,MORGAN,441,Morgan County,018,Wrigley Elementary School,441018,088441018,210429002214,KEDC,903,02,23,25,1,0,1,0,0,0,0,0,0,0,0,0,0,0,0,0,0,0,24,23,47,48
20192020,088,MORGAN,441,Morgan County,018,Wrigley Elementary School,441018,088441018,210429002214,KEDC,903,03,24,24,0,0,0,0,0,0,0,0,0,1,0,1,0,0,0,0,0,0,23,24,47,48
20192020,088,MORGAN,441,Morgan County,018,Wrigley Elementary School,441018,088441018,210429002214,KEDC,903,05,26,27,0,0,0,0,0,0,0,0,0,0,0,0,0,0,0,0,0,0,27,26,53,53
20192020,088,MORGAN,441,Morgan County,050,East Valley Elementary School,441050,088441050,210429001549,KEDC,903,01,8,12,0,1,1,0,0,0,0,0,0,0,0,0,0,0,0,0,0,0,12,7,19,20
20192020,088,MORGAN,441,Morgan County,050,East Valley Elementary School,441050,088441050,210429001549,KEDC,903,All Students,64,60,2,1,3,0,0,0,0,0,0,0,0,0,0,0,0,0,0,0,58,63,121,124
20192020,088,MORGAN,441,Morgan County,050,East Valley Elementary School,441050,088441050,210429001549,KEDC,903,PS,0,1,0,0,0,0,0,0,0,0,0,0,0,0,0,0,0,0,0,0,1,0,1,1
20192020,088,MORGAN,441,Morgan County,050,East Valley Elementary School,441050,088441050,210429001549,KEDC,903,KG,5,13,0,0,0,0,0,0,0,0,0,0,0,0,0,0,0,0,0,0,13,5,18,18
20192020,088,MORGAN,441,Morgan County,050,East Valley Elementary School,441050,088441050,210429001549,KEDC,903,02,11,6,0,0,0,0,0,0,0,0,0,0,0,0,0,0,0,0,0,0,6,11,17,17
20192020,088,MORGAN,441,Morgan County,050,East Valley Elementary School,441050,088441050,210429001549,KEDC,903,03,13,8,0,0,0,0,0,0,0,0,0,0,0,0,0,0,0,0,0,0,8,13,21,21
20192020,088,MORGAN,441,Morgan County,050,East Valley Elementary School,441050,088441050,210429001549,KEDC,903,04,16,12,0,0,0,0,0,0,0,0,0,0,0,0,0,0,0,0,0,0,12,16,28,28
20192020,088,MORGAN,441,Morgan County,050,East Valley Elementary School,441050,088441050,210429001549,KEDC,903,05,11,9,2,0,2,0,0,0,0,0,0,0,0,0,0,0,0,0,0,0,7,11,18,20
20192020,088,MORGAN,441,Morgan County,090,Ezel Elementary School,441090,088441090,210429001066,KEDC,903,05,9,10,0,0,0,0,0,0,0,0,0,0,0,0,0,0,0,0,0,0,10,9,19,19
20192020,088,MORGAN,441,Morgan County,090,Ezel Elementary School,441090,088441090,210429001066,KEDC,903,All Students,42,81,0,0,0,0,0,0,0,0,0,0,0,0,0,0,0,0,0,0,81,42,123,123
20192020,088,MORGAN,441,Morgan County,090,Ezel Elementary School,441090,088441090,210429001066,KEDC,903,PS,0,1,0,0,0,0,0,0,0,0,0,0,0,0,0,0,0,0,0,0,1,0,1,1
20192020,088,MORGAN,441,Morgan County,090,Ezel Elementary School,441090,088441090,210429001066,KEDC,903,KG,10,14,0,0,0,0,0,0,0,0,0,0,0,0,0,0,0,0,0,0,14,10,24,24
20192020,088,MORGAN,441,Morgan County,090,Ezel Elementary School,441090,088441090,210429001066,KEDC,903,01,3,13,0,0,0,0,0,0,0,0,0,0,0,0,0,0,0,0,0,0,13,3,16,16
20192020,088,MORGAN,441,Morgan County,090,Ezel Elementary School,441090,088441090,210429001066,KEDC,903,02,8,13,0,0,0,0,0,0,0,0,0,0,0,0,0,0,0,0,0,0,13,8,21,21
20192020,088,MORGAN,441,Morgan County,090,Ezel Elementary School,441090,088441090,210429001066,KEDC,903,03,7,10,0,0,0,0,0,0,0,0,0,0,0,0,0,0,0,0,0,0,10,7,17,17
20192020,088,MORGAN,441,Morgan County,090,Ezel Elementary School,441090,088441090,210429001066,KEDC,903,04,5,21,0,0,0,0,0,0,0,0,0,0,0,0,0,0,0,0,0,0,21,5,26,26
20192020,088,MORGAN,441,Morgan County,140,Morgan County Middle School,441140,088441140,210429001067,KEDC,903,07,74,79,0,1,1,0,0,0,0,0,0,1,2,3,0,0,0,0,2,2,78,69,147,153
20192020,088,MORGAN,441,Morgan County,140,Morgan County Middle School,441140,088441140,210429001067,KEDC,903,All Students,218,246,1,1,2,0,0,0,0,1,1,1,3,4,0,0,0,0,2,2,244,211,455,464
20192020,088,MORGAN,441,Morgan County,140,Morgan County Middle School,441140,088441140,210429001067,KEDC,903,06,74,80,1,0,1,0,0,0,0,0,0,0,1,1,0,0,0,0,0,0,79,73,152,154
20192020,088,MORGAN,441,Morgan County,140,Morgan County Middle School,441140,088441140,210429001067,KEDC,903,08,70,87,0,0,0,0,0,0,0,1,1,0,0,0,0,0,0,0,0,0,87,69,156,157
20192020,088,MORGAN,441,Morgan County,150,Morgan County High School,441150,088441150,210429001068,KEDC,903,10,68,64,0,0,0,0,0,0,0,1,1,0,1,1,0,0,0,0,0,0,64,66,130,132
20192020,088,MORGAN,441,Morgan County,150,Morgan County High School,441150,088441150,210429001068,KEDC,903,12,69,76,0,0,0,0,0,0,0,0,0,1,1,2,0,0,0,0,0,0,75,68,143,145
20192020,088,MORGAN,441,Morgan County,150,Morgan County High School,441150,088441150,210429001068,KEDC,903,All Students,274,301,1,0,1,1,1,2,0,1,1,1,2,3,0,0,0,0,1,1,298,269,567,575
20192020,088,MORGAN,441,Morgan County,150,Morgan County High School,441150,088441150,210429001068,KEDC,903,09,75,87,1,0,1,1,0,1,0,0,0,0,0,0,0,0,0,0,0,0,85,75,160,162
20192020,088,MORGAN,441,Morgan County,150,Morgan County High School,441150,088441150,210429001068,KEDC,903,11,62,74,0,0,0,0,1,1,0,0,0,0,0,0,0,0,0,0,1,1,74,60,134,136
20192020,088,MORGAN,441,Morgan County,230,Woodsbend Youth Development Center,441230,088441230,210429001070,KEDC,903,08,0,1,0,0,0,0,0,0,0,0,0,0,0,0,0,0,0,0,0,0,1,0,1,1
20192020,088,MORGAN,441,Morgan County,230,Woodsbend Youth Development Center,441230,088441230,210429001070,KEDC,903,All Students,0,18,10,0,10,0,0,0,0,0,0,0,0,0,0,0,0,0,0,0,8,0,8,18
20192020,088,MORGAN,441,Morgan County,230,Woodsbend Youth Development Center,441230,088441230,210429001070,KEDC,903,09,0,7,6,0,6,0,0,0,0,0,0,0,0,0,0,0,0,0,0,0,1,0,1,7
20192020,088,MORGAN,441,Morgan County,230,Woodsbend Youth Development Center,441230,088441230,210429001070,KEDC,903,10,0,2,0,0,0,0,0,0,0,0,0,0,0,0,0,0,0,0,0,0,2,0,2,2
20192020,088,MORGAN,441,Morgan County,230,Woodsbend Youth Development Center,441230,088441230,210429001070,KEDC,903,11,0,2,0,0,0,0,0,0,0,0,0,0,0,0,0,0,0,0,0,0,2,0,2,2
20192020,088,MORGAN,441,Morgan County,230,Woodsbend Youth Development Center,441230,088441230,210429001070,KEDC,903,12,0,6,4,0,4,0,0,0,0,0,0,0,0,0,0,0,0,0,0,0,2,0,2,6
20192020,089,MUHLENBERG,445,Muhlenberg County,"",---District Total---,445,"","",WKEC,908,14,0,1,0,0,0,0,0,0,0,0,0,0,0,0,0,0,0,0,0,0,1,0,1,1
20192020,089,MUHLENBERG,445,Muhlenberg County,"",---District Total---,445,"","",WKEC,908,All Students,2058,2214,48,41,89,0,2,2,12,7,19,62,62,124,4,1,5,80,76,156,2008,1869,3877,4272
20192020,089,MUHLENBERG,445,Muhlenberg County,"",---District Total---,445,"","",WKEC,908,PS,135,157,6,1,7,0,0,0,1,1,2,3,5,8,0,0,0,6,9,15,141,119,260,292
20192020,089,MUHLENBERG,445,Muhlenberg County,"",---District Total---,445,"","",WKEC,908,KG,169,158,2,1,3,0,0,0,0,0,0,5,5,10,0,1,1,9,4,13,142,158,300,327
20192020,089,MUHLENBERG,445,Muhlenberg County,"",---District Total---,445,"","",WKEC,908,01,172,185,2,5,7,0,0,0,1,1,2,4,1,5,0,0,0,9,13,22,169,152,321,357
20192020,089,MUHLENBERG,445,Muhlenberg County,"",---District Total---,445,"","",WKEC,908,02,157,159,6,2,8,0,0,0,2,0,2,6,3,9,0,0,0,5,11,16,140,141,281,316
20192020,089,MUHLENBERG,445,Muhlenberg County,"",---District Total---,445,"","",WKEC,908,03,153,172,2,2,4,0,0,0,0,0,0,6,9,15,0,0,0,4,6,10,160,136,296,325
20192020,089,MUHLENBERG,445,Muhlenberg County,"",---District Total---,445,"","",WKEC,908,04,162,178,5,2,7,0,0,0,0,1,1,7,7,14,0,0,0,9,5,14,157,147,304,340
20192020,089,MUHLENBERG,445,Muhlenberg County,"",---District Total---,445,"","",WKEC,908,05,160,163,2,3,5,0,0,0,0,1,1,4,3,7,0,0,0,4,4,8,153,149,302,323
20192020,089,MUHLENBERG,445,Muhlenberg County,"",---District Total---,445,"","",WKEC,908,06,151,192,5,6,11,0,0,0,2,1,3,5,3,8,0,0,0,6,8,14,174,133,307,343
20192020,089,MUHLENBERG,445,Muhlenberg County,"",---District Total---,445,"","",WKEC,908,07,166,178,3,2,5,0,2,2,4,0,4,3,5,8,1,0,1,9,6,15,158,151,309,344
20192020,089,MUHLENBERG,445,Muhlenberg County,"",---District Total---,445,"","",WKEC,908,08,156,180,2,1,3,0,0,0,1,1,2,3,6,9,0,0,0,8,9,17,166,139,305,336
20192020,089,MUHLENBERG,445,Muhlenberg County,"",---District Total---,445,"","",WKEC,908,09,173,187,5,4,9,0,0,0,1,1,2,4,6,10,1,0,1,8,2,10,168,160,328,360
20192020,089,MUHLENBERG,445,Muhlenberg County,"",---District Total---,445,"","",WKEC,908,10,161,184,7,6,13,0,0,0,1,0,1,6,7,13,0,0,0,6,4,10,164,144,308,345
20192020,089,MUHLENBERG,445,Muhlenberg County,"",---District Total---,445,"","",WKEC,908,11,140,134,5,5,10,0,0,0,0,1,1,5,2,7,0,0,0,1,2,3,123,130,253,274
20192020,089,MUHLENBERG,445,Muhlenberg County,"",---District Total---,445,"","",WKEC,908,12,138,143,2,2,4,0,0,0,0,0,0,4,5,9,2,0,2,2,2,4,133,129,262,281
20192020,089,MUHLENBERG,445,Muhlenberg County,010,Bremen Elementary School,445010,089445010,210008101072,WKEC,908,04,28,29,0,0,0,0,0,0,0,0,0,1,2,3,0,0,0,3,0,3,25,26,51,57
20192020,089,MUHLENBERG,445,Muhlenberg County,010,Bremen Elementary School,445010,089445010,210008101072,WKEC,908,All Students,158,179,0,0,0,0,0,0,0,1,1,6,5,11,0,0,0,5,3,8,168,149,317,337
20192020,089,MUHLENBERG,445,Muhlenberg County,010,Bremen Elementary School,445010,089445010,210008101072,WKEC,908,PS,27,34,0,0,0,0,0,0,0,0,0,1,1,2,0,0,0,2,1,3,31,25,56,61
20192020,089,MUHLENBERG,445,Muhlenberg County,010,Bremen Elementary School,445010,089445010,210008101072,WKEC,908,KG,20,32,0,0,0,0,0,0,0,0,0,1,0,1,0,0,0,0,0,0,31,20,51,52
20192020,089,MUHLENBERG,445,Muhlenberg County,010,Bremen Elementary School,445010,089445010,210008101072,WKEC,908,01,26,28,0,0,0,0,0,0,0,1,1,0,0,0,0,0,0,1,0,1,27,25,52,54
20192020,089,MUHLENBERG,445,Muhlenberg County,010,Bremen Elementary School,445010,089445010,210008101072,WKEC,908,02,35,30,0,0,0,0,0,0,0,0,0,3,1,4,0,0,0,1,3,4,26,31,57,65
20192020,089,MUHLENBERG,445,Muhlenberg County,010,Bremen Elementary School,445010,089445010,210008101072,WKEC,908,03,29,30,0,0,0,0,0,0,0,0,0,1,2,3,0,0,0,0,0,0,29,27,56,59
20192020,089,MUHLENBERG,445,Muhlenberg County,010,Bremen Elementary School,445010,089445010,210008101072,WKEC,908,05,20,30,0,0,0,0,0,0,0,0,0,0,0,0,0,0,0,0,0,0,30,20,50,50
20192020,089,MUHLENBERG,445,Muhlenberg County,012,Muhlenberg South Elementary,445012,089445012,210008101967,WKEC,908,04,50,41,3,0,3,0,0,0,0,1,1,1,0,1,0,0,0,0,1,1,37,48,85,91
20192020,089,MUHLENBERG,445,Muhlenberg County,012,Muhlenberg South Elementary,445012,089445012,210008101967,WKEC,908,All Students,250,250,5,2,7,0,0,0,0,1,1,3,4,7,0,0,0,6,6,12,236,237,473,500
20192020,089,MUHLENBERG,445,Muhlenberg County,012,Muhlenberg South Elementary,445012,089445012,210008101967,WKEC,908,PS,26,38,0,0,0,0,0,0,0,0,0,0,0,0,0,0,0,0,2,2,38,24,62,64
20192020,089,MUHLENBERG,445,Muhlenberg County,012,Muhlenberg South Elementary,445012,089445012,210008101967,WKEC,908,KG,52,44,0,0,0,0,0,0,0,0,0,0,2,2,0,0,0,3,1,4,41,49,90,96
20192020,089,MUHLENBERG,445,Muhlenberg County,012,Muhlenberg South Elementary,445012,089445012,210008101967,WKEC,908,01,43,50,1,1,2,0,0,0,0,0,0,0,0,0,0,0,0,2,1,3,47,41,88,93
20192020,089,MUHLENBERG,445,Muhlenberg County,012,Muhlenberg South Elementary,445012,089445012,210008101967,WKEC,908,02,32,30,0,0,0,0,0,0,0,0,0,0,2,2,0,0,0,1,1,2,29,29,58,62
20192020,089,MUHLENBERG,445,Muhlenberg County,012,Muhlenberg South Elementary,445012,089445012,210008101967,WKEC,908,03,38,44,0,0,0,0,0,0,0,0,0,1,0,1,0,0,0,0,1,1,43,37,80,82
20192020,089,MUHLENBERG,445,Muhlenberg County,012,Muhlenberg South Elementary,445012,089445012,210008101967,WKEC,908,05,35,41,1,1,2,0,0,0,0,0,0,1,0,1,0,0,0,0,1,1,39,33,72,76
20192020,089,MUHLENBERG,445,Muhlenberg County,030,Central City Elementary,445030,089445030,210008101514,WKEC,908,04,22,32,1,0,1,0,0,0,0,0,0,5,1,6,0,0,0,1,3,4,25,18,43,54
20192020,089,MUHLENBERG,445,Muhlenberg County,030,Central City Elementary,445030,089445030,210008101514,WKEC,908,02,18,25,1,0,1,0,0,0,2,0,2,0,0,0,0,0,0,2,2,4,20,16,36,43
20192020,089,MUHLENBERG,445,Muhlenberg County,030,Central City Elementary,445030,089445030,210008101514,WKEC,908,05,30,28,0,0,0,0,0,0,0,0,0,2,1,3,0,0,0,1,0,1,25,29,54,58
20192020,089,MUHLENBERG,445,Muhlenberg County,030,Central City Elementary,445030,089445030,210008101514,WKEC,908,All Students,149,172,6,5,11,0,0,0,2,0,2,15,8,23,0,1,1,12,11,23,137,124,261,321
20192020,089,MUHLENBERG,445,Muhlenberg County,030,Central City Elementary,445030,089445030,210008101514,WKEC,908,03,25,35,1,1,2,0,0,0,0,0,0,3,4,7,0,0,0,1,2,3,30,18,48,60
20192020,089,MUHLENBERG,445,Muhlenberg County,030,Central City Elementary,445030,089445030,210008101514,WKEC,908,PS,39,27,2,1,3,0,0,0,1,1,2,1,2,3,0,0,0,1,5,6,22,30,52,66
20192020,089,MUHLENBERG,445,Muhlenberg County,030,Central City Elementary,445030,089445030,210008101514,WKEC,908,KG,28,29,2,1,3,0,0,0,0,0,0,3,1,4,0,1,1,5,1,6,19,24,43,57
20192020,089,MUHLENBERG,445,Muhlenberg County,030,Central City Elementary,445030,089445030,210008101514,WKEC,908,01,26,23,1,3,4,0,0,0,0,0,0,2,1,3,0,0,0,2,3,5,18,19,37,49
20192020,089,MUHLENBERG,445,Muhlenberg County,035,The Renaissance Center,445035,089445035,210008101515,WKEC,908,All Students,20,44,0,1,1,0,0,0,0,0,0,0,1,1,0,0,0,5,0,5,39,18,57,64
20192020,089,MUHLENBERG,445,Muhlenberg County,035,The Renaissance Center,445035,089445035,210008101515,WKEC,908,06,1,2,0,0,0,0,0,0,0,0,0,0,0,0,0,0,0,0,0,0,2,1,3,3
20192020,089,MUHLENBERG,445,Muhlenberg County,035,The Renaissance Center,445035,089445035,210008101515,WKEC,908,07,0,5,0,0,0,0,0,0,0,0,0,0,0,0,0,0,0,0,0,0,5,0,5,5
20192020,089,MUHLENBERG,445,Muhlenberg County,035,The Renaissance Center,445035,089445035,210008101515,WKEC,908,08,0,7,0,0,0,0,0,0,0,0,0,0,0,0,0,0,0,2,0,2,5,0,5,7
20192020,089,MUHLENBERG,445,Muhlenberg County,035,The Renaissance Center,445035,089445035,210008101515,WKEC,908,09,5,9,0,0,0,0,0,0,0,0,0,0,1,1,0,0,0,0,0,0,9,4,13,14
20192020,089,MUHLENBERG,445,Muhlenberg County,035,The Renaissance Center,445035,089445035,210008101515,WKEC,908,10,6,14,0,1,1,0,0,0,0,0,0,0,0,0,0,0,0,3,0,3,11,5,16,20
20192020,089,MUHLENBERG,445,Muhlenberg County,035,The Renaissance Center,445035,089445035,210008101515,WKEC,908,11,7,4,0,0,0,0,0,0,0,0,0,0,0,0,0,0,0,0,0,0,4,7,11,11
20192020,089,MUHLENBERG,445,Muhlenberg County,035,The Renaissance Center,445035,089445035,210008101515,WKEC,908,12,1,3,0,0,0,0,0,0,0,0,0,0,0,0,0,0,0,0,0,0,3,1,4,4
20192020,089,MUHLENBERG,445,Muhlenberg County,040,Greenville Elementary School,445040,089445040,210008101516,WKEC,908,05,38,38,1,2,3,0,0,0,0,0,0,0,1,1,0,0,0,2,2,4,35,33,68,76
20192020,089,MUHLENBERG,445,Muhlenberg County,040,Greenville Elementary School,445040,089445040,210008101516,WKEC,908,All Students,232,224,7,7,14,0,0,0,0,0,0,5,8,13,0,0,0,7,17,24,205,200,405,456
20192020,089,MUHLENBERG,445,Muhlenberg County,040,Greenville Elementary School,445040,089445040,210008101516,WKEC,908,PS,26,36,4,0,4,0,0,0,0,0,0,0,2,2,0,0,0,2,1,3,30,23,53,62
20192020,089,MUHLENBERG,445,Muhlenberg County,040,Greenville Elementary School,445040,089445040,210008101516,WKEC,908,KG,36,25,0,0,0,0,0,0,0,0,0,0,1,1,0,0,0,0,1,1,25,34,59,61
20192020,089,MUHLENBERG,445,Muhlenberg County,040,Greenville Elementary School,445040,089445040,210008101516,WKEC,908,01,43,44,0,1,1,0,0,0,0,0,0,1,0,1,0,0,0,3,7,10,40,35,75,87
20192020,089,MUHLENBERG,445,Muhlenberg County,040,Greenville Elementary School,445040,089445040,210008101516,WKEC,908,02,41,42,5,2,7,0,0,0,0,0,0,3,0,3,0,0,0,0,4,4,34,35,69,83
20192020,089,MUHLENBERG,445,Muhlenberg County,040,Greenville Elementary School,445040,089445040,210008101516,WKEC,908,03,37,31,0,1,1,0,0,0,0,0,0,1,2,3,0,0,0,1,3,4,29,31,60,68
20192020,089,MUHLENBERG,445,Muhlenberg County,040,Greenville Elementary School,445040,089445040,210008101516,WKEC,908,04,37,44,1,1,2,0,0,0,0,0,0,0,4,4,0,0,0,1,0,1,42,32,74,81
20192020,089,MUHLENBERG,445,Muhlenberg County,045,Muhlenberg South Middle School,445045,089445045,210008101517,WKEC,908,07,80,74,2,2,4,0,1,1,1,0,1,0,2,2,1,0,1,3,1,4,67,74,141,154
20192020,089,MUHLENBERG,445,Muhlenberg County,045,Muhlenberg South Middle School,445045,089445045,210008101517,WKEC,908,All Students,207,233,7,5,12,0,1,1,1,0,1,3,4,7,1,0,1,5,12,17,216,185,401,440
20192020,089,MUHLENBERG,445,Muhlenberg County,045,Muhlenberg South Middle School,445045,089445045,210008101517,WKEC,908,06,61,87,4,3,7,0,0,0,0,0,0,2,1,3,0,0,0,1,6,7,80,51,131,148
20192020,089,MUHLENBERG,445,Muhlenberg County,045,Muhlenberg South Middle School,445045,089445045,210008101517,WKEC,908,08,66,72,1,0,1,0,0,0,0,0,0,1,1,2,0,0,0,1,5,6,69,60,129,138
20192020,089,MUHLENBERG,445,Muhlenberg County,115,Longest Elementary,445115,089445115,210008101080,WKEC,908,04,25,32,0,1,1,0,0,0,0,0,0,0,0,0,0,0,0,4,1,5,28,23,51,57
20192020,089,MUHLENBERG,445,Muhlenberg County,115,Longest Elementary,445115,089445115,210008101080,WKEC,908,All Students,184,190,1,1,2,0,0,0,1,1,2,3,3,6,0,0,0,10,6,16,175,173,348,374
20192020,089,MUHLENBERG,445,Muhlenberg County,115,Longest Elementary,445115,089445115,210008101080,WKEC,908,PS,17,22,0,0,0,0,0,0,0,0,0,1,0,1,0,0,0,1,0,1,20,17,37,39
20192020,089,MUHLENBERG,445,Muhlenberg County,115,Longest Elementary,445115,089445115,210008101080,WKEC,908,KG,33,28,0,0,0,0,0,0,0,0,0,1,1,2,0,0,0,1,1,2,26,31,57,61
20192020,089,MUHLENBERG,445,Muhlenberg County,115,Longest Elementary,445115,089445115,210008101080,WKEC,908,01,34,40,0,0,0,0,0,0,1,0,1,1,0,1,0,0,0,1,2,3,37,32,69,74
20192020,089,MUHLENBERG,445,Muhlenberg County,115,Longest Elementary,445115,089445115,210008101080,WKEC,908,02,31,32,0,0,0,0,0,0,0,0,0,0,0,0,0,0,0,1,1,2,31,30,61,63
20192020,089,MUHLENBERG,445,Muhlenberg County,115,Longest Elementary,445115,089445115,210008101080,WKEC,908,03,24,32,1,0,1,0,0,0,0,0,0,0,1,1,0,0,0,2,0,2,29,23,52,56
20192020,089,MUHLENBERG,445,Muhlenberg County,115,Longest Elementary,445115,089445115,210008101080,WKEC,908,05,37,26,0,0,0,0,0,0,0,1,1,1,1,2,0,0,0,1,1,2,24,34,58,63
20192020,089,MUHLENBERG,445,Muhlenberg County,150,Muhlenberg North Middle,445150,089445150,210008101081,WKEC,908,07,86,99,1,0,1,0,1,1,3,0,3,3,3,6,0,0,0,6,5,11,86,77,163,185
20192020,089,MUHLENBERG,445,Muhlenberg County,150,Muhlenberg North Middle,445150,089445150,210008101081,WKEC,908,All Students,265,303,3,4,7,0,1,1,6,2,8,8,10,18,0,0,0,16,11,27,270,237,507,568
20192020,089,MUHLENBERG,445,Muhlenberg County,150,Muhlenberg North Middle,445150,089445150,210008101081,WKEC,908,06,89,103,1,3,4,0,0,0,2,1,3,3,2,5,0,0,0,5,2,7,92,81,173,192
20192020,089,MUHLENBERG,445,Muhlenberg County,150,Muhlenberg North Middle,445150,089445150,210008101081,WKEC,908,08,90,101,1,1,2,0,0,0,1,1,2,2,5,7,0,0,0,5,4,9,92,79,171,191
20192020,089,MUHLENBERG,445,Muhlenberg County,175,Muhlenberg County High School,445175,089445175,210008102258,WKEC,908,12,137,140,2,2,4,0,0,0,0,0,0,4,5,9,2,0,2,2,2,4,130,128,258,277
20192020,089,MUHLENBERG,445,Muhlenberg County,175,Muhlenberg County High School,445175,089445175,210008102258,WKEC,908,All Students,593,619,19,16,35,0,0,0,2,2,4,19,19,38,3,0,3,14,10,24,562,546,1108,1212
20192020,089,MUHLENBERG,445,Muhlenberg County,175,Muhlenberg County High School,445175,089445175,210008102258,WKEC,908,09,168,178,5,4,9,0,0,0,1,1,2,4,5,9,1,0,1,8,2,10,159,156,315,346
20192020,089,MUHLENBERG,445,Muhlenberg County,175,Muhlenberg County High School,445175,089445175,210008102258,WKEC,908,10,155,170,7,5,12,0,0,0,1,0,1,6,7,13,0,0,0,3,4,7,153,139,292,325
20192020,089,MUHLENBERG,445,Muhlenberg County,175,Muhlenberg County High School,445175,089445175,210008102258,WKEC,908,11,133,130,5,5,10,0,0,0,0,1,1,5,2,7,0,0,0,1,2,3,119,123,242,263
20192020,089,MUHLENBERG,445,Muhlenberg County,175,Muhlenberg County High School,445175,089445175,210008102258,WKEC,908,14,0,1,0,0,0,0,0,0,0,0,0,0,0,0,0,0,0,0,0,0,1,0,1,1
20192020,089,MUHLENBERG,445,Muhlenberg County,902,Muhlenberg County Career & Tech Center,445902,089445902,210008102139,WKEC,908,11,0,0,0,0,0,0,0,0,0,0,0,0,0,0,0,0,0,0,0,0,0,0,0,0
20192020,089,MUHLENBERG,445,Muhlenberg County,902,Muhlenberg County Career & Tech Center,445902,089445902,210008102139,WKEC,908,All Students,0,0,0,0,0,0,0,0,0,0,0,0,0,0,0,0,0,0,0,0,0,0,0,0
20192020,089,MUHLENBERG,445,Muhlenberg County,902,Muhlenberg County Career & Tech Center,445902,089445902,210008102139,WKEC,908,09,0,0,0,0,0,0,0,0,0,0,0,0,0,0,0,0,0,0,0,0,0,0,0,0
20192020,089,MUHLENBERG,445,Muhlenberg County,902,Muhlenberg County Career & Tech Center,445902,089445902,210008102139,WKEC,908,10,0,0,0,0,0,0,0,0,0,0,0,0,0,0,0,0,0,0,0,0,0,0,0,0
20192020,089,MUHLENBERG,445,Muhlenberg County,902,Muhlenberg County Career & Tech Center,445902,089445902,210008102139,WKEC,908,12,0,0,0,0,0,0,0,0,0,0,0,0,0,0,0,0,0,0,0,0,0,0,0,0
20192020,018,CALLOWAY,446,Murray Independent,"",---District Total---,446,"","",WKEC,908,05,70,67,4,5,9,0,0,0,4,0,4,6,4,10,0,0,0,1,11,12,52,50,102,137
20192020,018,CALLOWAY,446,Murray Independent,"",---District Total---,446,"","",WKEC,908,All Students,785,813,58,53,111,0,3,3,24,29,53,59,48,107,0,1,1,55,52,107,617,599,1216,1598
20192020,018,CALLOWAY,446,Murray Independent,"",---District Total---,446,"","",WKEC,908,PS,63,67,10,6,16,0,0,0,1,2,3,7,6,13,0,0,0,6,6,12,43,43,86,130
20192020,018,CALLOWAY,446,Murray Independent,"",---District Total---,446,"","",WKEC,908,KG,72,70,4,4,8,0,1,1,2,0,2,6,6,12,0,0,0,3,5,8,55,56,111,142
20192020,018,CALLOWAY,446,Murray Independent,"",---District Total---,446,"","",WKEC,908,01,59,74,3,2,5,0,1,1,2,1,3,10,7,17,0,0,0,4,4,8,55,44,99,133
20192020,018,CALLOWAY,446,Murray Independent,"",---District Total---,446,"","",WKEC,908,02,50,51,0,6,6,0,0,0,0,2,2,10,3,13,0,0,0,3,2,5,38,37,75,101
20192020,018,CALLOWAY,446,Murray Independent,"",---District Total---,446,"","",WKEC,908,03,68,42,3,7,10,0,0,0,0,1,1,3,4,7,0,1,1,4,5,9,32,50,82,110
20192020,018,CALLOWAY,446,Murray Independent,"",---District Total---,446,"","",WKEC,908,04,70,72,8,7,15,0,0,0,3,4,7,2,4,6,0,0,0,5,4,9,54,51,105,142
20192020,018,CALLOWAY,446,Murray Independent,"",---District Total---,446,"","",WKEC,908,06,62,81,5,8,13,0,0,0,3,4,7,5,2,7,0,0,0,7,3,10,61,45,106,143
20192020,018,CALLOWAY,446,Murray Independent,"",---District Total---,446,"","",WKEC,908,07,69,66,5,1,6,0,0,0,2,3,5,2,3,5,0,0,0,4,5,9,53,57,110,135
20192020,018,CALLOWAY,446,Murray Independent,"",---District Total---,446,"","",WKEC,908,08,44,63,5,4,9,0,1,1,0,2,2,6,3,9,0,0,0,5,1,6,47,33,80,107
20192020,018,CALLOWAY,446,Murray Independent,"",---District Total---,446,"","",WKEC,908,09,65,52,2,3,5,0,0,0,1,3,4,1,3,4,0,0,0,6,6,12,42,50,92,117
20192020,018,CALLOWAY,446,Murray Independent,"",---District Total---,446,"","",WKEC,908,10,52,51,6,3,9,0,0,0,1,2,3,4,3,7,0,0,0,4,2,6,36,42,78,103
20192020,018,CALLOWAY,446,Murray Independent,"",---District Total---,446,"","",WKEC,908,11,61,58,6,0,6,0,0,0,1,3,4,2,5,7,0,0,0,6,4,10,43,49,92,119
20192020,018,CALLOWAY,446,Murray Independent,"",---District Total---,446,"","",WKEC,908,12,43,65,6,3,9,0,0,0,5,4,9,2,1,3,0,0,0,3,0,3,49,35,84,108
20192020,018,CALLOWAY,446,Murray Independent,"",---District Total---,446,"","",WKEC,908,14,0,1,1,0,1,0,0,0,0,0,0,0,0,0,0,0,0,0,0,0,0,0,0,1
20192020,018,CALLOWAY,446,Murray Independent,020,Murray Elementary School,446020,018446020,210438001084,WKEC,908,03,68,42,3,7,10,0,0,0,0,1,1,3,4,7,0,1,1,4,5,9,32,50,82,110
20192020,018,CALLOWAY,446,Murray Independent,020,Murray Elementary School,446020,018446020,210438001084,WKEC,908,All Students,249,237,10,19,29,0,2,2,4,4,8,29,20,49,0,1,1,14,16,30,180,187,367,486
20192020,018,CALLOWAY,446,Murray Independent,020,Murray Elementary School,446020,018446020,210438001084,WKEC,908,PS,11,12,1,1,2,0,0,0,1,0,1,1,1,2,0,0,0,0,1,1,9,8,17,23
20192020,018,CALLOWAY,446,Murray Independent,020,Murray Elementary School,446020,018446020,210438001084,WKEC,908,KG,72,70,4,4,8,0,1,1,2,0,2,6,6,12,0,0,0,3,5,8,55,56,111,142
20192020,018,CALLOWAY,446,Murray Independent,020,Murray Elementary School,446020,018446020,210438001084,WKEC,908,01,59,74,3,2,5,0,1,1,2,1,3,10,7,17,0,0,0,4,4,8,55,44,99,133
20192020,018,CALLOWAY,446,Murray Independent,020,Murray Elementary School,446020,018446020,210438001084,WKEC,908,02,50,51,0,6,6,0,0,0,0,2,2,10,3,13,0,0,0,3,2,5,38,37,75,101
20192020,018,CALLOWAY,446,Murray Independent,030,Murray Middle School,446030,018446030,210438001085,WKEC,908,07,69,66,5,1,6,0,0,0,2,3,5,2,3,5,0,0,0,4,5,9,53,57,110,135
20192020,018,CALLOWAY,446,Murray Independent,030,Murray Middle School,446030,018446030,210438001085,WKEC,908,All Students,315,349,27,25,52,0,1,1,12,13,25,21,16,37,0,0,0,22,24,46,267,236,503,664
20192020,018,CALLOWAY,446,Murray Independent,030,Murray Middle School,446030,018446030,210438001085,WKEC,908,04,70,72,8,7,15,0,0,0,3,4,7,2,4,6,0,0,0,5,4,9,54,51,105,142
20192020,018,CALLOWAY,446,Murray Independent,030,Murray Middle School,446030,018446030,210438001085,WKEC,908,05,70,67,4,5,9,0,0,0,4,0,4,6,4,10,0,0,0,1,11,12,52,50,102,137
20192020,018,CALLOWAY,446,Murray Independent,030,Murray Middle School,446030,018446030,210438001085,WKEC,908,06,62,81,5,8,13,0,0,0,3,4,7,5,2,7,0,0,0,7,3,10,61,45,106,143
20192020,018,CALLOWAY,446,Murray Independent,030,Murray Middle School,446030,018446030,210438001085,WKEC,908,08,44,63,5,4,9,0,1,1,0,2,2,6,3,9,0,0,0,5,1,6,47,33,80,107
20192020,018,CALLOWAY,446,Murray Independent,050,Murray High School,446050,018446050,210438001086,WKEC,908,12,43,65,6,3,9,0,0,0,5,4,9,2,1,3,0,0,0,3,0,3,49,35,84,108
20192020,018,CALLOWAY,446,Murray Independent,050,Murray High School,446050,018446050,210438001086,WKEC,908,All Students,221,227,21,9,30,0,0,0,8,12,20,9,12,21,0,0,0,19,12,31,170,176,346,448
20192020,018,CALLOWAY,446,Murray Independent,050,Murray High School,446050,018446050,210438001086,WKEC,908,09,65,52,2,3,5,0,0,0,1,3,4,1,3,4,0,0,0,6,6,12,42,50,92,117
20192020,018,CALLOWAY,446,Murray Independent,050,Murray High School,446050,018446050,210438001086,WKEC,908,10,52,51,6,3,9,0,0,0,1,2,3,4,3,7,0,0,0,4,2,6,36,42,78,103
20192020,018,CALLOWAY,446,Murray Independent,050,Murray High School,446050,018446050,210438001086,WKEC,908,11,61,58,6,0,6,0,0,0,1,3,4,2,5,7,0,0,0,6,4,10,43,49,92,119
20192020,018,CALLOWAY,446,Murray Independent,050,Murray High School,446050,018446050,210438001086,WKEC,908,14,0,1,1,0,1,0,0,0,0,0,0,0,0,0,0,0,0,0,0,0,0,0,0,1
20192020,018,CALLOWAY,446,Murray Independent,075,Murray Preschool Head Start,446075,018446075,210438000933,WKEC,908,All Students,0,0,0,0,0,0,0,0,0,0,0,0,0,0,0,0,0,0,0,0,0,0,0,0
20192020,018,CALLOWAY,446,Murray Independent,075,Murray Preschool Head Start,446075,018446075,210438000933,WKEC,908,PS,52,55,9,5,14,0,0,0,0,2,2,6,5,11,0,0,0,6,5,11,34,35,69,107
20192020,090,NELSON,451,Nelson County,"",---District Total---,451,"","",CKEC,901,11,196,174,4,4,8,0,0,0,0,5,5,6,9,15,1,0,1,6,1,7,157,177,334,370
20192020,090,NELSON,451,Nelson County,"",---District Total---,451,"","",CKEC,901,All Students,2025,2370,30,24,54,3,3,6,5,19,24,73,62,135,1,0,1,53,44,97,2205,1873,4078,4395
20192020,090,NELSON,451,Nelson County,"",---District Total---,451,"","",CKEC,901,PS,119,175,2,3,5,2,1,3,1,0,1,8,4,12,0,0,0,7,10,17,155,101,256,294
20192020,090,NELSON,451,Nelson County,"",---District Total---,451,"","",CKEC,901,KG,129,171,1,2,3,0,0,0,0,1,1,6,5,11,0,0,0,7,4,11,157,117,274,300
20192020,090,NELSON,451,Nelson County,"",---District Total---,451,"","",CKEC,901,01,159,175,3,0,3,0,0,0,2,2,4,8,1,9,0,0,0,5,3,8,157,153,310,334
20192020,090,NELSON,451,Nelson County,"",---District Total---,451,"","",CKEC,901,02,130,165,1,1,2,1,0,1,0,0,0,5,1,6,0,0,0,7,3,10,151,125,276,295
20192020,090,NELSON,451,Nelson County,"",---District Total---,451,"","",CKEC,901,03,152,184,0,1,1,0,0,0,1,1,2,2,9,11,0,0,0,5,5,10,176,136,312,336
20192020,090,NELSON,451,Nelson County,"",---District Total---,451,"","",CKEC,901,04,153,169,2,1,3,0,1,1,0,0,0,6,3,9,0,0,0,7,3,10,154,145,299,322
20192020,090,NELSON,451,Nelson County,"",---District Total---,451,"","",CKEC,901,14,1,1,0,0,0,0,0,0,0,0,0,0,0,0,0,0,0,0,0,0,1,1,2,2
20192020,090,NELSON,451,Nelson County,"",---District Total---,451,"","",CKEC,901,05,141,170,1,1,2,0,0,0,0,1,1,6,7,13,0,0,0,3,4,7,160,128,288,311
20192020,090,NELSON,451,Nelson County,"",---District Total---,451,"","",CKEC,901,06,155,198,2,2,4,1,1,2,0,0,0,9,6,15,0,0,0,1,4,5,185,142,327,353
20192020,090,NELSON,451,Nelson County,"",---District Total---,451,"","",CKEC,901,07,162,186,6,1,7,0,0,0,0,2,2,8,3,11,0,0,0,5,5,10,167,151,318,348
20192020,090,NELSON,451,Nelson County,"",---District Total---,451,"","",CKEC,901,08,139,167,0,2,2,0,0,0,1,2,3,1,5,6,0,0,0,3,4,7,162,126,288,306
20192020,090,NELSON,451,Nelson County,"",---District Total---,451,"","",CKEC,901,09,163,235,3,3,6,0,0,0,0,2,2,8,3,11,0,0,0,2,2,4,222,153,375,398
20192020,090,NELSON,451,Nelson County,"",---District Total---,451,"","",CKEC,901,10,168,182,3,1,4,1,0,1,1,0,1,2,5,7,0,0,0,1,2,3,174,160,334,350
20192020,090,NELSON,451,Nelson County,"",---District Total---,451,"","",CKEC,901,12,177,193,4,5,9,0,1,1,0,3,3,6,5,11,0,0,0,1,4,5,182,159,341,370
20192020,090,NELSON,451,Nelson County,010,Bloomfield Middle School,451010,090451010,210441001087,CKEC,901,07,61,87,3,0,3,0,0,0,0,1,1,3,0,3,0,0,0,3,3,6,78,57,135,148
20192020,090,NELSON,451,Nelson County,010,Bloomfield Middle School,451010,090451010,210441001087,CKEC,901,All Students,164,242,5,0,5,0,0,0,1,1,2,7,4,11,0,0,0,5,4,9,224,155,379,406
20192020,090,NELSON,451,Nelson County,010,Bloomfield Middle School,451010,090451010,210441001087,CKEC,901,06,47,81,2,0,2,0,0,0,0,0,0,4,2,6,0,0,0,0,1,1,75,44,119,128
20192020,090,NELSON,451,Nelson County,010,Bloomfield Middle School,451010,090451010,210441001087,CKEC,901,08,56,74,0,0,0,0,0,0,1,0,1,0,2,2,0,0,0,2,0,2,71,54,125,130
20192020,090,NELSON,451,Nelson County,011,The New Haven School,451011,090451011,210441001937,CKEC,901,08,13,20,0,0,0,0,0,0,0,0,0,0,0,0,0,0,0,0,0,0,20,13,33,33
20192020,090,NELSON,451,Nelson County,011,The New Haven School,451011,090451011,210441001937,CKEC,901,All Students,139,214,1,1,2,0,0,0,0,0,0,0,4,4,0,0,0,0,1,1,213,133,346,353
20192020,090,NELSON,451,Nelson County,011,The New Haven School,451011,090451011,210441001937,CKEC,901,KG,18,19,0,0,0,0,0,0,0,0,0,0,0,0,0,0,0,0,0,0,19,18,37,37
20192020,090,NELSON,451,Nelson County,011,The New Haven School,451011,090451011,210441001937,CKEC,901,01,17,24,0,0,0,0,0,0,0,0,0,0,0,0,0,0,0,0,0,0,24,17,41,41
20192020,090,NELSON,451,Nelson County,011,The New Haven School,451011,090451011,210441001937,CKEC,901,02,8,21,0,0,0,0,0,0,0,0,0,0,0,0,0,0,0,0,0,0,21,8,29,29
20192020,090,NELSON,451,Nelson County,011,The New Haven School,451011,090451011,210441001937,CKEC,901,03,17,27,0,0,0,0,0,0,0,0,0,0,1,1,0,0,0,0,0,0,27,16,43,44
20192020,090,NELSON,451,Nelson County,011,The New Haven School,451011,090451011,210441001937,CKEC,901,04,15,28,1,0,1,0,0,0,0,0,0,0,1,1,0,0,0,0,0,0,27,14,41,43
20192020,090,NELSON,451,Nelson County,011,The New Haven School,451011,090451011,210441001937,CKEC,901,05,16,28,0,0,0,0,0,0,0,0,0,0,0,0,0,0,0,0,0,0,28,16,44,44
20192020,090,NELSON,451,Nelson County,011,The New Haven School,451011,090451011,210441001937,CKEC,901,06,20,26,0,1,1,0,0,0,0,0,0,0,1,1,0,0,0,0,1,1,26,17,43,46
20192020,090,NELSON,451,Nelson County,011,The New Haven School,451011,090451011,210441001937,CKEC,901,07,15,21,0,0,0,0,0,0,0,0,0,0,1,1,0,0,0,0,0,0,21,14,35,36
20192020,090,NELSON,451,Nelson County,013,Bloomfield Elementary School,451013,090451013,210441002006,CKEC,901,04,24,39,1,0,1,0,0,0,0,0,0,2,0,2,0,0,0,1,1,2,35,23,58,63
20192020,090,NELSON,451,Nelson County,013,Bloomfield Elementary School,451013,090451013,210441002006,CKEC,901,All Students,133,175,2,1,3,0,0,0,1,1,2,8,4,12,0,0,0,5,3,8,159,124,283,308
20192020,090,NELSON,451,Nelson County,013,Bloomfield Elementary School,451013,090451013,210441002006,CKEC,901,KG,20,27,0,0,0,0,0,0,0,1,1,1,2,3,0,0,0,1,1,2,25,16,41,47
20192020,090,NELSON,451,Nelson County,013,Bloomfield Elementary School,451013,090451013,210441002006,CKEC,901,01,22,28,1,0,1,0,0,0,0,0,0,0,0,0,0,0,0,1,0,1,26,22,48,50
20192020,090,NELSON,451,Nelson County,013,Bloomfield Elementary School,451013,090451013,210441002006,CKEC,901,02,22,27,0,0,0,0,0,0,0,0,0,2,0,2,0,0,0,0,0,0,25,22,47,49
20192020,090,NELSON,451,Nelson County,013,Bloomfield Elementary School,451013,090451013,210441002006,CKEC,901,03,24,23,0,0,0,0,0,0,1,0,1,0,0,0,0,0,0,2,0,2,20,24,44,47
20192020,090,NELSON,451,Nelson County,013,Bloomfield Elementary School,451013,090451013,210441002006,CKEC,901,05,21,31,0,1,1,0,0,0,0,0,0,3,2,5,0,0,0,0,1,1,28,17,45,52
20192020,090,NELSON,451,Nelson County,019,The Academy at Horizons,451019,090451019,210441002212,CKEC,901,06,3,4,0,0,0,0,0,0,0,0,0,1,0,1,0,0,0,0,0,0,3,3,6,7
20192020,090,NELSON,451,Nelson County,019,The Academy at Horizons,451019,090451019,210441002212,CKEC,901,All Students,35,82,2,1,3,0,0,0,0,0,0,5,1,6,0,0,0,2,0,2,73,33,106,117
20192020,090,NELSON,451,Nelson County,019,The Academy at Horizons,451019,090451019,210441002212,CKEC,901,KG,0,1,0,0,0,0,0,0,0,0,0,0,0,0,0,0,0,0,0,0,1,0,1,1
20192020,090,NELSON,451,Nelson County,019,The Academy at Horizons,451019,090451019,210441002212,CKEC,901,01,1,2,0,0,0,0,0,0,0,0,0,0,1,1,0,0,0,1,0,1,1,0,1,3
20192020,090,NELSON,451,Nelson County,019,The Academy at Horizons,451019,090451019,210441002212,CKEC,901,02,0,3,0,0,0,0,0,0,0,0,0,0,0,0,0,0,0,0,0,0,3,0,3,3
20192020,090,NELSON,451,Nelson County,019,The Academy at Horizons,451019,090451019,210441002212,CKEC,901,03,0,2,0,0,0,0,0,0,0,0,0,0,0,0,0,0,0,0,0,0,2,0,2,2
20192020,090,NELSON,451,Nelson County,019,The Academy at Horizons,451019,090451019,210441002212,CKEC,901,04,0,2,0,0,0,0,0,0,0,0,0,0,0,0,0,0,0,0,0,0,2,0,2,2
20192020,090,NELSON,451,Nelson County,019,The Academy at Horizons,451019,090451019,210441002212,CKEC,901,05,0,2,0,0,0,0,0,0,0,0,0,1,0,1,0,0,0,0,0,0,1,0,1,2
20192020,090,NELSON,451,Nelson County,019,The Academy at Horizons,451019,090451019,210441002212,CKEC,901,07,3,7,0,0,0,0,0,0,0,0,0,1,0,1,0,0,0,0,0,0,6,3,9,10
20192020,090,NELSON,451,Nelson County,019,The Academy at Horizons,451019,090451019,210441002212,CKEC,901,08,0,3,0,0,0,0,0,0,0,0,0,0,0,0,0,0,0,0,0,0,3,0,3,3
20192020,090,NELSON,451,Nelson County,019,The Academy at Horizons,451019,090451019,210441002212,CKEC,901,09,4,11,0,0,0,0,0,0,0,0,0,0,0,0,0,0,0,0,0,0,11,4,15,15
20192020,090,NELSON,451,Nelson County,019,The Academy at Horizons,451019,090451019,210441002212,CKEC,901,10,9,9,1,0,1,0,0,0,0,0,0,0,0,0,0,0,0,0,0,0,8,9,17,18
20192020,090,NELSON,451,Nelson County,019,The Academy at Horizons,451019,090451019,210441002212,CKEC,901,11,4,12,1,1,2,0,0,0,0,0,0,1,0,1,0,0,0,1,0,1,9,3,12,16
20192020,090,NELSON,451,Nelson County,019,The Academy at Horizons,451019,090451019,210441002212,CKEC,901,12,11,24,0,0,0,0,0,0,0,0,0,1,0,1,0,0,0,0,0,0,23,11,34,35
20192020,090,NELSON,451,Nelson County,030,Boston School,451030,090451030,210441001089,CKEC,901,07,22,15,2,0,2,0,0,0,0,0,0,1,1,2,0,0,0,0,0,0,12,21,33,37
20192020,090,NELSON,451,Nelson County,030,Boston School,451030,090451030,210441001089,CKEC,901,All Students,191,165,2,1,3,1,0,1,0,0,0,5,3,8,0,0,0,1,3,4,156,184,340,356
20192020,090,NELSON,451,Nelson County,030,Boston School,451030,090451030,210441001089,CKEC,901,KG,17,24,0,0,0,0,0,0,0,0,0,1,0,1,0,0,0,0,0,0,23,17,40,41
20192020,090,NELSON,451,Nelson County,030,Boston School,451030,090451030,210441001089,CKEC,901,01,23,20,0,0,0,0,0,0,0,0,0,1,0,1,0,0,0,0,0,0,19,23,42,43
20192020,090,NELSON,451,Nelson County,030,Boston School,451030,090451030,210441001089,CKEC,901,08,16,14,0,0,0,0,0,0,0,0,0,1,0,1,0,0,0,0,0,0,13,16,29,30
20192020,090,NELSON,451,Nelson County,030,Boston School,451030,090451030,210441001089,CKEC,901,02,18,20,0,0,0,0,0,0,0,0,0,0,0,0,0,0,0,0,0,0,20,18,38,38
20192020,090,NELSON,451,Nelson County,030,Boston School,451030,090451030,210441001089,CKEC,901,03,23,20,0,0,0,0,0,0,0,0,0,0,0,0,0,0,0,0,1,1,20,22,42,43
20192020,090,NELSON,451,Nelson County,030,Boston School,451030,090451030,210441001089,CKEC,901,04,28,13,0,1,1,0,0,0,0,0,0,0,0,0,0,0,0,1,0,1,12,27,39,41
20192020,090,NELSON,451,Nelson County,030,Boston School,451030,090451030,210441001089,CKEC,901,05,20,17,0,0,0,0,0,0,0,0,0,0,1,1,0,0,0,0,1,1,17,18,35,37
20192020,090,NELSON,451,Nelson County,030,Boston School,451030,090451030,210441001089,CKEC,901,06,24,22,0,0,0,1,0,1,0,0,0,1,1,2,0,0,0,0,1,1,20,22,42,46
20192020,090,NELSON,451,Nelson County,050,Coxs Creek Elementary School,451050,090451050,210441001091,CKEC,901,01,37,41,0,0,0,0,0,0,0,1,1,2,0,2,0,0,0,1,0,1,38,36,74,78
20192020,090,NELSON,451,Nelson County,050,Coxs Creek Elementary School,451050,090451050,210441001091,CKEC,901,All Students,205,240,0,0,0,0,0,0,0,1,1,13,3,16,0,0,0,8,5,13,219,196,415,445
20192020,090,NELSON,451,Nelson County,050,Coxs Creek Elementary School,451050,090451050,210441001091,CKEC,901,KG,23,39,0,0,0,0,0,0,0,0,0,4,1,5,0,0,0,1,1,2,34,21,55,62
20192020,090,NELSON,451,Nelson County,050,Coxs Creek Elementary School,451050,090451050,210441001091,CKEC,901,02,36,36,0,0,0,0,0,0,0,0,0,2,0,2,0,0,0,4,2,6,30,34,64,72
20192020,090,NELSON,451,Nelson County,050,Coxs Creek Elementary School,451050,090451050,210441001091,CKEC,901,03,35,51,0,0,0,0,0,0,0,0,0,2,0,2,0,0,0,0,2,2,49,33,82,86
20192020,090,NELSON,451,Nelson County,050,Coxs Creek Elementary School,451050,090451050,210441001091,CKEC,901,04,39,33,0,0,0,0,0,0,0,0,0,1,1,2,0,0,0,1,0,1,31,38,69,72
20192020,090,NELSON,451,Nelson County,050,Coxs Creek Elementary School,451050,090451050,210441001091,CKEC,901,05,35,40,0,0,0,0,0,0,0,0,0,2,1,3,0,0,0,1,0,1,37,34,71,75
20192020,090,NELSON,451,Nelson County,070,Foster Heights Elementary School,451070,090451070,210441001093,CKEC,901,05,49,52,1,0,1,0,0,0,0,1,1,0,3,3,0,0,0,2,2,4,49,43,92,101
20192020,090,NELSON,451,Nelson County,070,Foster Heights Elementary School,451070,090451070,210441001093,CKEC,901,All Students,305,346,5,4,9,1,1,2,2,3,5,9,15,24,0,0,0,19,12,31,310,270,580,651
20192020,090,NELSON,451,Nelson County,070,Foster Heights Elementary School,451070,090451070,210441001093,CKEC,901,KG,51,61,1,2,3,0,0,0,0,0,0,0,2,2,0,0,0,5,2,7,55,45,100,112
20192020,090,NELSON,451,Nelson County,070,Foster Heights Elementary School,451070,090451070,210441001093,CKEC,901,01,59,60,2,0,2,0,0,0,2,1,3,5,0,5,0,0,0,2,3,5,49,55,104,119
20192020,090,NELSON,451,Nelson County,070,Foster Heights Elementary School,451070,090451070,210441001093,CKEC,901,02,46,58,1,1,2,1,0,1,0,0,0,1,1,2,0,0,0,3,1,4,52,43,95,104
20192020,090,NELSON,451,Nelson County,070,Foster Heights Elementary School,451070,090451070,210441001093,CKEC,901,03,53,61,0,1,1,0,0,0,0,1,1,0,8,8,0,0,0,3,2,5,58,41,99,114
20192020,090,NELSON,451,Nelson County,070,Foster Heights Elementary School,451070,090451070,210441001093,CKEC,901,04,47,54,0,0,0,0,1,1,0,0,0,3,1,4,0,0,0,4,2,6,47,43,90,101
20192020,090,NELSON,451,Nelson County,071,Nelson County Early Learning Center,451071,090451071,210441002261,CKEC,901,All Students,0,0,0,0,0,0,0,0,0,0,0,0,0,0,0,0,0,0,0,0,0,0,0,0
20192020,090,NELSON,451,Nelson County,071,Nelson County Early Learning Center,451071,090451071,210441002261,CKEC,901,PS,119,175,2,3,5,2,1,3,1,0,1,8,4,12,0,0,0,7,10,17,155,101,256,294
20192020,090,NELSON,451,Nelson County,090,Old Kentucky Home Middle School,451090,090451090,210441001095,CKEC,901,07,61,56,1,1,2,0,0,0,0,1,1,3,1,4,0,0,0,2,2,4,50,56,106,117
20192020,090,NELSON,451,Nelson County,090,Old Kentucky Home Middle School,451090,090451090,210441001095,CKEC,901,All Students,175,177,1,4,5,0,1,1,0,3,3,6,6,12,0,0,0,4,7,11,166,154,320,352
20192020,090,NELSON,451,Nelson County,090,Old Kentucky Home Middle School,451090,090451090,210441001095,CKEC,901,06,61,65,0,1,1,0,1,1,0,0,0,3,2,5,0,0,0,1,1,2,61,56,117,126
20192020,090,NELSON,451,Nelson County,090,Old Kentucky Home Middle School,451090,090451090,210441001095,CKEC,901,08,53,56,0,2,2,0,0,0,0,2,2,0,3,3,0,0,0,1,4,5,55,42,97,109
20192020,090,NELSON,451,Nelson County,100,Nelson County High School,451100,090451100,210441001096,CKEC,901,08,1,0,0,0,0,0,0,0,0,0,0,0,0,0,0,0,0,0,0,0,0,1,1,1
20192020,090,NELSON,451,Nelson County,100,Nelson County High School,451100,090451100,210441001096,CKEC,901,All Students,366,389,7,9,16,1,1,2,0,5,5,13,16,29,0,0,0,5,7,12,363,328,691,755
20192020,090,NELSON,451,Nelson County,100,Nelson County High School,451100,090451100,210441001096,CKEC,901,09,75,123,1,2,3,0,0,0,0,1,1,3,2,5,0,0,0,2,1,3,117,69,186,198
20192020,090,NELSON,451,Nelson County,100,Nelson County High School,451100,090451100,210441001096,CKEC,901,10,86,87,1,1,2,1,0,1,0,0,0,1,3,4,0,0,0,0,1,1,84,81,165,173
20192020,090,NELSON,451,Nelson County,100,Nelson County High School,451100,090451100,210441001096,CKEC,901,11,104,84,1,2,3,0,0,0,0,3,3,5,7,12,0,0,0,2,1,3,76,91,167,188
20192020,090,NELSON,451,Nelson County,100,Nelson County High School,451100,090451100,210441001096,CKEC,901,12,99,94,4,4,8,0,1,1,0,1,1,4,4,8,0,0,0,1,4,5,85,85,170,193
20192020,090,NELSON,451,Nelson County,100,Nelson County High School,451100,090451100,210441001096,CKEC,901,14,1,1,0,0,0,0,0,0,0,0,0,0,0,0,0,0,0,0,0,0,1,1,2,2
20192020,090,NELSON,451,Nelson County,101,Thomas Nelson High School,451101,090451101,210441002324,CKEC,901,All Students,312,340,5,3,8,0,0,0,1,5,6,7,6,13,1,0,1,4,2,6,322,296,618,652
20192020,090,NELSON,451,Nelson County,101,Thomas Nelson High School,451101,090451101,210441002324,CKEC,901,09,84,101,2,1,3,0,0,0,0,1,1,5,1,6,0,0,0,0,1,1,94,80,174,185
20192020,090,NELSON,451,Nelson County,101,Thomas Nelson High School,451101,090451101,210441002324,CKEC,901,10,73,86,1,0,1,0,0,0,1,0,1,1,2,3,0,0,0,1,1,2,82,70,152,159
20192020,090,NELSON,451,Nelson County,101,Thomas Nelson High School,451101,090451101,210441002324,CKEC,901,11,88,78,2,1,3,0,0,0,0,2,2,0,2,2,1,0,1,3,0,3,72,83,155,166
20192020,090,NELSON,451,Nelson County,101,Thomas Nelson High School,451101,090451101,210441002324,CKEC,901,12,67,75,0,1,1,0,0,0,0,2,2,1,1,2,0,0,0,0,0,0,74,63,137,142
20192020,019,CAMPBELL,452,Newport Independent,"",---District Total---,452,"","",NKCES,905,02,51,48,6,14,20,0,0,0,0,0,0,7,8,15,0,0,0,9,9,18,26,20,46,99
20192020,019,CAMPBELL,452,Newport Independent,"",---District Total---,452,"","",NKCES,905,03,57,54,5,10,15,0,1,1,0,0,0,7,8,15,0,0,0,10,7,17,32,31,63,111
20192020,019,CAMPBELL,452,Newport Independent,"",---District Total---,452,"","",NKCES,905,04,56,63,12,12,24,0,0,0,0,0,0,12,13,25,0,0,0,11,6,17,28,25,53,119
20192020,019,CAMPBELL,452,Newport Independent,"",---District Total---,452,"","",NKCES,905,05,57,54,11,13,24,0,0,0,0,0,0,8,8,16,0,0,0,10,7,17,25,29,54,111
20192020,019,CAMPBELL,452,Newport Independent,"",---District Total---,452,"","",NKCES,905,06,58,50,13,9,22,0,0,0,0,0,0,7,7,14,0,0,0,9,10,19,21,32,53,108
20192020,019,CAMPBELL,452,Newport Independent,"",---District Total---,452,"","",NKCES,905,07,59,39,10,13,23,0,0,0,0,0,0,7,10,17,0,0,0,3,5,8,19,31,50,98
20192020,019,CAMPBELL,452,Newport Independent,"",---District Total---,452,"","",NKCES,905,14,1,1,0,0,0,0,0,0,0,0,0,0,0,0,0,0,0,0,0,0,1,1,2,2
20192020,019,CAMPBELL,452,Newport Independent,"",---District Total---,452,"","",NKCES,905,08,43,45,10,6,16,0,0,0,0,0,0,6,5,11,0,0,0,9,5,14,20,27,47,88
20192020,019,CAMPBELL,452,Newport Independent,"",---District Total---,452,"","",NKCES,905,12,51,53,9,9,18,0,0,0,0,0,0,2,4,6,0,0,0,10,5,15,32,33,65,104
20192020,019,CAMPBELL,452,Newport Independent,"",---District Total---,452,"","",NKCES,905,09,45,54,11,5,16,0,0,0,0,0,0,12,12,24,0,0,0,6,10,16,25,18,43,99
20192020,019,CAMPBELL,452,Newport Independent,"",---District Total---,452,"","",NKCES,905,11,43,50,7,6,13,0,0,0,0,0,0,8,6,14,0,0,0,5,3,8,30,28,58,93
20192020,019,CAMPBELL,452,Newport Independent,"",---District Total---,452,"","",NKCES,905,10,43,50,10,9,19,0,0,0,0,0,0,5,4,9,0,0,0,8,8,16,27,22,49,93
20192020,019,CAMPBELL,452,Newport Independent,"",---District Total---,452,"","",NKCES,905,All Students,679,680,122,130,252,0,1,1,0,2,2,100,102,202,0,0,0,104,90,194,354,354,708,1359
20192020,019,CAMPBELL,452,Newport Independent,"",---District Total---,452,"","",NKCES,905,PS,34,36,5,7,12,1,0,1,0,0,0,5,6,11,0,0,0,4,4,8,21,17,38,70
20192020,019,CAMPBELL,452,Newport Independent,"",---District Total---,452,"","",NKCES,905,KG,57,59,10,10,20,0,0,0,0,2,2,8,10,18,0,0,0,4,11,15,37,24,61,116
20192020,019,CAMPBELL,452,Newport Independent,"",---District Total---,452,"","",NKCES,905,01,58,60,8,14,22,0,0,0,0,0,0,11,7,18,0,0,0,10,4,14,31,33,64,118
20192020,019,CAMPBELL,452,Newport Independent,018,Newport Regional School,452018,019452018,210444002401,NKCES,905,12,1,1,0,0,0,0,0,0,0,0,0,0,0,0,0,0,0,1,0,1,0,1,1,2
20192020,019,CAMPBELL,452,Newport Independent,018,Newport Regional School,452018,019452018,210444002401,NKCES,905,All Students,3,6,2,1,3,0,0,0,0,0,0,0,0,0,0,0,0,2,0,2,2,2,4,9
20192020,019,CAMPBELL,452,Newport Independent,018,Newport Regional School,452018,019452018,210444002401,NKCES,905,08,1,0,0,0,0,0,0,0,0,0,0,0,0,0,0,0,0,0,0,0,0,1,1,1
20192020,019,CAMPBELL,452,Newport Independent,018,Newport Regional School,452018,019452018,210444002401,NKCES,905,09,1,1,0,1,1,0,0,0,0,0,0,0,0,0,0,0,0,0,0,0,1,0,1,2
20192020,019,CAMPBELL,452,Newport Independent,018,Newport Regional School,452018,019452018,210444002401,NKCES,905,10,0,2,1,0,1,0,0,0,0,0,0,0,0,0,0,0,0,1,0,1,0,0,0,2
20192020,019,CAMPBELL,452,Newport Independent,018,Newport Regional School,452018,019452018,210444002401,NKCES,905,11,0,2,1,0,1,0,0,0,0,0,0,0,0,0,0,0,0,0,0,0,1,0,1,2
20192020,019,CAMPBELL,452,Newport Independent,020,Newport Primary School,452020,019452020,210444001099,NKCES,905,KG,57,59,10,10,20,0,0,0,0,2,2,8,10,18,0,0,0,4,11,15,37,24,61,116
20192020,019,CAMPBELL,452,Newport Independent,020,Newport Primary School,452020,019452020,210444001099,NKCES,905,01,58,60,8,14,22,0,0,0,0,0,0,11,7,18,0,0,0,10,4,14,31,33,64,118
20192020,019,CAMPBELL,452,Newport Independent,020,Newport Primary School,452020,019452020,210444001099,NKCES,905,02,51,48,6,14,20,0,0,0,0,0,0,7,8,15,0,0,0,9,9,18,26,20,46,99
20192020,019,CAMPBELL,452,Newport Independent,020,Newport Primary School,452020,019452020,210444001099,NKCES,905,All Students,166,167,24,38,62,0,0,0,0,2,2,26,25,51,0,0,0,23,24,47,94,77,171,333
20192020,019,CAMPBELL,452,Newport Independent,020,Newport Primary School,452020,019452020,210444001099,NKCES,905,PS,34,36,5,7,12,1,0,1,0,0,0,5,6,11,0,0,0,4,4,8,21,17,38,70
20192020,019,CAMPBELL,452,Newport Independent,030,Newport School of Innovation,452030,019452030,210444002493,NKCES,905,09,1,4,0,0,0,0,0,0,0,0,0,1,0,1,0,0,0,0,0,0,3,1,4,5
20192020,019,CAMPBELL,452,Newport Independent,030,Newport School of Innovation,452030,019452030,210444002493,NKCES,905,10,6,2,1,0,1,0,0,0,0,0,0,0,0,0,0,0,0,0,1,1,1,5,6,8
20192020,019,CAMPBELL,452,Newport Independent,030,Newport School of Innovation,452030,019452030,210444002493,NKCES,905,12,13,6,1,0,1,0,0,0,0,0,0,0,1,1,0,0,0,0,1,1,5,11,16,19
20192020,019,CAMPBELL,452,Newport Independent,030,Newport School of Innovation,452030,019452030,210444002493,NKCES,905,11,7,9,2,0,2,0,0,0,0,0,0,1,0,1,0,0,0,0,2,2,6,5,11,16
20192020,019,CAMPBELL,452,Newport Independent,030,Newport School of Innovation,452030,019452030,210444002493,NKCES,905,All Students,35,26,4,0,4,0,0,0,0,0,0,2,1,3,0,0,0,1,5,6,19,29,48,61
20192020,019,CAMPBELL,452,Newport Independent,030,Newport School of Innovation,452030,019452030,210444002493,NKCES,905,06,2,0,0,0,0,0,0,0,0,0,0,0,0,0,0,0,0,0,1,1,0,1,1,2
20192020,019,CAMPBELL,452,Newport Independent,030,Newport School of Innovation,452030,019452030,210444002493,NKCES,905,07,4,2,0,0,0,0,0,0,0,0,0,0,0,0,0,0,0,0,0,0,2,4,6,6
20192020,019,CAMPBELL,452,Newport Independent,030,Newport School of Innovation,452030,019452030,210444002493,NKCES,905,08,2,3,0,0,0,0,0,0,0,0,0,0,0,0,0,0,0,1,0,1,2,2,4,5
20192020,019,CAMPBELL,452,Newport Independent,040,Newport Intermediate School,452040,019452040,210444001100,NKCES,905,05,57,54,11,13,24,0,0,0,0,0,0,8,8,16,0,0,0,10,7,17,25,29,54,111
20192020,019,CAMPBELL,452,Newport Independent,040,Newport Intermediate School,452040,019452040,210444001100,NKCES,905,All Students,226,221,41,44,85,0,1,1,0,0,0,34,36,70,0,0,0,40,29,69,106,116,222,447
20192020,019,CAMPBELL,452,Newport Independent,040,Newport Intermediate School,452040,019452040,210444001100,NKCES,905,03,57,54,5,10,15,0,1,1,0,0,0,7,8,15,0,0,0,10,7,17,32,31,63,111
20192020,019,CAMPBELL,452,Newport Independent,040,Newport Intermediate School,452040,019452040,210444001100,NKCES,905,04,56,63,12,12,24,0,0,0,0,0,0,12,13,25,0,0,0,11,6,17,28,25,53,119
20192020,019,CAMPBELL,452,Newport Independent,040,Newport Intermediate School,452040,019452040,210444001100,NKCES,905,06,56,50,13,9,22,0,0,0,0,0,0,7,7,14,0,0,0,9,9,18,21,31,52,106
20192020,019,CAMPBELL,452,Newport Independent,070,Newport High School,452070,019452070,210444001103,NKCES,905,12,37,46,8,9,17,0,0,0,0,0,0,2,3,5,0,0,0,9,4,13,27,21,48,83
20192020,019,CAMPBELL,452,Newport Independent,070,Newport High School,452070,019452070,210444001103,NKCES,905,All Students,249,260,51,47,98,0,0,0,0,0,0,38,40,78,0,0,0,38,32,70,133,130,263,509
20192020,019,CAMPBELL,452,Newport Independent,070,Newport High School,452070,019452070,210444001103,NKCES,905,07,55,37,10,13,23,0,0,0,0,0,0,7,10,17,0,0,0,3,5,8,17,27,44,92
20192020,019,CAMPBELL,452,Newport Independent,070,Newport High School,452070,019452070,210444001103,NKCES,905,08,40,42,10,6,16,0,0,0,0,0,0,6,5,11,0,0,0,8,5,13,18,24,42,82
20192020,019,CAMPBELL,452,Newport Independent,070,Newport High School,452070,019452070,210444001103,NKCES,905,09,43,49,11,4,15,0,0,0,0,0,0,11,12,23,0,0,0,6,10,16,21,17,38,92
20192020,019,CAMPBELL,452,Newport Independent,070,Newport High School,452070,019452070,210444001103,NKCES,905,10,37,46,8,9,17,0,0,0,0,0,0,5,4,9,0,0,0,7,7,14,26,17,43,83
20192020,019,CAMPBELL,452,Newport Independent,070,Newport High School,452070,019452070,210444001103,NKCES,905,11,36,39,4,6,10,0,0,0,0,0,0,7,6,13,0,0,0,5,1,6,23,23,46,75
20192020,019,CAMPBELL,452,Newport Independent,070,Newport High School,452070,019452070,210444001103,NKCES,905,14,1,1,0,0,0,0,0,0,0,0,0,0,0,0,0,0,0,0,0,0,1,1,2,2
20192020,091,NICHOLAS,455,Nicholas County,"",---District Total---,455,"","",CKEC,901,11,33,33,0,0,0,0,0,0,0,1,1,1,1,2,0,0,0,0,0,0,32,31,63,66
20192020,091,NICHOLAS,455,Nicholas County,"",---District Total---,455,"","",CKEC,901,All Students,506,525,5,0,5,1,0,1,2,2,4,17,31,48,0,0,0,5,3,8,495,470,965,1031
20192020,091,NICHOLAS,455,Nicholas County,"",---District Total---,455,"","",CKEC,901,PS,31,50,0,0,0,0,0,0,0,0,0,6,1,7,0,0,0,0,0,0,44,30,74,81
20192020,091,NICHOLAS,455,Nicholas County,"",---District Total---,455,"","",CKEC,901,KG,49,56,0,0,0,1,0,1,1,0,1,0,4,4,0,0,0,1,0,1,53,45,98,105
20192020,091,NICHOLAS,455,Nicholas County,"",---District Total---,455,"","",CKEC,901,01,40,46,0,0,0,0,0,0,0,0,0,3,2,5,0,0,0,0,0,0,43,38,81,86
20192020,091,NICHOLAS,455,Nicholas County,"",---District Total---,455,"","",CKEC,901,02,36,37,1,0,1,0,0,0,1,0,1,0,3,3,0,0,0,0,0,0,35,33,68,73
20192020,091,NICHOLAS,455,Nicholas County,"",---District Total---,455,"","",CKEC,901,03,37,36,0,0,0,0,0,0,0,0,0,2,3,5,0,0,0,0,0,0,34,34,68,73
20192020,091,NICHOLAS,455,Nicholas County,"",---District Total---,455,"","",CKEC,901,04,37,39,0,0,0,0,0,0,0,0,0,1,4,5,0,0,0,0,0,0,38,33,71,76
20192020,091,NICHOLAS,455,Nicholas County,"",---District Total---,455,"","",CKEC,901,05,31,52,1,0,1,0,0,0,0,0,0,3,0,3,0,0,0,1,0,1,47,31,78,83
20192020,091,NICHOLAS,455,Nicholas County,"",---District Total---,455,"","",CKEC,901,06,42,37,1,0,1,0,0,0,0,0,0,2,2,4,0,0,0,0,0,0,34,40,74,79
20192020,091,NICHOLAS,455,Nicholas County,"",---District Total---,455,"","",CKEC,901,07,54,34,0,0,0,0,0,0,0,0,0,2,4,6,0,0,0,1,0,1,31,50,81,88
20192020,091,NICHOLAS,455,Nicholas County,"",---District Total---,455,"","",CKEC,901,08,42,40,0,0,0,0,0,0,0,1,1,0,2,2,0,0,0,1,1,2,39,38,77,82
20192020,091,NICHOLAS,455,Nicholas County,"",---District Total---,455,"","",CKEC,901,09,36,36,1,0,1,0,0,0,0,0,0,1,3,4,0,0,0,0,1,1,34,32,66,72
20192020,091,NICHOLAS,455,Nicholas County,"",---District Total---,455,"","",CKEC,901,10,32,42,0,0,0,0,0,0,0,0,0,1,1,2,0,0,0,1,0,1,40,31,71,74
20192020,091,NICHOLAS,455,Nicholas County,"",---District Total---,455,"","",CKEC,901,12,37,37,1,0,1,0,0,0,0,0,0,1,2,3,0,0,0,0,1,1,35,34,69,74
20192020,091,NICHOLAS,455,Nicholas County,020,Nicholas County Elementary School,455020,091455020,210447001106,CKEC,901,KG,49,56,0,0,0,1,0,1,1,0,1,0,4,4,0,0,0,1,0,1,53,45,98,105
20192020,091,NICHOLAS,455,Nicholas County,020,Nicholas County Elementary School,455020,091455020,210447001106,CKEC,901,All Students,272,303,3,0,3,1,0,1,2,0,2,11,18,29,0,0,0,2,0,2,284,254,538,575
20192020,091,NICHOLAS,455,Nicholas County,020,Nicholas County Elementary School,455020,091455020,210447001106,CKEC,901,PS,31,50,0,0,0,0,0,0,0,0,0,6,1,7,0,0,0,0,0,0,44,30,74,81
20192020,091,NICHOLAS,455,Nicholas County,020,Nicholas County Elementary School,455020,091455020,210447001106,CKEC,901,01,40,46,0,0,0,0,0,0,0,0,0,3,2,5,0,0,0,0,0,0,43,38,81,86
20192020,091,NICHOLAS,455,Nicholas County,020,Nicholas County Elementary School,455020,091455020,210447001106,CKEC,901,02,36,37,1,0,1,0,0,0,1,0,1,0,3,3,0,0,0,0,0,0,35,33,68,73
20192020,091,NICHOLAS,455,Nicholas County,020,Nicholas County Elementary School,455020,091455020,210447001106,CKEC,901,03,37,36,0,0,0,0,0,0,0,0,0,2,3,5,0,0,0,0,0,0,34,34,68,73
20192020,091,NICHOLAS,455,Nicholas County,020,Nicholas County Elementary School,455020,091455020,210447001106,CKEC,901,04,37,39,0,0,0,0,0,0,0,0,0,1,4,5,0,0,0,0,0,0,38,33,71,76
20192020,091,NICHOLAS,455,Nicholas County,020,Nicholas County Elementary School,455020,091455020,210447001106,CKEC,901,05,31,52,1,0,1,0,0,0,0,0,0,3,0,3,0,0,0,1,0,1,47,31,78,83
20192020,091,NICHOLAS,455,Nicholas County,020,Nicholas County Elementary School,455020,091455020,210447001106,CKEC,901,06,42,37,1,0,1,0,0,0,0,0,0,2,2,4,0,0,0,0,0,0,34,40,74,79
20192020,091,NICHOLAS,455,Nicholas County,030,Nicholas County High School,455030,091455030,210447001107,CKEC,901,07,54,34,0,0,0,0,0,0,0,0,0,2,4,6,0,0,0,1,0,1,31,50,81,88
20192020,091,NICHOLAS,455,Nicholas County,030,Nicholas County High School,455030,091455030,210447001107,CKEC,901,08,42,40,0,0,0,0,0,0,0,1,1,0,2,2,0,0,0,1,1,2,39,38,77,82
20192020,091,NICHOLAS,455,Nicholas County,030,Nicholas County High School,455030,091455030,210447001107,CKEC,901,09,36,36,1,0,1,0,0,0,0,0,0,1,3,4,0,0,0,0,1,1,34,32,66,72
20192020,091,NICHOLAS,455,Nicholas County,030,Nicholas County High School,455030,091455030,210447001107,CKEC,901,10,32,42,0,0,0,0,0,0,0,0,0,1,1,2,0,0,0,1,0,1,40,31,71,74
20192020,091,NICHOLAS,455,Nicholas County,030,Nicholas County High School,455030,091455030,210447001107,CKEC,901,11,33,33,0,0,0,0,0,0,0,1,1,1,1,2,0,0,0,0,0,0,32,31,63,66
20192020,091,NICHOLAS,455,Nicholas County,030,Nicholas County High School,455030,091455030,210447001107,CKEC,901,12,37,37,1,0,1,0,0,0,0,0,0,1,2,3,0,0,0,0,1,1,35,34,69,74
20192020,091,NICHOLAS,455,Nicholas County,030,Nicholas County High School,455030,091455030,210447001107,CKEC,901,All Students,234,222,2,0,2,0,0,0,0,2,2,6,13,19,0,0,0,3,3,6,211,216,427,456
20192020,092,OHIO,461,Ohio County,"",---District Total---,461,"","",GRREC,902,04,134,152,1,0,1,0,0,0,0,0,0,14,15,29,0,0,0,5,3,8,132,116,248,286
20192020,092,OHIO,461,Ohio County,"",---District Total---,461,"","",GRREC,902,05,151,148,4,0,4,0,0,0,1,1,2,11,13,24,0,0,0,3,4,7,129,133,262,299
20192020,092,OHIO,461,Ohio County,"",---District Total---,461,"","",GRREC,902,06,150,178,1,1,2,0,0,0,0,0,0,18,16,34,0,0,0,4,5,9,155,128,283,328
20192020,092,OHIO,461,Ohio County,"",---District Total---,461,"","",GRREC,902,All Students,1922,2078,21,5,26,1,0,1,1,6,7,188,192,380,0,0,0,34,35,69,1833,1684,3517,4000
20192020,092,OHIO,461,Ohio County,"",---District Total---,461,"","",GRREC,902,PS,100,117,3,2,5,0,0,0,0,1,1,14,10,24,0,0,0,0,0,0,100,87,187,217
20192020,092,OHIO,461,Ohio County,"",---District Total---,461,"","",GRREC,902,KG,154,158,0,0,0,0,0,0,0,0,0,12,23,35,0,0,0,3,3,6,143,128,271,312
20192020,092,OHIO,461,Ohio County,"",---District Total---,461,"","",GRREC,902,01,156,163,0,0,0,0,0,0,0,0,0,12,9,21,0,0,0,3,2,5,148,145,293,319
20192020,092,OHIO,461,Ohio County,"",---District Total---,461,"","",GRREC,902,02,130,145,0,1,1,0,0,0,0,1,1,14,13,27,0,0,0,4,4,8,127,111,238,275
20192020,092,OHIO,461,Ohio County,"",---District Total---,461,"","",GRREC,902,03,173,164,0,1,1,0,0,0,0,1,1,18,21,39,0,0,0,2,3,5,144,147,291,337
20192020,092,OHIO,461,Ohio County,"",---District Total---,461,"","",GRREC,902,07,145,160,3,0,3,0,0,0,0,0,0,12,17,29,0,0,0,2,2,4,143,126,269,305
20192020,092,OHIO,461,Ohio County,"",---District Total---,461,"","",GRREC,902,08,186,190,2,0,2,0,0,0,0,0,0,13,17,30,0,0,0,0,2,2,175,167,342,376
20192020,092,OHIO,461,Ohio County,"",---District Total---,461,"","",GRREC,902,09,183,189,1,0,1,0,0,0,0,2,2,18,20,38,0,0,0,2,0,2,168,161,329,372
20192020,092,OHIO,461,Ohio County,"",---District Total---,461,"","",GRREC,902,10,128,157,1,2,3,1,0,1,0,0,0,21,14,35,0,0,0,2,2,4,132,110,242,285
20192020,092,OHIO,461,Ohio County,"",---District Total---,461,"","",GRREC,902,11,115,128,5,0,5,0,0,0,0,1,1,11,7,18,0,0,0,1,2,3,111,105,216,243
20192020,092,OHIO,461,Ohio County,"",---District Total---,461,"","",GRREC,902,12,115,145,3,0,3,0,0,0,0,0,0,14,7,21,0,0,0,3,3,6,125,105,230,260
20192020,092,OHIO,461,Ohio County,"",---District Total---,461,"","",GRREC,902,14,2,1,0,0,0,0,0,0,0,0,0,0,0,0,0,0,0,0,0,0,1,2,3,3
20192020,092,OHIO,461,Ohio County,010,Beaver Dam Elementary School,461010,092461010,210450001108,GRREC,902,05,38,34,1,0,1,0,0,0,0,1,1,9,9,18,0,0,0,0,1,1,24,27,51,72
20192020,092,OHIO,461,Ohio County,010,Beaver Dam Elementary School,461010,092461010,210450001108,GRREC,902,All Students,259,268,3,1,4,0,0,0,0,1,1,64,66,130,0,0,0,10,3,13,191,188,379,527
20192020,092,OHIO,461,Ohio County,010,Beaver Dam Elementary School,461010,092461010,210450001108,GRREC,902,06,33,37,1,1,2,0,0,0,0,0,0,10,6,16,0,0,0,1,0,1,25,26,51,70
20192020,092,OHIO,461,Ohio County,010,Beaver Dam Elementary School,461010,092461010,210450001108,GRREC,902,PS,23,26,2,0,2,0,0,0,0,1,1,10,6,16,0,0,0,0,0,0,14,16,30,49
20192020,092,OHIO,461,Ohio County,010,Beaver Dam Elementary School,461010,092461010,210450001108,GRREC,902,KG,46,28,0,0,0,0,0,0,0,0,0,9,14,23,0,0,0,1,1,2,18,31,49,74
20192020,092,OHIO,461,Ohio County,010,Beaver Dam Elementary School,461010,092461010,210450001108,GRREC,902,01,31,46,0,0,0,0,0,0,0,0,0,9,6,15,0,0,0,2,0,2,35,25,60,77
20192020,092,OHIO,461,Ohio County,010,Beaver Dam Elementary School,461010,092461010,210450001108,GRREC,902,02,28,40,0,0,0,0,0,0,0,0,0,10,6,16,0,0,0,3,0,3,27,22,49,68
20192020,092,OHIO,461,Ohio County,010,Beaver Dam Elementary School,461010,092461010,210450001108,GRREC,902,03,46,49,0,0,0,0,0,0,0,0,0,9,14,23,0,0,0,2,1,3,38,31,69,95
20192020,092,OHIO,461,Ohio County,010,Beaver Dam Elementary School,461010,092461010,210450001108,GRREC,902,04,37,34,1,0,1,0,0,0,0,0,0,8,11,19,0,0,0,1,0,1,24,26,50,71
20192020,092,OHIO,461,Ohio County,011,Ohio County Day Treatment,461011,092461011,210450002361,GRREC,902,10,0,6,0,0,0,0,0,0,0,0,0,0,0,0,0,0,0,0,0,0,6,0,6,6
20192020,092,OHIO,461,Ohio County,011,Ohio County Day Treatment,461011,092461011,210450002361,GRREC,902,12,0,1,0,0,0,0,0,0,0,0,0,0,0,0,0,0,0,0,0,0,1,0,1,1
20192020,092,OHIO,461,Ohio County,011,Ohio County Day Treatment,461011,092461011,210450002361,GRREC,902,All Students,4,18,0,0,0,0,0,0,0,0,0,0,0,0,0,0,0,0,0,0,18,4,22,22
20192020,092,OHIO,461,Ohio County,011,Ohio County Day Treatment,461011,092461011,210450002361,GRREC,902,08,0,2,0,0,0,0,0,0,0,0,0,0,0,0,0,0,0,0,0,0,2,0,2,2
20192020,092,OHIO,461,Ohio County,011,Ohio County Day Treatment,461011,092461011,210450002361,GRREC,902,09,2,6,0,0,0,0,0,0,0,0,0,0,0,0,0,0,0,0,0,0,6,2,8,8
20192020,092,OHIO,461,Ohio County,011,Ohio County Day Treatment,461011,092461011,210450002361,GRREC,902,11,2,3,0,0,0,0,0,0,0,0,0,0,0,0,0,0,0,0,0,0,3,2,5,5
20192020,092,OHIO,461,Ohio County,012,Ohio County Alternative Learning Program,461012,092461012,210450002353,GRREC,902,10,1,2,0,0,0,0,0,0,0,0,0,0,0,0,0,0,0,0,0,0,2,1,3,3
20192020,092,OHIO,461,Ohio County,012,Ohio County Alternative Learning Program,461012,092461012,210450002353,GRREC,902,All Students,10,29,0,0,0,0,0,0,0,0,0,3,2,5,0,0,0,0,1,1,26,7,33,39
20192020,092,OHIO,461,Ohio County,012,Ohio County Alternative Learning Program,461012,092461012,210450002353,GRREC,902,07,1,5,0,0,0,0,0,0,0,0,0,1,0,1,0,0,0,0,0,0,4,1,5,6
20192020,092,OHIO,461,Ohio County,012,Ohio County Alternative Learning Program,461012,092461012,210450002353,GRREC,902,08,4,6,0,0,0,0,0,0,0,0,0,0,1,1,0,0,0,0,1,1,6,2,8,10
20192020,092,OHIO,461,Ohio County,012,Ohio County Alternative Learning Program,461012,092461012,210450002353,GRREC,902,09,1,9,0,0,0,0,0,0,0,0,0,1,0,1,0,0,0,0,0,0,8,1,9,10
20192020,092,OHIO,461,Ohio County,012,Ohio County Alternative Learning Program,461012,092461012,210450002353,GRREC,902,11,0,4,0,0,0,0,0,0,0,0,0,1,0,1,0,0,0,0,0,0,3,0,3,4
20192020,092,OHIO,461,Ohio County,012,Ohio County Alternative Learning Program,461012,092461012,210450002353,GRREC,902,12,3,3,0,0,0,0,0,0,0,0,0,0,1,1,0,0,0,0,0,0,3,2,5,6
20192020,092,OHIO,461,Ohio County,090,Fordsville Elementary School,461090,092461090,210450001112,GRREC,902,06,12,21,0,0,0,0,0,0,0,0,0,1,2,3,0,0,0,0,0,0,20,10,30,33
20192020,092,OHIO,461,Ohio County,090,Fordsville Elementary School,461090,092461090,210450001112,GRREC,902,All Students,102,133,0,0,0,0,0,0,0,0,0,5,6,11,0,0,0,0,2,2,128,94,222,235
20192020,092,OHIO,461,Ohio County,090,Fordsville Elementary School,461090,092461090,210450001112,GRREC,902,PS,10,17,0,0,0,0,0,0,0,0,0,0,0,0,0,0,0,0,0,0,17,10,27,27
20192020,092,OHIO,461,Ohio County,090,Fordsville Elementary School,461090,092461090,210450001112,GRREC,902,KG,13,24,0,0,0,0,0,0,0,0,0,2,0,2,0,0,0,0,0,0,22,13,35,37
20192020,092,OHIO,461,Ohio County,090,Fordsville Elementary School,461090,092461090,210450001112,GRREC,902,01,20,20,0,0,0,0,0,0,0,0,0,1,0,1,0,0,0,0,0,0,19,20,39,40
20192020,092,OHIO,461,Ohio County,090,Fordsville Elementary School,461090,092461090,210450001112,GRREC,902,02,16,18,0,0,0,0,0,0,0,0,0,0,1,1,0,0,0,0,1,1,18,14,32,34
20192020,092,OHIO,461,Ohio County,090,Fordsville Elementary School,461090,092461090,210450001112,GRREC,902,03,15,10,0,0,0,0,0,0,0,0,0,0,2,2,0,0,0,0,0,0,10,13,23,25
20192020,092,OHIO,461,Ohio County,090,Fordsville Elementary School,461090,092461090,210450001112,GRREC,902,04,11,23,0,0,0,0,0,0,0,0,0,1,1,2,0,0,0,0,0,0,22,10,32,34
20192020,092,OHIO,461,Ohio County,090,Fordsville Elementary School,461090,092461090,210450001112,GRREC,902,05,15,17,0,0,0,0,0,0,0,0,0,0,0,0,0,0,0,0,1,1,17,14,31,32
20192020,092,OHIO,461,Ohio County,110,Ohio County Middle School,461110,092461110,210450001114,GRREC,902,07,144,155,3,0,3,0,0,0,0,0,0,11,17,28,0,0,0,2,2,4,139,125,264,299
20192020,092,OHIO,461,Ohio County,110,Ohio County Middle School,461110,092461110,210450001114,GRREC,902,All Students,326,337,5,0,5,0,0,0,0,0,0,24,33,57,0,0,0,2,3,5,306,290,596,663
20192020,092,OHIO,461,Ohio County,110,Ohio County Middle School,461110,092461110,210450001114,GRREC,902,08,182,182,2,0,2,0,0,0,0,0,0,13,16,29,0,0,0,0,1,1,167,165,332,364
20192020,092,OHIO,461,Ohio County,140,Horse Branch Elementary School,461140,092461140,210450001115,GRREC,902,05,12,12,1,0,1,0,0,0,0,0,0,0,0,0,0,0,0,0,0,0,11,12,23,24
20192020,092,OHIO,461,Ohio County,140,Horse Branch Elementary School,461140,092461140,210450001115,GRREC,902,All Students,94,86,1,0,1,0,0,0,0,0,0,3,1,4,0,0,0,1,2,3,81,91,172,180
20192020,092,OHIO,461,Ohio County,140,Horse Branch Elementary School,461140,092461140,210450001115,GRREC,902,PS,9,11,0,1,1,0,0,0,0,0,0,0,0,0,0,0,0,0,0,0,11,8,19,20
20192020,092,OHIO,461,Ohio County,140,Horse Branch Elementary School,461140,092461140,210450001115,GRREC,902,KG,11,10,0,0,0,0,0,0,0,0,0,0,1,1,0,0,0,0,0,0,10,10,20,21
20192020,092,OHIO,461,Ohio County,140,Horse Branch Elementary School,461140,092461140,210450001115,GRREC,902,01,14,15,0,0,0,0,0,0,0,0,0,1,0,1,0,0,0,0,0,0,14,14,28,29
20192020,092,OHIO,461,Ohio County,140,Horse Branch Elementary School,461140,092461140,210450001115,GRREC,902,02,8,13,0,0,0,0,0,0,0,0,0,0,0,0,0,0,0,0,0,0,13,8,21,21
20192020,092,OHIO,461,Ohio County,140,Horse Branch Elementary School,461140,092461140,210450001115,GRREC,902,03,17,12,0,0,0,0,0,0,0,0,0,1,0,1,0,0,0,0,0,0,11,17,28,29
20192020,092,OHIO,461,Ohio County,140,Horse Branch Elementary School,461140,092461140,210450001115,GRREC,902,04,16,10,0,0,0,0,0,0,0,0,0,0,0,0,0,0,0,1,0,1,9,16,25,26
20192020,092,OHIO,461,Ohio County,140,Horse Branch Elementary School,461140,092461140,210450001115,GRREC,902,06,16,14,0,0,0,0,0,0,0,0,0,1,0,1,0,0,0,0,2,2,13,14,27,30
20192020,092,OHIO,461,Ohio County,155,Ohio County High School,461155,092461155,210450001116,GRREC,902,12,112,141,3,0,3,0,0,0,0,0,0,14,6,20,0,0,0,3,3,6,121,103,224,253
20192020,092,OHIO,461,Ohio County,155,Ohio County High School,461155,092461155,210450001116,GRREC,902,All Students,534,586,10,2,12,1,0,1,0,3,3,62,47,109,0,0,0,8,7,15,505,475,980,1120
20192020,092,OHIO,461,Ohio County,155,Ohio County High School,461155,092461155,210450001116,GRREC,902,09,180,174,1,0,1,0,0,0,0,2,2,17,20,37,0,0,0,2,0,2,154,158,312,354
20192020,092,OHIO,461,Ohio County,155,Ohio County High School,461155,092461155,210450001116,GRREC,902,10,127,149,1,2,3,1,0,1,0,0,0,21,14,35,0,0,0,2,2,4,124,109,233,276
20192020,092,OHIO,461,Ohio County,155,Ohio County High School,461155,092461155,210450001116,GRREC,902,11,113,121,5,0,5,0,0,0,0,1,1,10,7,17,0,0,0,1,2,3,105,103,208,234
20192020,092,OHIO,461,Ohio County,155,Ohio County High School,461155,092461155,210450001116,GRREC,902,14,2,1,0,0,0,0,0,0,0,0,0,0,0,0,0,0,0,0,0,0,1,2,3,3
20192020,092,OHIO,461,Ohio County,170,Southern Elementary School,461170,092461170,210450001118,GRREC,902,05,20,23,1,0,1,0,0,0,0,0,0,0,0,0,0,0,0,1,0,1,21,20,41,43
20192020,092,OHIO,461,Ohio County,170,Southern Elementary School,461170,092461170,210450001118,GRREC,902,All Students,141,157,1,1,2,0,0,0,0,0,0,6,7,13,0,0,0,1,1,2,149,132,281,298
20192020,092,OHIO,461,Ohio County,170,Southern Elementary School,461170,092461170,210450001118,GRREC,902,PS,14,18,0,0,0,0,0,0,0,0,0,1,2,3,0,0,0,0,0,0,17,12,29,32
20192020,092,OHIO,461,Ohio County,170,Southern Elementary School,461170,092461170,210450001118,GRREC,902,KG,19,31,0,0,0,0,0,0,0,0,0,1,1,2,0,0,0,0,1,1,30,17,47,50
20192020,092,OHIO,461,Ohio County,170,Southern Elementary School,461170,092461170,210450001118,GRREC,902,01,29,16,0,0,0,0,0,0,0,0,0,0,2,2,0,0,0,0,0,0,16,27,43,45
20192020,092,OHIO,461,Ohio County,170,Southern Elementary School,461170,092461170,210450001118,GRREC,902,02,14,24,0,1,1,0,0,0,0,0,0,0,1,1,0,0,0,0,0,0,24,12,36,38
20192020,092,OHIO,461,Ohio County,170,Southern Elementary School,461170,092461170,210450001118,GRREC,902,03,22,23,0,0,0,0,0,0,0,0,0,3,0,3,0,0,0,0,0,0,20,22,42,45
20192020,092,OHIO,461,Ohio County,170,Southern Elementary School,461170,092461170,210450001118,GRREC,902,04,13,23,0,0,0,0,0,0,0,0,0,1,1,2,0,0,0,0,0,0,22,12,34,36
20192020,092,OHIO,461,Ohio County,170,Southern Elementary School,461170,092461170,210450001118,GRREC,902,06,24,17,0,0,0,0,0,0,0,0,0,1,2,3,0,0,0,0,0,0,16,22,38,41
20192020,092,OHIO,461,Ohio County,190,Wayland Alexander Elementary School,461190,092461190,210450001119,GRREC,902,06,48,65,0,0,0,0,0,0,0,0,0,5,4,9,0,0,0,1,2,3,59,42,101,113
20192020,092,OHIO,461,Ohio County,190,Wayland Alexander Elementary School,461190,092461190,210450001119,GRREC,902,All Students,333,339,0,1,1,0,0,0,1,2,3,18,26,44,0,0,0,5,6,11,315,298,613,672
20192020,092,OHIO,461,Ohio County,190,Wayland Alexander Elementary School,461190,092461190,210450001119,GRREC,902,PS,22,35,1,1,2,0,0,0,0,0,0,3,2,5,0,0,0,0,0,0,31,19,50,57
20192020,092,OHIO,461,Ohio County,190,Wayland Alexander Elementary School,461190,092461190,210450001119,GRREC,902,KG,50,51,0,0,0,0,0,0,0,0,0,0,7,7,0,0,0,1,1,2,50,42,92,101
20192020,092,OHIO,461,Ohio County,190,Wayland Alexander Elementary School,461190,092461190,210450001119,GRREC,902,01,48,40,0,0,0,0,0,0,0,0,0,1,1,2,0,0,0,0,2,2,39,45,84,88
20192020,092,OHIO,461,Ohio County,190,Wayland Alexander Elementary School,461190,092461190,210450001119,GRREC,902,02,49,35,0,0,0,0,0,0,0,1,1,2,4,6,0,0,0,1,0,1,32,44,76,84
20192020,092,OHIO,461,Ohio County,190,Wayland Alexander Elementary School,461190,092461190,210450001119,GRREC,902,03,47,56,0,1,1,0,0,0,0,1,1,4,4,8,0,0,0,0,0,0,52,41,93,103
20192020,092,OHIO,461,Ohio County,190,Wayland Alexander Elementary School,461190,092461190,210450001119,GRREC,902,04,44,45,0,0,0,0,0,0,0,0,0,4,2,6,0,0,0,1,1,2,40,41,81,89
20192020,092,OHIO,461,Ohio County,190,Wayland Alexander Elementary School,461190,092461190,210450001119,GRREC,902,05,47,47,0,0,0,0,0,0,1,0,1,2,4,6,0,0,0,1,0,1,43,43,86,94
20192020,092,OHIO,461,Ohio County,200,Western Elementary School,461200,092461200,210450001120,GRREC,902,06,17,24,0,0,0,0,0,0,0,0,0,0,2,2,0,0,0,2,1,3,22,14,36,41
20192020,092,OHIO,461,Ohio County,200,Western Elementary School,461200,092461200,210450001120,GRREC,902,All Students,119,125,1,0,1,0,0,0,0,0,0,3,4,7,0,0,0,7,10,17,114,105,219,244
20192020,092,OHIO,461,Ohio County,200,Western Elementary School,461200,092461200,210450001120,GRREC,902,PS,22,10,0,0,0,0,0,0,0,0,0,0,0,0,0,0,0,0,0,0,10,22,32,32
20192020,092,OHIO,461,Ohio County,200,Western Elementary School,461200,092461200,210450001120,GRREC,902,KG,15,14,0,0,0,0,0,0,0,0,0,0,0,0,0,0,0,1,0,1,13,15,28,29
20192020,092,OHIO,461,Ohio County,200,Western Elementary School,461200,092461200,210450001120,GRREC,902,01,14,26,0,0,0,0,0,0,0,0,0,0,0,0,0,0,0,1,0,1,25,14,39,40
20192020,092,OHIO,461,Ohio County,200,Western Elementary School,461200,092461200,210450001120,GRREC,902,02,15,15,0,0,0,0,0,0,0,0,0,2,1,3,0,0,0,0,3,3,13,11,24,30
20192020,092,OHIO,461,Ohio County,200,Western Elementary School,461200,092461200,210450001120,GRREC,902,03,26,14,0,0,0,0,0,0,0,0,0,1,1,2,0,0,0,0,2,2,13,23,36,40
20192020,092,OHIO,461,Ohio County,200,Western Elementary School,461200,092461200,210450001120,GRREC,902,04,13,17,0,0,0,0,0,0,0,0,0,0,0,0,0,0,0,2,2,4,15,11,26,30
20192020,092,OHIO,461,Ohio County,200,Western Elementary School,461200,092461200,210450001120,GRREC,902,05,19,15,1,0,1,0,0,0,0,0,0,0,0,0,0,0,0,1,2,3,13,17,30,34
20192020,093,OLDHAM,465,Oldham County,"",---District Total---,465,"","",OVEC,906,All Students,6158,6403,153,137,290,8,11,19,127,154,281,436,425,861,4,2,6,269,241,510,5406,5188,10594,12561
20192020,093,OLDHAM,465,Oldham County,"",---District Total---,465,"","",OVEC,906,PS,103,152,5,5,10,0,0,0,0,1,1,14,13,27,0,0,0,10,4,14,123,80,203,255
20192020,093,OLDHAM,465,Oldham County,"",---District Total---,465,"","",OVEC,906,KG,407,421,13,7,20,0,0,0,4,5,9,33,25,58,1,0,1,23,31,54,347,339,686,828
20192020,093,OLDHAM,465,Oldham County,"",---District Total---,465,"","",OVEC,906,01,452,463,14,11,25,0,0,0,5,2,7,25,30,55,0,0,0,30,24,54,389,385,774,915
20192020,093,OLDHAM,465,Oldham County,"",---District Total---,465,"","",OVEC,906,02,384,449,8,12,20,0,0,0,8,9,17,37,30,67,0,0,0,23,9,32,373,324,697,833
20192020,093,OLDHAM,465,Oldham County,"",---District Total---,465,"","",OVEC,906,03,463,458,6,6,12,0,1,1,10,5,15,42,22,64,1,0,1,19,20,39,380,409,789,921
20192020,093,OLDHAM,465,Oldham County,"",---District Total---,465,"","",OVEC,906,04,463,450,12,10,22,1,1,2,13,8,21,32,36,68,0,0,0,19,24,43,373,384,757,913
20192020,093,OLDHAM,465,Oldham County,"",---District Total---,465,"","",OVEC,906,05,486,477,10,11,21,2,1,3,10,7,17,30,34,64,0,0,0,20,14,34,405,419,824,963
20192020,093,OLDHAM,465,Oldham County,"",---District Total---,465,"","",OVEC,906,06,486,573,10,11,21,0,0,0,11,13,24,34,33,67,1,0,1,24,15,39,493,414,907,1059
20192020,093,OLDHAM,465,Oldham County,"",---District Total---,465,"","",OVEC,906,07,468,508,8,7,15,1,2,3,16,18,34,37,44,81,0,0,0,25,26,51,421,371,792,976
20192020,093,OLDHAM,465,Oldham County,"",---District Total---,465,"","",OVEC,906,08,528,516,10,4,14,2,1,3,8,15,23,34,49,83,1,0,1,20,21,41,441,438,879,1044
20192020,093,OLDHAM,465,Oldham County,"",---District Total---,465,"","",OVEC,906,09,525,542,16,12,28,1,2,3,15,16,31,35,38,73,0,0,0,22,14,36,453,443,896,1067
20192020,093,OLDHAM,465,Oldham County,"",---District Total---,465,"","",OVEC,906,10,523,517,10,19,29,0,1,1,10,20,30,32,30,62,0,1,1,16,11,27,449,441,890,1040
20192020,093,OLDHAM,465,Oldham County,"",---District Total---,465,"","",OVEC,906,11,493,509,17,16,33,1,0,1,9,16,25,36,31,67,0,0,0,11,15,26,435,415,850,1002
20192020,093,OLDHAM,465,Oldham County,"",---District Total---,465,"","",OVEC,906,12,475,507,18,11,29,0,2,2,7,20,27,28,23,51,0,1,1,16,17,33,438,401,839,982
20192020,093,OLDHAM,465,Oldham County,"",---District Total---,465,"","",OVEC,906,14,5,13,1,0,1,0,0,0,1,0,1,1,0,1,0,0,0,1,0,1,9,5,14,18
20192020,093,OLDHAM,465,Oldham County,005,Camden Station Elementary School,465005,093465005,210453001597,OVEC,906,04,48,45,1,0,1,0,0,0,0,1,1,3,2,5,0,0,0,2,2,4,39,43,82,93
20192020,093,OLDHAM,465,Oldham County,005,Camden Station Elementary School,465005,093465005,210453001597,OVEC,906,05,40,28,1,1,2,0,0,0,0,0,0,3,2,5,0,0,0,2,0,2,22,37,59,68
20192020,093,OLDHAM,465,Oldham County,005,Camden Station Elementary School,465005,093465005,210453001597,OVEC,906,KG,34,43,3,1,4,0,0,0,1,0,1,3,2,5,0,0,0,0,6,6,36,25,61,77
20192020,093,OLDHAM,465,Oldham County,005,Camden Station Elementary School,465005,093465005,210453001597,OVEC,906,01,50,49,2,1,3,0,0,0,2,0,2,2,5,7,0,0,0,3,4,7,40,40,80,99
20192020,093,OLDHAM,465,Oldham County,005,Camden Station Elementary School,465005,093465005,210453001597,OVEC,906,02,33,45,2,3,5,0,0,0,0,0,0,4,2,6,0,0,0,1,0,1,38,28,66,78
20192020,093,OLDHAM,465,Oldham County,005,Camden Station Elementary School,465005,093465005,210453001597,OVEC,906,03,48,37,1,1,2,0,0,0,2,1,3,1,2,3,0,0,0,1,0,1,32,44,76,85
20192020,093,OLDHAM,465,Oldham County,005,Camden Station Elementary School,465005,093465005,210453001597,OVEC,906,All Students,253,247,10,7,17,0,0,0,5,2,7,16,15,31,0,0,0,9,12,21,207,217,424,500
20192020,093,OLDHAM,465,Oldham County,007,Buckner Elementary School,465007,093465007,210453001817,OVEC,906,03,54,58,0,0,0,0,0,0,0,0,0,2,2,4,0,0,0,3,1,4,53,51,104,112
20192020,093,OLDHAM,465,Oldham County,007,Buckner Elementary School,465007,093465007,210453001817,OVEC,906,05,44,57,1,0,1,0,0,0,0,0,0,4,1,5,0,0,0,2,0,2,50,43,93,101
20192020,093,OLDHAM,465,Oldham County,007,Buckner Elementary School,465007,093465007,210453001817,OVEC,906,All Students,299,331,8,3,11,0,0,0,7,0,7,12,12,24,0,0,0,14,7,21,290,277,567,630
20192020,093,OLDHAM,465,Oldham County,007,Buckner Elementary School,465007,093465007,210453001817,OVEC,906,KG,42,44,0,0,0,0,0,0,3,0,3,1,1,2,0,0,0,3,3,6,37,38,75,86
20192020,093,OLDHAM,465,Oldham County,007,Buckner Elementary School,465007,093465007,210453001817,OVEC,906,01,71,60,2,2,4,0,0,0,0,0,0,1,4,5,0,0,0,4,0,4,53,65,118,131
20192020,093,OLDHAM,465,Oldham County,007,Buckner Elementary School,465007,093465007,210453001817,OVEC,906,02,42,65,1,1,2,0,0,0,3,0,3,3,4,7,0,0,0,2,0,2,56,37,93,107
20192020,093,OLDHAM,465,Oldham County,007,Buckner Elementary School,465007,093465007,210453001817,OVEC,906,04,46,47,4,0,4,0,0,0,1,0,1,1,0,1,0,0,0,0,3,3,41,43,84,93
20192020,093,OLDHAM,465,Oldham County,010,Centerfield Elementary School,465010,093465010,210453001121,OVEC,906,05,56,42,0,0,0,0,0,0,0,0,0,2,5,7,0,0,0,1,2,3,39,49,88,98
20192020,093,OLDHAM,465,Oldham County,010,Centerfield Elementary School,465010,093465010,210453001121,OVEC,906,04,44,44,0,1,1,0,0,0,0,2,2,4,3,7,0,0,0,4,4,8,36,34,70,88
20192020,093,OLDHAM,465,Oldham County,010,Centerfield Elementary School,465010,093465010,210453001121,OVEC,906,All Students,256,261,5,6,11,0,0,0,2,4,6,26,17,43,1,0,1,15,18,33,212,211,423,517
20192020,093,OLDHAM,465,Oldham County,010,Centerfield Elementary School,465010,093465010,210453001121,OVEC,906,KG,43,47,2,1,3,0,0,0,0,0,0,5,2,7,0,0,0,2,4,6,38,36,74,90
20192020,093,OLDHAM,465,Oldham County,010,Centerfield Elementary School,465010,093465010,210453001121,OVEC,906,01,42,42,1,0,1,0,0,0,0,0,0,6,1,7,0,0,0,4,5,9,31,36,67,84
20192020,093,OLDHAM,465,Oldham County,010,Centerfield Elementary School,465010,093465010,210453001121,OVEC,906,02,30,39,1,2,3,0,0,0,1,1,2,5,4,9,0,0,0,4,0,4,28,23,51,69
20192020,093,OLDHAM,465,Oldham County,010,Centerfield Elementary School,465010,093465010,210453001121,OVEC,906,03,41,47,1,2,3,0,0,0,1,1,2,4,2,6,1,0,1,0,3,3,40,33,73,88
20192020,093,OLDHAM,465,Oldham County,012,North Oldham High School,465012,093465012,210453001953,OVEC,906,09,95,106,1,2,3,0,1,1,5,4,9,6,6,12,0,0,0,1,4,5,93,78,171,201
20192020,093,OLDHAM,465,Oldham County,012,North Oldham High School,465012,093465012,210453001953,OVEC,906,All Students,490,475,6,8,14,0,1,1,15,33,48,25,22,47,0,1,1,9,11,20,420,414,834,965
20192020,093,OLDHAM,465,Oldham County,012,North Oldham High School,465012,093465012,210453001953,OVEC,906,08,16,18,0,0,0,0,0,0,2,3,5,1,1,2,0,0,0,2,0,2,13,12,25,34
20192020,093,OLDHAM,465,Oldham County,012,North Oldham High School,465012,093465012,210453001953,OVEC,906,10,138,123,3,3,6,0,0,0,2,11,13,5,6,11,0,0,0,3,1,4,110,117,227,261
20192020,093,OLDHAM,465,Oldham County,012,North Oldham High School,465012,093465012,210453001953,OVEC,906,11,124,111,1,1,2,0,0,0,1,8,9,9,6,15,0,0,0,3,2,5,97,107,204,235
20192020,093,OLDHAM,465,Oldham County,012,North Oldham High School,465012,093465012,210453001953,OVEC,906,12,117,117,1,2,3,0,0,0,5,7,12,4,3,7,0,1,1,0,4,4,107,100,207,234
20192020,093,OLDHAM,465,Oldham County,013,Kenwood Station Elementary School,465013,093465013,210453002007,OVEC,906,05,54,60,1,1,2,0,0,0,0,0,0,3,1,4,0,0,0,1,2,3,55,50,105,114
20192020,093,OLDHAM,465,Oldham County,013,Kenwood Station Elementary School,465013,093465013,210453002007,OVEC,906,All Students,335,305,6,10,16,0,0,0,3,3,6,14,6,20,0,0,0,17,11,28,265,305,570,640
20192020,093,OLDHAM,465,Oldham County,013,Kenwood Station Elementary School,465013,093465013,210453002007,OVEC,906,KG,50,54,1,0,1,0,0,0,0,1,1,3,0,3,0,0,0,4,1,5,46,48,94,104
20192020,093,OLDHAM,465,Oldham County,013,Kenwood Station Elementary School,465013,093465013,210453002007,OVEC,906,01,59,42,1,3,4,0,0,0,0,0,0,2,1,3,0,0,0,4,3,7,35,52,87,101
20192020,093,OLDHAM,465,Oldham County,013,Kenwood Station Elementary School,465013,093465013,210453002007,OVEC,906,02,52,52,1,3,4,0,0,0,1,0,1,2,1,3,0,0,0,3,0,3,45,48,93,104
20192020,093,OLDHAM,465,Oldham County,013,Kenwood Station Elementary School,465013,093465013,210453002007,OVEC,906,03,66,47,1,0,1,0,0,0,0,2,2,3,2,5,0,0,0,2,3,5,41,59,100,113
20192020,093,OLDHAM,465,Oldham County,013,Kenwood Station Elementary School,465013,093465013,210453002007,OVEC,906,04,54,50,1,3,4,0,0,0,2,0,2,1,1,2,0,0,0,3,2,5,43,48,91,104
20192020,093,OLDHAM,465,Oldham County,014,Harmony Elementary School,465014,093465014,210453002008,OVEC,906,04,54,60,1,1,2,0,0,0,1,0,1,3,3,6,0,0,0,3,4,7,52,46,98,114
20192020,093,OLDHAM,465,Oldham County,014,Harmony Elementary School,465014,093465014,210453002008,OVEC,906,All Students,304,334,2,2,4,0,0,0,8,6,14,13,8,21,0,0,0,12,15,27,299,273,572,638
20192020,093,OLDHAM,465,Oldham County,014,Harmony Elementary School,465014,093465014,210453002008,OVEC,906,KG,47,60,0,0,0,0,0,0,0,0,0,3,1,4,0,0,0,2,2,4,55,44,99,107
20192020,093,OLDHAM,465,Oldham County,014,Harmony Elementary School,465014,093465014,210453002008,OVEC,906,01,48,56,0,0,0,0,0,0,1,1,2,2,0,2,0,0,0,1,3,4,52,44,96,104
20192020,093,OLDHAM,465,Oldham County,014,Harmony Elementary School,465014,093465014,210453002008,OVEC,906,02,43,57,1,0,1,0,0,0,1,1,2,1,1,2,0,0,0,2,1,3,52,40,92,100
20192020,093,OLDHAM,465,Oldham County,014,Harmony Elementary School,465014,093465014,210453002008,OVEC,906,03,47,45,0,0,0,0,0,0,4,1,5,1,1,2,0,0,0,0,3,3,40,42,82,92
20192020,093,OLDHAM,465,Oldham County,014,Harmony Elementary School,465014,093465014,210453002008,OVEC,906,05,65,56,0,1,1,0,0,0,1,3,4,3,2,5,0,0,0,4,2,6,48,57,105,121
20192020,093,OLDHAM,465,Oldham County,015,East Oldham Middle School,465015,093465015,210453002009,OVEC,906,07,91,126,0,0,0,0,0,0,1,6,7,10,9,19,0,0,0,3,4,7,112,72,184,217
20192020,093,OLDHAM,465,Oldham County,015,East Oldham Middle School,465015,093465015,210453002009,OVEC,906,All Students,303,358,5,1,6,1,1,2,2,10,12,19,18,37,0,0,0,11,10,21,320,263,583,661
20192020,093,OLDHAM,465,Oldham County,015,East Oldham Middle School,465015,093465015,210453002009,OVEC,906,06,106,118,1,1,2,0,0,0,1,2,3,5,5,10,0,0,0,4,2,6,107,96,203,224
20192020,093,OLDHAM,465,Oldham County,015,East Oldham Middle School,465015,093465015,210453002009,OVEC,906,08,106,114,4,0,4,1,1,2,0,2,2,4,4,8,0,0,0,4,4,8,101,95,196,220
20192020,093,OLDHAM,465,Oldham County,020,Crestwood Elementary School,465020,093465020,210453001122,OVEC,906,04,55,50,2,0,2,0,0,0,0,0,0,7,7,14,0,0,0,2,2,4,39,46,85,105
20192020,093,OLDHAM,465,Oldham County,020,Crestwood Elementary School,465020,093465020,210453001122,OVEC,906,All Students,267,304,13,5,18,0,0,0,1,0,1,28,25,53,0,0,0,20,16,36,242,221,463,571
20192020,093,OLDHAM,465,Oldham County,020,Crestwood Elementary School,465020,093465020,210453001122,OVEC,906,KG,45,44,6,2,8,0,0,0,0,0,0,3,2,5,0,0,0,4,5,9,31,36,67,89
20192020,093,OLDHAM,465,Oldham County,020,Crestwood Elementary School,465020,093465020,210453001122,OVEC,906,01,35,57,2,1,3,0,0,0,0,0,0,3,2,5,0,0,0,2,2,4,50,30,80,92
20192020,093,OLDHAM,465,Oldham County,020,Crestwood Elementary School,465020,093465020,210453001122,OVEC,906,02,35,48,0,0,0,0,0,0,0,0,0,4,6,10,0,0,0,4,2,6,40,27,67,83
20192020,093,OLDHAM,465,Oldham County,020,Crestwood Elementary School,465020,093465020,210453001122,OVEC,906,03,48,58,1,2,3,0,0,0,0,0,0,7,0,7,0,0,0,5,2,7,45,44,89,106
20192020,093,OLDHAM,465,Oldham County,020,Crestwood Elementary School,465020,093465020,210453001122,OVEC,906,05,49,47,2,0,2,0,0,0,1,0,1,4,8,12,0,0,0,3,3,6,37,38,75,96
20192020,093,OLDHAM,465,Oldham County,025,Goshen At Hillcrest Elementary School,465025,093465025,210453001432,OVEC,906,04,67,62,0,1,1,0,0,0,9,3,12,5,2,7,0,0,0,2,4,6,46,57,103,129
20192020,093,OLDHAM,465,Oldham County,025,Goshen At Hillcrest Elementary School,465025,093465025,210453001432,OVEC,906,All Students,353,346,2,4,6,0,0,0,20,16,36,19,19,38,0,0,0,18,16,34,287,298,585,699
20192020,093,OLDHAM,465,Oldham County,025,Goshen At Hillcrest Elementary School,465025,093465025,210453001432,OVEC,906,KG,57,42,0,0,0,0,0,0,0,4,4,2,5,7,0,0,0,2,3,5,38,45,83,99
20192020,093,OLDHAM,465,Oldham County,025,Goshen At Hillcrest Elementary School,465025,093465025,210453001432,OVEC,906,01,44,54,1,0,1,0,0,0,2,1,3,1,2,3,0,0,0,4,1,5,46,40,86,98
20192020,093,OLDHAM,465,Oldham County,025,Goshen At Hillcrest Elementary School,465025,093465025,210453001432,OVEC,906,02,50,64,0,0,0,0,0,0,2,6,8,5,4,9,0,0,0,4,3,7,53,37,90,114
20192020,093,OLDHAM,465,Oldham County,025,Goshen At Hillcrest Elementary School,465025,093465025,210453001432,OVEC,906,03,65,66,0,1,1,0,0,0,3,0,3,6,4,10,0,0,0,4,2,6,53,58,111,131
20192020,093,OLDHAM,465,Oldham County,025,Goshen At Hillcrest Elementary School,465025,093465025,210453001432,OVEC,906,05,70,58,1,2,3,0,0,0,4,2,6,0,2,2,0,0,0,2,3,5,51,61,112,128
20192020,093,OLDHAM,465,Oldham County,028,Locust Grove Elementary School,465028,093465028,210453002196,OVEC,906,04,54,55,0,1,1,1,0,1,0,2,2,1,3,4,0,0,0,1,1,2,52,47,99,109
20192020,093,OLDHAM,465,Oldham County,028,Locust Grove Elementary School,465028,093465028,210453002196,OVEC,906,All Students,325,333,9,8,17,2,2,4,4,5,9,9,11,20,1,0,1,17,11,28,291,288,579,658
20192020,093,OLDHAM,465,Oldham County,028,Locust Grove Elementary School,465028,093465028,210453002196,OVEC,906,KG,46,50,0,2,2,0,0,0,0,0,0,3,3,6,1,0,1,3,2,5,43,39,82,96
20192020,093,OLDHAM,465,Oldham County,028,Locust Grove Elementary School,465028,093465028,210453002196,OVEC,906,01,49,63,4,1,5,0,0,0,0,0,0,1,1,2,0,0,0,6,5,11,52,42,94,112
20192020,093,OLDHAM,465,Oldham County,028,Locust Grove Elementary School,465028,093465028,210453002196,OVEC,906,02,62,40,1,2,3,0,0,0,0,1,1,0,1,1,0,0,0,1,1,2,38,57,95,102
20192020,093,OLDHAM,465,Oldham County,028,Locust Grove Elementary School,465028,093465028,210453002196,OVEC,906,03,55,58,2,0,2,0,1,1,0,0,0,4,1,5,0,0,0,2,2,4,50,51,101,113
20192020,093,OLDHAM,465,Oldham County,028,Locust Grove Elementary School,465028,093465028,210453002196,OVEC,906,05,59,67,2,2,4,1,1,2,4,2,6,0,2,2,0,0,0,4,0,4,56,52,108,126
20192020,093,OLDHAM,465,Oldham County,030,LaGrange Elementary School,465030,093465030,210453001123,OVEC,906,01,54,40,1,3,4,0,0,0,0,0,0,7,14,21,0,0,0,2,1,3,30,36,66,94
20192020,093,OLDHAM,465,Oldham County,030,LaGrange Elementary School,465030,093465030,210453001123,OVEC,906,All Students,263,253,8,12,20,1,1,2,0,0,0,62,64,126,0,0,0,12,16,28,170,170,340,516
20192020,093,OLDHAM,465,Oldham County,030,LaGrange Elementary School,465030,093465030,210453001123,OVEC,906,KG,43,37,1,1,2,0,0,0,0,0,0,10,9,19,0,0,0,3,5,8,23,28,51,80
20192020,093,OLDHAM,465,Oldham County,030,LaGrange Elementary School,465030,093465030,210453001123,OVEC,906,02,37,39,1,1,2,0,0,0,0,0,0,13,7,20,0,0,0,2,2,4,23,27,50,76
20192020,093,OLDHAM,465,Oldham County,030,LaGrange Elementary School,465030,093465030,210453001123,OVEC,906,03,39,42,0,0,0,0,0,0,0,0,0,14,8,22,0,0,0,2,4,6,26,27,53,81
20192020,093,OLDHAM,465,Oldham County,030,LaGrange Elementary School,465030,093465030,210453001123,OVEC,906,04,41,37,3,3,6,0,1,1,0,0,0,7,15,22,0,0,0,2,2,4,25,20,45,78
20192020,093,OLDHAM,465,Oldham County,030,LaGrange Elementary School,465030,093465030,210453001123,OVEC,906,05,49,58,2,4,6,1,0,1,0,0,0,11,11,22,0,0,0,1,2,3,43,32,75,107
20192020,093,OLDHAM,465,Oldham County,060,Oldham County High School,465060,093465060,210453001125,OVEC,906,14,0,1,0,0,0,0,0,0,0,0,0,1,0,1,0,0,0,0,0,0,0,0,0,1
20192020,093,OLDHAM,465,Oldham County,060,Oldham County High School,465060,093465060,210453001125,OVEC,906,All Students,685,624,20,21,41,1,4,5,5,10,15,54,60,114,0,1,1,21,19,40,523,570,1093,1309
20192020,093,OLDHAM,465,Oldham County,060,Oldham County High School,465060,093465060,210453001125,OVEC,906,09,175,178,4,4,8,0,1,1,3,2,5,22,18,40,0,0,0,8,2,10,141,148,289,353
20192020,093,OLDHAM,465,Oldham County,060,Oldham County High School,465060,093465060,210453001125,OVEC,906,10,170,141,2,9,11,0,1,1,2,2,4,9,17,26,0,1,1,4,4,8,124,136,260,311
20192020,093,OLDHAM,465,Oldham County,060,Oldham County High School,465060,093465060,210453001125,OVEC,906,11,171,146,8,6,14,1,0,1,0,2,2,9,15,24,0,0,0,3,7,10,125,141,266,317
20192020,093,OLDHAM,465,Oldham County,060,Oldham County High School,465060,093465060,210453001125,OVEC,906,12,169,158,6,2,8,0,2,2,0,4,4,13,10,23,0,0,0,6,6,12,133,145,278,327
20192020,093,OLDHAM,465,Oldham County,070,Oldham County Middle School,465070,093465070,210453001126,OVEC,906,07,135,124,2,1,3,0,0,0,4,3,7,16,17,33,0,0,0,11,9,20,91,105,196,259
20192020,093,OLDHAM,465,Oldham County,070,Oldham County Middle School,465070,093465070,210453001126,OVEC,906,All Students,378,416,7,5,12,0,0,0,4,7,11,45,48,93,0,0,0,24,19,43,336,299,635,794
20192020,093,OLDHAM,465,Oldham County,070,Oldham County Middle School,465070,093465070,210453001126,OVEC,906,06,110,159,3,3,6,0,0,0,0,1,1,12,7,19,0,0,0,8,3,11,136,96,232,269
20192020,093,OLDHAM,465,Oldham County,070,Oldham County Middle School,465070,093465070,210453001126,OVEC,906,08,133,133,2,1,3,0,0,0,0,3,3,17,24,41,0,0,0,5,7,12,109,98,207,266
20192020,093,OLDHAM,465,Oldham County,080,Buckner Alternative High School,465080,093465080,210453000735,OVEC,906,11,1,4,1,0,1,0,0,0,0,0,0,0,0,0,0,0,0,0,0,0,3,1,4,5
20192020,093,OLDHAM,465,Oldham County,080,Buckner Alternative High School,465080,093465080,210453000735,OVEC,906,All Students,12,28,4,1,5,0,0,0,0,0,0,0,1,1,0,0,0,3,2,5,21,8,29,40
20192020,093,OLDHAM,465,Oldham County,080,Buckner Alternative High School,465080,093465080,210453000735,OVEC,906,08,1,3,0,0,0,0,0,0,0,0,0,0,0,0,0,0,0,0,0,0,3,1,4,4
20192020,093,OLDHAM,465,Oldham County,080,Buckner Alternative High School,465080,093465080,210453000735,OVEC,906,09,3,8,1,0,1,0,0,0,0,0,0,0,1,1,0,0,0,3,2,5,4,0,4,11
20192020,093,OLDHAM,465,Oldham County,080,Buckner Alternative High School,465080,093465080,210453000735,OVEC,906,10,3,5,2,1,3,0,0,0,0,0,0,0,0,0,0,0,0,0,0,0,3,2,5,8
20192020,093,OLDHAM,465,Oldham County,080,Buckner Alternative High School,465080,093465080,210453000735,OVEC,906,12,4,8,0,0,0,0,0,0,0,0,0,0,0,0,0,0,0,0,0,0,8,4,12,12
20192020,093,OLDHAM,465,Oldham County,090,South Oldham Middle School,465090,093465090,210453001433,OVEC,906,07,130,127,4,6,10,0,2,2,5,2,7,8,9,17,0,0,0,6,8,14,104,103,207,257
20192020,093,OLDHAM,465,Oldham County,090,South Oldham Middle School,465090,093465090,210453001433,OVEC,906,All Students,408,419,12,12,24,1,2,3,7,9,16,27,34,61,1,0,1,20,19,39,351,332,683,827
20192020,093,OLDHAM,465,Oldham County,090,South Oldham Middle School,465090,093465090,210453001433,OVEC,906,05,0,4,0,0,0,0,0,0,0,0,0,0,0,0,0,0,0,0,0,0,4,0,4,4
20192020,093,OLDHAM,465,Oldham County,090,South Oldham Middle School,465090,093465090,210453001433,OVEC,906,06,135,169,5,4,9,0,0,0,1,3,4,10,13,23,0,0,0,9,6,15,144,109,253,304
20192020,093,OLDHAM,465,Oldham County,090,South Oldham Middle School,465090,093465090,210453001433,OVEC,906,08,143,119,3,2,5,1,0,1,1,4,5,9,12,21,1,0,1,5,5,10,99,120,219,262
20192020,093,OLDHAM,465,Oldham County,095,South Oldham High School,465095,093465095,210453001620,OVEC,906,12,126,137,9,3,12,0,0,0,0,6,6,5,5,10,0,0,0,6,4,10,117,108,225,263
20192020,093,OLDHAM,465,Oldham County,095,South Oldham High School,465095,093465095,210453001620,OVEC,906,All Students,551,500,24,21,45,0,0,0,6,21,27,29,26,55,0,0,0,19,17,36,422,466,888,1051
20192020,093,OLDHAM,465,Oldham County,095,South Oldham High School,465095,093465095,210453001620,OVEC,906,09,139,113,6,5,11,0,0,0,2,6,8,6,8,14,0,0,0,6,4,10,93,116,209,252
20192020,093,OLDHAM,465,Oldham County,095,South Oldham High School,465095,093465095,210453001620,OVEC,906,10,150,129,3,6,9,0,0,0,1,4,5,11,7,18,0,0,0,2,4,6,112,129,241,279
20192020,093,OLDHAM,465,Oldham County,095,South Oldham High School,465095,093465095,210453001620,OVEC,906,11,136,119,6,7,13,0,0,0,3,5,8,7,6,13,0,0,0,5,5,10,98,113,211,255
20192020,093,OLDHAM,465,Oldham County,095,South Oldham High School,465095,093465095,210453001620,OVEC,906,14,0,2,0,0,0,0,0,0,0,0,0,0,0,0,0,0,0,0,0,0,2,0,2,2
20192020,093,OLDHAM,465,Oldham County,100,Oldham County Preschool,465100,093465100,210453000736,OVEC,906,All Students,0,0,0,0,0,0,0,0,0,0,0,0,0,0,0,0,0,0,0,0,0,0,0,0
20192020,093,OLDHAM,465,Oldham County,100,Oldham County Preschool,465100,093465100,210453000736,OVEC,906,PS,103,152,5,5,10,0,0,0,0,1,1,14,13,27,0,0,0,10,4,14,123,80,203,255
20192020,093,OLDHAM,465,Oldham County,350,North Oldham Middle School,465350,093465350,210453001552,OVEC,906,07,112,131,2,0,2,1,0,1,6,7,13,3,9,12,0,0,0,5,5,10,114,91,205,243
20192020,093,OLDHAM,465,Oldham County,350,North Oldham Middle School,465350,093465350,210453001552,OVEC,906,All Students,376,387,4,4,8,1,0,1,20,17,37,13,25,38,1,0,1,12,14,26,336,316,652,763
20192020,093,OLDHAM,465,Oldham County,350,North Oldham Middle School,465350,093465350,210453001552,OVEC,906,06,135,127,1,3,4,0,0,0,9,7,16,7,8,15,1,0,1,3,4,7,106,113,219,262
20192020,093,OLDHAM,465,Oldham County,350,North Oldham Middle School,465350,093465350,210453001552,OVEC,906,08,129,129,1,1,2,0,0,0,5,3,8,3,8,11,0,0,0,4,5,9,116,112,228,258
20192020,093,OLDHAM,465,Oldham County,905,The Robert L. Arvin Education Center,465905,093465905,210453001818,OVEC,906,11,61,129,1,2,3,0,0,0,5,1,6,11,4,15,0,0,0,0,1,1,112,53,165,190
20192020,093,OLDHAM,465,Oldham County,905,The Robert L. Arvin Education Center,465905,093465905,210453001818,OVEC,906,All Students,300,482,8,7,15,1,0,1,18,11,29,25,14,39,0,0,0,16,8,24,414,260,674,782
20192020,093,OLDHAM,465,Oldham County,905,The Robert L. Arvin Education Center,465905,093465905,210453001818,OVEC,906,14,5,10,1,0,1,0,0,0,1,0,1,0,0,0,0,0,0,1,0,1,7,5,12,15
20192020,093,OLDHAM,465,Oldham County,905,The Robert L. Arvin Education Center,465905,093465905,210453001818,OVEC,906,09,113,137,4,1,5,1,0,1,5,4,9,1,5,6,0,0,0,4,2,6,122,101,223,250
20192020,093,OLDHAM,465,Oldham County,905,The Robert L. Arvin Education Center,465905,093465905,210453001818,OVEC,906,10,62,119,0,0,0,0,0,0,5,3,8,7,0,7,0,0,0,7,2,9,100,57,157,181
20192020,093,OLDHAM,465,Oldham County,905,The Robert L. Arvin Education Center,465905,093465905,210453001818,OVEC,906,12,59,87,2,4,6,0,0,0,2,3,5,6,5,11,0,0,0,4,3,7,73,44,117,146
20192020,094,OWEN,471,Owen County,"",---District Total---,471,"","",OVEC,906,03,54,57,0,0,0,0,0,0,0,0,0,3,2,5,1,0,1,0,0,0,53,52,105,111
20192020,094,OWEN,471,Owen County,"",---District Total---,471,"","",OVEC,906,All Students,905,893,2,3,5,1,1,2,1,7,8,44,44,88,1,0,1,16,15,31,828,835,1663,1798
20192020,094,OWEN,471,Owen County,"",---District Total---,471,"","",OVEC,906,PS,31,57,0,1,1,0,0,0,0,0,0,1,0,1,0,0,0,2,0,2,54,30,84,88
20192020,094,OWEN,471,Owen County,"",---District Total---,471,"","",OVEC,906,KG,61,75,0,0,0,1,0,1,0,0,0,4,2,6,0,0,0,0,0,0,70,59,129,136
20192020,094,OWEN,471,Owen County,"",---District Total---,471,"","",OVEC,906,01,55,65,0,1,1,0,0,0,0,0,0,2,3,5,0,0,0,0,0,0,63,51,114,120
20192020,094,OWEN,471,Owen County,"",---District Total---,471,"","",OVEC,906,02,71,58,0,1,1,0,0,0,0,0,0,2,3,5,0,0,0,0,1,1,56,66,122,129
20192020,094,OWEN,471,Owen County,"",---District Total---,471,"","",OVEC,906,04,55,71,1,0,1,0,0,0,0,1,1,4,2,6,0,0,0,2,1,3,64,51,115,126
20192020,094,OWEN,471,Owen County,"",---District Total---,471,"","",OVEC,906,05,66,83,0,1,1,0,0,0,0,0,0,4,4,8,0,0,0,2,1,3,77,60,137,149
20192020,094,OWEN,471,Owen County,"",---District Total---,471,"","",OVEC,906,06,82,72,1,0,1,0,0,0,0,0,0,5,2,7,0,0,0,0,3,3,66,77,143,154
20192020,094,OWEN,471,Owen County,"",---District Total---,471,"","",OVEC,906,07,82,83,0,0,0,0,1,1,0,1,1,7,6,13,0,0,0,2,3,5,74,71,145,165
20192020,094,OWEN,471,Owen County,"",---District Total---,471,"","",OVEC,906,08,73,72,0,0,0,0,0,0,0,1,1,2,4,6,0,0,0,3,1,4,67,67,134,145
20192020,094,OWEN,471,Owen County,"",---District Total---,471,"","",OVEC,906,09,71,64,0,0,0,0,0,0,0,2,2,3,3,6,0,0,0,2,1,3,59,65,124,135
20192020,094,OWEN,471,Owen County,"",---District Total---,471,"","",OVEC,906,10,86,71,0,0,0,0,0,0,0,2,2,2,6,8,0,0,0,0,1,1,69,77,146,157
20192020,094,OWEN,471,Owen County,"",---District Total---,471,"","",OVEC,906,11,63,54,0,0,0,0,0,0,1,0,1,3,3,6,0,0,0,1,2,3,49,58,107,117
20192020,094,OWEN,471,Owen County,"",---District Total---,471,"","",OVEC,906,12,86,68,0,0,0,0,0,0,0,0,0,3,4,7,0,0,0,4,1,5,61,81,142,154
20192020,094,OWEN,471,Owen County,075,Owen County Elementary/Primary School,471075,094471075,210456001127,OVEC,906,04,55,71,1,0,1,0,0,0,0,1,1,4,2,6,0,0,0,2,1,3,64,51,115,126
20192020,094,OWEN,471,Owen County,075,Owen County Elementary/Primary School,471075,094471075,210456001127,OVEC,906,All Students,296,326,1,2,3,1,0,1,0,1,1,15,12,27,1,0,1,2,2,4,306,279,585,622
20192020,094,OWEN,471,Owen County,075,Owen County Elementary/Primary School,471075,094471075,210456001127,OVEC,906,PS,31,57,0,1,1,0,0,0,0,0,0,1,0,1,0,0,0,2,0,2,54,30,84,88
20192020,094,OWEN,471,Owen County,075,Owen County Elementary/Primary School,471075,094471075,210456001127,OVEC,906,KG,61,75,0,0,0,1,0,1,0,0,0,4,2,6,0,0,0,0,0,0,70,59,129,136
20192020,094,OWEN,471,Owen County,075,Owen County Elementary/Primary School,471075,094471075,210456001127,OVEC,906,01,55,65,0,1,1,0,0,0,0,0,0,2,3,5,0,0,0,0,0,0,63,51,114,120
20192020,094,OWEN,471,Owen County,075,Owen County Elementary/Primary School,471075,094471075,210456001127,OVEC,906,02,71,58,0,1,1,0,0,0,0,0,0,2,3,5,0,0,0,0,1,1,56,66,122,129
20192020,094,OWEN,471,Owen County,075,Owen County Elementary/Primary School,471075,094471075,210456001127,OVEC,906,03,54,57,0,0,0,0,0,0,0,0,0,3,2,5,1,0,1,0,0,0,53,52,105,111
20192020,094,OWEN,471,Owen County,078,Maurice Bowling Middle School,471078,094471078,210456001539,OVEC,906,07,82,83,0,0,0,0,1,1,0,1,1,7,6,13,0,0,0,2,3,5,74,71,145,165
20192020,094,OWEN,471,Owen County,078,Maurice Bowling Middle School,471078,094471078,210456001539,OVEC,906,All Students,303,310,1,1,2,0,1,1,0,2,2,18,16,34,0,0,0,7,8,15,284,275,559,613
20192020,094,OWEN,471,Owen County,078,Maurice Bowling Middle School,471078,094471078,210456001539,OVEC,906,05,66,83,0,1,1,0,0,0,0,0,0,4,4,8,0,0,0,2,1,3,77,60,137,149
20192020,094,OWEN,471,Owen County,078,Maurice Bowling Middle School,471078,094471078,210456001539,OVEC,906,06,82,72,1,0,1,0,0,0,0,0,0,5,2,7,0,0,0,0,3,3,66,77,143,154
20192020,094,OWEN,471,Owen County,078,Maurice Bowling Middle School,471078,094471078,210456001539,OVEC,906,08,73,72,0,0,0,0,0,0,0,1,1,2,4,6,0,0,0,3,1,4,67,67,134,145
20192020,094,OWEN,471,Owen County,080,Owen County High School,471080,094471080,210456001128,OVEC,906,11,63,54,0,0,0,0,0,0,1,0,1,3,3,6,0,0,0,1,2,3,49,58,107,117
20192020,094,OWEN,471,Owen County,080,Owen County High School,471080,094471080,210456001128,OVEC,906,All Students,306,257,0,0,0,0,0,0,1,4,5,11,16,27,0,0,0,7,5,12,238,281,519,563
20192020,094,OWEN,471,Owen County,080,Owen County High School,471080,094471080,210456001128,OVEC,906,09,71,64,0,0,0,0,0,0,0,2,2,3,3,6,0,0,0,2,1,3,59,65,124,135
20192020,094,OWEN,471,Owen County,080,Owen County High School,471080,094471080,210456001128,OVEC,906,10,86,71,0,0,0,0,0,0,0,2,2,2,6,8,0,0,0,0,1,1,69,77,146,157
20192020,094,OWEN,471,Owen County,080,Owen County High School,471080,094471080,210456001128,OVEC,906,12,86,68,0,0,0,0,0,0,0,0,0,3,4,7,0,0,0,4,1,5,61,81,142,154
20192020,030,DAVIESS,472,Owensboro Independent,"",---District Total---,472,"","",GRREC,902,12,186,180,15,29,44,0,0,0,1,9,10,13,15,28,0,0,0,17,13,30,134,120,254,366
20192020,030,DAVIESS,472,Owensboro Independent,"",---District Total---,472,"","",GRREC,902,All Students,2400,2611,326,290,616,1,6,7,70,65,135,302,262,564,2,3,5,292,281,573,1618,1493,3111,5011
20192020,030,DAVIESS,472,Owensboro Independent,"",---District Total---,472,"","",GRREC,902,PS,95,106,21,23,44,0,0,0,2,2,4,11,10,21,0,0,0,12,20,32,60,40,100,201
20192020,030,DAVIESS,472,Owensboro Independent,"",---District Total---,472,"","",GRREC,902,KG,210,195,21,31,52,0,2,2,8,2,10,30,11,41,0,0,0,23,25,48,113,139,252,405
20192020,030,DAVIESS,472,Owensboro Independent,"",---District Total---,472,"","",GRREC,902,01,207,240,20,19,39,1,0,1,13,3,16,27,28,55,1,0,1,32,29,61,146,128,274,447
20192020,030,DAVIESS,472,Owensboro Independent,"",---District Total---,472,"","",GRREC,902,02,173,220,29,13,42,0,0,0,6,7,13,25,21,46,0,1,1,20,22,42,140,109,249,393
20192020,030,DAVIESS,472,Owensboro Independent,"",---District Total---,472,"","",GRREC,902,03,177,213,23,25,48,0,1,1,8,4,12,26,26,52,0,0,0,23,22,45,133,99,232,390
20192020,030,DAVIESS,472,Owensboro Independent,"",---District Total---,472,"","",GRREC,902,04,181,182,21,21,42,0,0,0,5,5,10,22,27,49,0,0,0,20,21,41,114,107,221,363
20192020,030,DAVIESS,472,Owensboro Independent,"",---District Total---,472,"","",GRREC,902,05,189,211,20,20,40,0,1,1,3,2,5,38,25,63,0,0,0,27,25,52,123,116,239,400
20192020,030,DAVIESS,472,Owensboro Independent,"",---District Total---,472,"","",GRREC,902,06,138,215,28,15,43,0,0,0,4,5,9,19,19,38,0,0,0,34,17,51,130,82,212,353
20192020,030,DAVIESS,472,Owensboro Independent,"",---District Total---,472,"","",GRREC,902,07,214,196,33,28,61,0,1,1,3,4,7,21,22,43,0,0,0,24,28,52,115,131,246,410
20192020,030,DAVIESS,472,Owensboro Independent,"",---District Total---,472,"","",GRREC,902,08,175,182,27,33,60,0,1,1,5,4,9,23,17,40,0,0,0,20,22,42,107,98,205,357
20192020,030,DAVIESS,472,Owensboro Independent,"",---District Total---,472,"","",GRREC,902,09,188,206,33,21,54,0,0,0,3,7,10,23,19,42,1,0,1,24,16,40,122,125,247,394
20192020,030,DAVIESS,472,Owensboro Independent,"",---District Total---,472,"","",GRREC,902,10,178,176,25,19,44,0,0,0,6,6,12,19,19,38,0,0,0,17,18,35,109,116,225,354
20192020,030,DAVIESS,472,Owensboro Independent,"",---District Total---,472,"","",GRREC,902,11,181,192,31,16,47,0,0,0,5,7,12,16,13,29,0,2,2,11,23,34,129,120,249,373
20192020,030,DAVIESS,472,Owensboro Independent,"",---District Total---,472,"","",GRREC,902,14,3,3,0,0,0,0,0,0,0,0,0,0,0,0,0,0,0,0,0,0,3,3,6,6
20192020,030,DAVIESS,472,Owensboro Independent,010,Cravens Elementary School,472010,030472010,210459001129,GRREC,902,04,21,36,9,3,12,0,0,0,0,0,0,6,5,11,0,0,0,5,4,9,16,9,25,57
20192020,030,DAVIESS,472,Owensboro Independent,010,Cravens Elementary School,472010,030472010,210459001129,GRREC,902,All Students,165,185,39,28,67,1,1,2,0,0,0,25,22,47,1,0,1,21,26,47,98,88,186,350
20192020,030,DAVIESS,472,Owensboro Independent,010,Cravens Elementary School,472010,030472010,210459001129,GRREC,902,KG,32,29,5,10,15,0,0,0,0,0,0,4,3,7,0,0,0,5,5,10,15,14,29,61
20192020,030,DAVIESS,472,Owensboro Independent,010,Cravens Elementary School,472010,030472010,210459001129,GRREC,902,01,35,32,3,2,5,1,0,1,0,0,0,2,3,5,1,0,1,3,8,11,22,22,44,67
20192020,030,DAVIESS,472,Owensboro Independent,010,Cravens Elementary School,472010,030472010,210459001129,GRREC,902,02,23,31,10,2,12,0,0,0,0,0,0,5,2,7,0,0,0,2,3,5,14,16,30,54
20192020,030,DAVIESS,472,Owensboro Independent,010,Cravens Elementary School,472010,030472010,210459001129,GRREC,902,03,18,24,4,3,7,0,0,0,0,0,0,2,3,5,0,0,0,3,2,5,15,10,25,42
20192020,030,DAVIESS,472,Owensboro Independent,010,Cravens Elementary School,472010,030472010,210459001129,GRREC,902,05,36,33,8,8,16,0,1,1,0,0,0,6,6,12,0,0,0,3,4,7,16,17,33,69
20192020,030,DAVIESS,472,Owensboro Independent,015,Emerson Academy,472015,030472015,210459002011,GRREC,902,All Students,36,41,11,6,17,0,0,0,0,0,0,3,4,7,0,0,0,5,4,9,22,22,44,77
20192020,030,DAVIESS,472,Owensboro Independent,015,Emerson Academy,472015,030472015,210459002011,GRREC,902,09,4,4,1,0,1,0,0,0,0,0,0,0,1,1,0,0,0,0,0,0,3,3,6,8
20192020,030,DAVIESS,472,Owensboro Independent,015,Emerson Academy,472015,030472015,210459002011,GRREC,902,10,6,9,3,1,4,0,0,0,0,0,0,0,2,2,0,0,0,1,2,3,5,1,6,15
20192020,030,DAVIESS,472,Owensboro Independent,015,Emerson Academy,472015,030472015,210459002011,GRREC,902,11,9,12,3,2,5,0,0,0,0,0,0,1,1,2,0,0,0,1,2,3,7,4,11,21
20192020,030,DAVIESS,472,Owensboro Independent,015,Emerson Academy,472015,030472015,210459002011,GRREC,902,12,17,16,4,3,7,0,0,0,0,0,0,2,0,2,0,0,0,3,0,3,7,14,21,33
20192020,030,DAVIESS,472,Owensboro Independent,030,Estes Elementary School,472030,030472030,210459001130,GRREC,902,05,41,44,2,4,6,0,0,0,0,0,0,13,10,23,0,0,0,6,9,15,23,18,41,85
20192020,030,DAVIESS,472,Owensboro Independent,030,Estes Elementary School,472030,030472030,210459001130,GRREC,902,PS,9,11,1,2,3,0,0,0,0,0,0,4,3,7,0,0,0,0,2,2,6,2,8,20
20192020,030,DAVIESS,472,Owensboro Independent,030,Estes Elementary School,472030,030472030,210459001130,GRREC,902,All Students,264,280,24,24,48,0,2,2,2,0,2,77,64,141,0,0,0,38,41,79,139,133,272,544
20192020,030,DAVIESS,472,Owensboro Independent,030,Estes Elementary School,472030,030472030,210459001130,GRREC,902,KG,53,47,4,6,10,0,1,1,1,0,1,14,6,20,0,0,0,5,10,15,23,30,53,100
20192020,030,DAVIESS,472,Owensboro Independent,030,Estes Elementary School,472030,030472030,210459001130,GRREC,902,01,43,57,6,2,8,0,0,0,0,0,0,18,14,32,0,0,0,13,6,19,20,21,41,100
20192020,030,DAVIESS,472,Owensboro Independent,030,Estes Elementary School,472030,030472030,210459001130,GRREC,902,02,36,43,5,4,9,0,0,0,0,0,0,8,11,19,0,0,0,7,4,11,23,17,40,79
20192020,030,DAVIESS,472,Owensboro Independent,030,Estes Elementary School,472030,030472030,210459001130,GRREC,902,03,47,52,4,3,7,0,1,1,1,0,1,14,13,27,0,0,0,5,7,12,28,23,51,99
20192020,030,DAVIESS,472,Owensboro Independent,030,Estes Elementary School,472030,030472030,210459001130,GRREC,902,04,44,37,3,5,8,0,0,0,0,0,0,10,10,20,0,0,0,2,5,7,22,24,46,81
20192020,030,DAVIESS,472,Owensboro Independent,060,Foust Elementary School,472060,030472060,210459001132,GRREC,902,04,33,30,6,5,11,0,0,0,4,5,9,3,8,11,0,0,0,4,5,9,13,10,23,63
20192020,030,DAVIESS,472,Owensboro Independent,060,Foust Elementary School,472060,030472060,210459001132,GRREC,902,All Students,212,224,38,40,78,0,0,0,34,21,55,31,31,62,0,1,1,35,26,61,86,93,179,436
20192020,030,DAVIESS,472,Owensboro Independent,060,Foust Elementary School,472060,030472060,210459001132,GRREC,902,KG,27,38,9,9,18,0,0,0,5,2,7,7,1,8,0,0,0,5,0,5,12,15,27,65
20192020,030,DAVIESS,472,Owensboro Independent,060,Foust Elementary School,472060,030472060,210459001132,GRREC,902,01,51,41,3,11,14,0,0,0,12,3,15,3,7,10,0,0,0,7,9,16,16,21,37,92
20192020,030,DAVIESS,472,Owensboro Independent,060,Foust Elementary School,472060,030472060,210459001132,GRREC,902,02,36,38,8,3,11,0,0,0,5,6,11,3,4,7,0,1,1,6,6,12,16,16,32,74
20192020,030,DAVIESS,472,Owensboro Independent,060,Foust Elementary School,472060,030472060,210459001132,GRREC,902,03,33,43,9,6,15,0,0,0,5,3,8,6,6,12,0,0,0,7,2,9,16,16,32,76
20192020,030,DAVIESS,472,Owensboro Independent,060,Foust Elementary School,472060,030472060,210459001132,GRREC,902,05,32,34,3,6,9,0,0,0,3,2,5,9,5,14,0,0,0,6,4,10,13,15,28,66
20192020,030,DAVIESS,472,Owensboro Independent,100,Newton Parrish Elementary School,472100,030472100,210459001135,GRREC,902,04,41,43,2,3,5,0,0,0,1,0,1,2,2,4,0,0,0,6,7,13,32,29,61,84
20192020,030,DAVIESS,472,Owensboro Independent,100,Newton Parrish Elementary School,472100,030472100,210459001135,GRREC,902,All Students,253,308,20,21,41,0,0,0,4,2,6,21,13,34,0,0,0,36,35,71,227,182,409,561
20192020,030,DAVIESS,472,Owensboro Independent,100,Newton Parrish Elementary School,472100,030472100,210459001135,GRREC,902,KG,56,48,1,5,6,0,0,0,2,0,2,4,1,5,0,0,0,7,7,14,34,43,77,104
20192020,030,DAVIESS,472,Owensboro Independent,100,Newton Parrish Elementary School,472100,030472100,210459001135,GRREC,902,01,37,57,5,3,8,0,0,0,0,0,0,2,2,4,0,0,0,5,3,8,45,29,74,94
20192020,030,DAVIESS,472,Owensboro Independent,100,Newton Parrish Elementary School,472100,030472100,210459001135,GRREC,902,02,43,53,3,1,4,0,0,0,0,1,1,6,3,9,0,0,0,4,7,11,40,31,71,96
20192020,030,DAVIESS,472,Owensboro Independent,100,Newton Parrish Elementary School,472100,030472100,210459001135,GRREC,902,03,41,51,5,7,12,0,0,0,1,1,2,3,3,6,0,0,0,5,7,12,37,23,60,92
20192020,030,DAVIESS,472,Owensboro Independent,100,Newton Parrish Elementary School,472100,030472100,210459001135,GRREC,902,05,35,56,4,2,6,0,0,0,0,0,0,4,2,6,0,0,0,9,4,13,39,27,66,91
20192020,030,DAVIESS,472,Owensboro Independent,102,Owensboro Innovation Middle School,472102,030472102,210459002304,GRREC,902,07,66,47,5,3,8,0,1,1,1,2,3,6,7,13,0,0,0,6,5,11,29,48,77,113
20192020,030,DAVIESS,472,Owensboro Independent,102,Owensboro Innovation Middle School,472102,030472102,210459002304,GRREC,902,All Students,125,148,11,8,19,0,1,1,2,6,8,18,13,31,0,0,0,19,12,31,98,85,183,273
20192020,030,DAVIESS,472,Owensboro Independent,102,Owensboro Innovation Middle School,472102,030472102,210459002304,GRREC,902,06,47,77,6,5,11,0,0,0,1,2,3,11,5,16,0,0,0,9,5,14,50,30,80,124
20192020,030,DAVIESS,472,Owensboro Independent,102,Owensboro Innovation Middle School,472102,030472102,210459002304,GRREC,902,08,12,24,0,0,0,0,0,0,0,2,2,1,1,2,0,0,0,4,2,6,19,7,26,36
20192020,030,DAVIESS,472,Owensboro Independent,108,Owensboro Middle School,472108,030472108,210459002305,GRREC,902,06,91,138,22,10,32,0,0,0,3,3,6,8,14,22,0,0,0,25,12,37,80,52,132,229
20192020,030,DAVIESS,472,Owensboro Independent,108,Owensboro Middle School,472108,030472108,210459002305,GRREC,902,08,163,158,27,33,60,0,1,1,5,2,7,22,16,38,0,0,0,16,20,36,88,91,179,321
20192020,030,DAVIESS,472,Owensboro Independent,108,Owensboro Middle School,472108,030472108,210459002305,GRREC,902,All Students,404,449,78,68,146,0,1,1,10,7,17,46,45,91,0,0,0,60,56,116,255,227,482,853
20192020,030,DAVIESS,472,Owensboro Independent,108,Owensboro Middle School,472108,030472108,210459002305,GRREC,902,05,2,4,1,0,1,0,0,0,0,0,0,1,0,1,0,0,0,1,1,2,1,1,2,6
20192020,030,DAVIESS,472,Owensboro Independent,108,Owensboro Middle School,472108,030472108,210459002305,GRREC,902,07,148,149,28,25,53,0,0,0,2,2,4,15,15,30,0,0,0,18,23,41,86,83,169,297
20192020,030,DAVIESS,472,Owensboro Independent,110,Owensboro High School,472110,030472110,210459001136,GRREC,902,10,145,130,19,17,36,0,0,0,6,5,11,17,14,31,0,0,0,15,14,29,73,95,168,275
20192020,030,DAVIESS,472,Owensboro Independent,110,Owensboro High School,472110,030472110,210459001136,GRREC,902,14,3,3,0,0,0,0,0,0,0,0,0,0,0,0,0,0,0,0,0,0,3,3,6,6
20192020,030,DAVIESS,472,Owensboro Independent,110,Owensboro High School,472110,030472110,210459001136,GRREC,902,12,151,131,11,26,37,0,0,0,1,7,8,10,15,25,0,0,0,13,12,25,96,91,187,282
20192020,030,DAVIESS,472,Owensboro Independent,110,Owensboro High School,472110,030472110,210459001136,GRREC,902,All Students,591,559,85,72,157,0,0,0,15,25,40,62,56,118,1,2,3,58,59,117,338,377,715,1150
20192020,030,DAVIESS,472,Owensboro Independent,110,Owensboro High School,472110,030472110,210459001136,GRREC,902,09,157,160,30,19,49,0,0,0,3,7,10,21,15,36,1,0,1,21,14,35,84,102,186,317
20192020,030,DAVIESS,472,Owensboro Independent,110,Owensboro High School,472110,030472110,210459001136,GRREC,902,11,135,135,25,10,35,0,0,0,5,6,11,14,12,26,0,2,2,9,19,28,82,86,168,270
20192020,030,DAVIESS,472,Owensboro Independent,116,Owensboro Innovation Academy,472116,030472116,210459002411,GRREC,902,11,37,45,3,4,7,0,0,0,0,1,1,1,0,1,0,0,0,1,2,3,40,30,70,82
20192020,030,DAVIESS,472,Owensboro Independent,116,Owensboro Innovation Academy,472116,030472116,210459002411,GRREC,902,All Students,109,157,8,7,15,0,0,0,0,4,4,6,6,12,0,0,0,6,7,13,137,85,222,266
20192020,030,DAVIESS,472,Owensboro Independent,116,Owensboro Innovation Academy,472116,030472116,210459002411,GRREC,902,09,27,42,2,2,4,0,0,0,0,0,0,2,3,5,0,0,0,3,2,5,35,20,55,69
20192020,030,DAVIESS,472,Owensboro Independent,116,Owensboro Innovation Academy,472116,030472116,210459002411,GRREC,902,10,27,37,3,1,4,0,0,0,0,1,1,2,3,5,0,0,0,1,2,3,31,20,51,64
20192020,030,DAVIESS,472,Owensboro Independent,116,Owensboro Innovation Academy,472116,030472116,210459002411,GRREC,902,12,18,33,0,0,0,0,0,0,0,2,2,1,0,1,0,0,0,1,1,2,31,15,46,51
20192020,030,DAVIESS,472,Owensboro Independent,140,Sutton Elementary School,472140,030472140,210459001139,GRREC,902,05,43,40,2,0,2,0,0,0,0,0,0,5,2,7,0,0,0,2,3,5,31,38,69,83
20192020,030,DAVIESS,472,Owensboro Independent,140,Sutton Elementary School,472140,030472140,210459001139,GRREC,902,All Students,241,260,12,16,28,0,1,1,3,0,3,13,8,21,0,0,0,14,15,29,218,201,419,501
20192020,030,DAVIESS,472,Owensboro Independent,140,Sutton Elementary School,472140,030472140,210459001139,GRREC,902,KG,42,33,2,1,3,0,1,1,0,0,0,1,0,1,0,0,0,1,3,4,29,37,66,75
20192020,030,DAVIESS,472,Owensboro Independent,140,Sutton Elementary School,472140,030472140,210459001139,GRREC,902,01,41,53,3,1,4,0,0,0,1,0,1,2,2,4,0,0,0,4,3,7,43,35,78,94
20192020,030,DAVIESS,472,Owensboro Independent,140,Sutton Elementary School,472140,030472140,210459001139,GRREC,902,02,35,55,3,3,6,0,0,0,1,0,1,3,1,4,0,0,0,1,2,3,47,29,76,90
20192020,030,DAVIESS,472,Owensboro Independent,140,Sutton Elementary School,472140,030472140,210459001139,GRREC,902,03,38,43,1,6,7,0,0,0,1,0,1,1,1,2,0,0,0,3,4,7,37,27,64,81
20192020,030,DAVIESS,472,Owensboro Independent,140,Sutton Elementary School,472140,030472140,210459001139,GRREC,902,04,42,36,1,5,6,0,0,0,0,0,0,1,2,3,0,0,0,3,0,3,31,35,66,78
20192020,030,DAVIESS,472,Owensboro Independent,180,Hager Preschool,472180,030472180,210459001685,GRREC,902,All Students,0,0,0,0,0,0,0,0,0,0,0,0,0,0,0,0,0,0,0,0,0,0,0,0
20192020,030,DAVIESS,472,Owensboro Independent,180,Hager Preschool,472180,030472180,210459001685,GRREC,902,PS,86,95,20,21,41,0,0,0,2,2,4,7,7,14,0,0,0,12,18,30,54,38,92,181
20192020,095,OWSLEY,475,Owsley County,"",---District Total---,475,"","",KVEC,904,All Students,333,369,0,1,1,0,0,0,0,0,0,10,3,13,0,0,0,0,3,3,359,326,685,702
20192020,095,OWSLEY,475,Owsley County,"",---District Total---,475,"","",KVEC,904,PS,72,80,0,0,0,0,0,0,0,0,0,0,0,0,0,0,0,1,1,2,79,71,150,152
20192020,095,OWSLEY,475,Owsley County,"",---District Total---,475,"","",KVEC,904,KG,29,40,0,0,0,0,0,0,0,0,0,3,1,4,0,0,0,0,0,0,37,28,65,69
20192020,095,OWSLEY,475,Owsley County,"",---District Total---,475,"","",KVEC,904,01,29,16,0,0,0,0,0,0,0,0,0,1,0,1,0,0,0,0,1,1,15,28,43,45
20192020,095,OWSLEY,475,Owsley County,"",---District Total---,475,"","",KVEC,904,02,18,15,0,0,0,0,0,0,0,0,0,0,1,1,0,0,0,0,0,0,15,17,32,33
20192020,095,OWSLEY,475,Owsley County,"",---District Total---,475,"","",KVEC,904,03,19,22,0,0,0,0,0,0,0,0,0,1,0,1,0,0,0,0,0,0,21,19,40,41
20192020,095,OWSLEY,475,Owsley County,"",---District Total---,475,"","",KVEC,904,04,26,31,0,0,0,0,0,0,0,0,0,0,0,0,0,0,0,0,0,0,31,26,57,57
20192020,095,OWSLEY,475,Owsley County,"",---District Total---,475,"","",KVEC,904,05,27,31,0,0,0,0,0,0,0,0,0,1,0,1,0,0,0,0,0,0,30,27,57,58
20192020,095,OWSLEY,475,Owsley County,"",---District Total---,475,"","",KVEC,904,06,26,28,0,0,0,0,0,0,0,0,0,1,0,1,0,0,0,0,1,1,27,25,52,54
20192020,095,OWSLEY,475,Owsley County,"",---District Total---,475,"","",KVEC,904,07,24,34,0,0,0,0,0,0,0,0,0,1,1,2,0,0,0,0,0,0,33,23,56,58
20192020,095,OWSLEY,475,Owsley County,"",---District Total---,475,"","",KVEC,904,08,30,37,0,0,0,0,0,0,0,0,0,0,0,0,0,0,0,0,0,0,37,30,67,67
20192020,095,OWSLEY,475,Owsley County,"",---District Total---,475,"","",KVEC,904,09,32,35,0,0,0,0,0,0,0,0,0,2,0,2,0,0,0,0,0,0,33,32,65,67
20192020,095,OWSLEY,475,Owsley County,"",---District Total---,475,"","",KVEC,904,10,18,28,0,1,1,0,0,0,0,0,0,0,0,0,0,0,0,0,0,0,28,17,45,46
20192020,095,OWSLEY,475,Owsley County,"",---District Total---,475,"","",KVEC,904,11,24,29,0,0,0,0,0,0,0,0,0,0,0,0,0,0,0,0,1,1,29,23,52,53
20192020,095,OWSLEY,475,Owsley County,"",---District Total---,475,"","",KVEC,904,12,31,22,0,0,0,0,0,0,0,0,0,0,0,0,0,0,0,0,0,0,22,31,53,53
20192020,095,OWSLEY,475,Owsley County,"",---District Total---,475,"","",KVEC,904,14,0,1,0,0,0,0,0,0,0,0,0,0,0,0,0,0,0,0,0,0,1,0,1,1
20192020,095,OWSLEY,475,Owsley County,020,Owsley County Elementary School,475020,095475020,210462001142,KVEC,904,05,27,31,0,0,0,0,0,0,0,0,0,1,0,1,0,0,0,0,0,0,30,27,57,58
20192020,095,OWSLEY,475,Owsley County,020,Owsley County Elementary School,475020,095475020,210462001142,KVEC,904,All Students,148,155,0,0,0,0,0,0,0,0,0,6,2,8,0,0,0,0,1,1,149,145,294,303
20192020,095,OWSLEY,475,Owsley County,020,Owsley County Elementary School,475020,095475020,210462001142,KVEC,904,PS,72,80,0,0,0,0,0,0,0,0,0,0,0,0,0,0,0,1,1,2,79,71,150,152
20192020,095,OWSLEY,475,Owsley County,020,Owsley County Elementary School,475020,095475020,210462001142,KVEC,904,KG,29,40,0,0,0,0,0,0,0,0,0,3,1,4,0,0,0,0,0,0,37,28,65,69
20192020,095,OWSLEY,475,Owsley County,020,Owsley County Elementary School,475020,095475020,210462001142,KVEC,904,01,29,16,0,0,0,0,0,0,0,0,0,1,0,1,0,0,0,0,1,1,15,28,43,45
20192020,095,OWSLEY,475,Owsley County,020,Owsley County Elementary School,475020,095475020,210462001142,KVEC,904,02,18,15,0,0,0,0,0,0,0,0,0,0,1,1,0,0,0,0,0,0,15,17,32,33
20192020,095,OWSLEY,475,Owsley County,020,Owsley County Elementary School,475020,095475020,210462001142,KVEC,904,03,19,22,0,0,0,0,0,0,0,0,0,1,0,1,0,0,0,0,0,0,21,19,40,41
20192020,095,OWSLEY,475,Owsley County,020,Owsley County Elementary School,475020,095475020,210462001142,KVEC,904,04,26,31,0,0,0,0,0,0,0,0,0,0,0,0,0,0,0,0,0,0,31,26,57,57
20192020,095,OWSLEY,475,Owsley County,080,Owsley County High School,475080,095475080,210462001143,KVEC,904,12,31,22,0,0,0,0,0,0,0,0,0,0,0,0,0,0,0,0,0,0,22,31,53,53
20192020,095,OWSLEY,475,Owsley County,080,Owsley County High School,475080,095475080,210462001143,KVEC,904,11,24,29,0,0,0,0,0,0,0,0,0,0,0,0,0,0,0,0,1,1,29,23,52,53
20192020,095,OWSLEY,475,Owsley County,080,Owsley County High School,475080,095475080,210462001143,KVEC,904,14,0,1,0,0,0,0,0,0,0,0,0,0,0,0,0,0,0,0,0,0,1,0,1,1
20192020,095,OWSLEY,475,Owsley County,080,Owsley County High School,475080,095475080,210462001143,KVEC,904,All Students,185,214,0,1,1,0,0,0,0,0,0,4,1,5,0,0,0,0,2,2,210,181,391,399
20192020,095,OWSLEY,475,Owsley County,080,Owsley County High School,475080,095475080,210462001143,KVEC,904,06,26,28,0,0,0,0,0,0,0,0,0,1,0,1,0,0,0,0,1,1,27,25,52,54
20192020,095,OWSLEY,475,Owsley County,080,Owsley County High School,475080,095475080,210462001143,KVEC,904,07,24,34,0,0,0,0,0,0,0,0,0,1,1,2,0,0,0,0,0,0,33,23,56,58
20192020,095,OWSLEY,475,Owsley County,080,Owsley County High School,475080,095475080,210462001143,KVEC,904,08,30,37,0,0,0,0,0,0,0,0,0,0,0,0,0,0,0,0,0,0,37,30,67,67
20192020,095,OWSLEY,475,Owsley County,080,Owsley County High School,475080,095475080,210462001143,KVEC,904,09,32,35,0,0,0,0,0,0,0,0,0,2,0,2,0,0,0,0,0,0,33,32,65,67
20192020,095,OWSLEY,475,Owsley County,080,Owsley County High School,475080,095475080,210462001143,KVEC,904,10,18,28,0,1,1,0,0,0,0,0,0,0,0,0,0,0,0,0,0,0,28,17,45,46
20192020,079,MCCRACKEN,476,Paducah Independent,"",---District Total---,476,"","",WKEC,908,08,95,118,38,41,79,0,0,0,1,0,1,11,4,15,0,0,0,14,10,24,54,40,94,213
20192020,079,MCCRACKEN,476,Paducah Independent,"",---District Total---,476,"","",WKEC,908,All Students,1455,1510,562,586,1148,1,0,1,9,8,17,100,96,196,0,0,0,187,178,365,651,587,1238,2965
20192020,079,MCCRACKEN,476,Paducah Independent,"",---District Total---,476,"","",WKEC,908,PS,140,138,60,77,137,0,0,0,0,0,0,14,9,23,0,0,0,16,23,39,48,31,79,278
20192020,079,MCCRACKEN,476,Paducah Independent,"",---District Total---,476,"","",WKEC,908,KG,128,115,36,52,88,0,0,0,0,1,1,7,8,15,0,0,0,17,24,41,55,43,98,243
20192020,079,MCCRACKEN,476,Paducah Independent,"",---District Total---,476,"","",WKEC,908,01,137,113,44,48,92,0,0,0,1,1,2,7,12,19,0,0,0,13,23,36,48,53,101,250
20192020,079,MCCRACKEN,476,Paducah Independent,"",---District Total---,476,"","",WKEC,908,02,99,119,40,34,74,0,0,0,0,1,1,8,5,13,0,0,0,12,15,27,59,44,103,218
20192020,079,MCCRACKEN,476,Paducah Independent,"",---District Total---,476,"","",WKEC,908,03,106,124,54,46,100,0,0,0,1,0,1,8,6,14,0,0,0,7,16,23,54,38,92,230
20192020,079,MCCRACKEN,476,Paducah Independent,"",---District Total---,476,"","",WKEC,908,04,111,119,40,46,86,0,0,0,2,0,2,7,5,12,0,0,0,19,16,35,51,44,95,230
20192020,079,MCCRACKEN,476,Paducah Independent,"",---District Total---,476,"","",WKEC,908,05,111,111,40,41,81,0,0,0,0,1,1,6,10,16,0,0,0,17,13,30,48,46,94,222
20192020,079,MCCRACKEN,476,Paducah Independent,"",---District Total---,476,"","",WKEC,908,06,125,114,39,56,95,1,0,1,1,0,1,5,10,15,0,0,0,18,10,28,50,49,99,239
20192020,079,MCCRACKEN,476,Paducah Independent,"",---District Total---,476,"","",WKEC,908,07,109,119,57,41,98,0,0,0,0,1,1,7,8,15,0,0,0,11,13,24,44,46,90,228
20192020,079,MCCRACKEN,476,Paducah Independent,"",---District Total---,476,"","",WKEC,908,09,120,145,49,50,99,0,0,0,1,1,2,9,8,17,0,0,0,23,9,32,63,52,115,265
20192020,079,MCCRACKEN,476,Paducah Independent,"",---District Total---,476,"","",WKEC,908,10,109,112,42,46,88,0,0,0,0,2,2,7,8,15,0,0,0,11,11,22,52,42,94,221
20192020,079,MCCRACKEN,476,Paducah Independent,"",---District Total---,476,"","",WKEC,908,11,105,108,40,41,81,0,0,0,1,0,1,9,4,13,0,0,0,17,8,25,41,52,93,213
20192020,079,MCCRACKEN,476,Paducah Independent,"",---District Total---,476,"","",WKEC,908,12,98,93,43,44,87,0,0,0,1,0,1,9,8,17,0,0,0,8,10,18,32,36,68,191
20192020,079,MCCRACKEN,476,Paducah Independent,"",---District Total---,476,"","",WKEC,908,14,2,0,0,0,0,0,0,0,0,0,0,0,0,0,0,0,0,0,0,0,0,2,2,2
20192020,079,MCCRACKEN,476,Paducah Independent,010,Paducah Middle School,476010,079476010,210465001144,WKEC,908,06,124,110,37,55,92,1,0,1,1,0,1,5,10,15,0,0,0,18,10,28,48,49,97,234
20192020,079,MCCRACKEN,476,Paducah Independent,010,Paducah Middle School,476010,079476010,210465001144,WKEC,908,07,109,114,54,41,95,0,0,0,0,1,1,7,8,15,0,0,0,9,13,22,44,46,90,223
20192020,079,MCCRACKEN,476,Paducah Independent,010,Paducah Middle School,476010,079476010,210465001144,WKEC,908,08,92,115,36,39,75,0,0,0,1,0,1,11,4,15,0,0,0,14,10,24,53,39,92,207
20192020,079,MCCRACKEN,476,Paducah Independent,010,Paducah Middle School,476010,079476010,210465001144,WKEC,908,All Students,325,339,127,135,262,1,0,1,2,1,3,23,22,45,0,0,0,41,33,74,145,134,279,664
20192020,079,MCCRACKEN,476,Paducah Independent,015,Paducah Head Start Preschool,476015,079476015,210465001571,WKEC,908,All Students,0,0,0,0,0,0,0,0,0,0,0,0,0,0,0,0,0,0,0,0,0,0,0,0
20192020,079,MCCRACKEN,476,Paducah Independent,015,Paducah Head Start Preschool,476015,079476015,210465001571,WKEC,908,PS,140,138,60,77,137,0,0,0,0,0,0,14,9,23,0,0,0,16,23,39,48,31,79,278
20192020,079,MCCRACKEN,476,Paducah Independent,016,Choices Educational Center,476016,079476016,210465002364,WKEC,908,10,2,6,4,1,5,0,0,0,0,0,0,1,1,2,0,0,0,1,0,1,0,0,0,8
20192020,079,MCCRACKEN,476,Paducah Independent,016,Choices Educational Center,476016,079476016,210465002364,WKEC,908,12,8,5,5,6,11,0,0,0,0,0,0,0,0,0,0,0,0,0,0,0,0,2,2,13
20192020,079,MCCRACKEN,476,Paducah Independent,016,Choices Educational Center,476016,079476016,210465002364,WKEC,908,11,6,11,8,4,12,0,0,0,0,0,0,0,0,0,0,0,0,3,0,3,0,2,2,17
20192020,079,MCCRACKEN,476,Paducah Independent,016,Choices Educational Center,476016,079476016,210465002364,WKEC,908,All Students,30,46,31,22,53,0,0,0,0,0,0,1,1,2,0,0,0,8,0,8,6,7,13,76
20192020,079,MCCRACKEN,476,Paducah Independent,016,Choices Educational Center,476016,079476016,210465002364,WKEC,908,06,1,4,2,1,3,0,0,0,0,0,0,0,0,0,0,0,0,0,0,0,2,0,2,5
20192020,079,MCCRACKEN,476,Paducah Independent,016,Choices Educational Center,476016,079476016,210465002364,WKEC,908,07,0,5,3,0,3,0,0,0,0,0,0,0,0,0,0,0,0,2,0,2,0,0,0,5
20192020,079,MCCRACKEN,476,Paducah Independent,016,Choices Educational Center,476016,079476016,210465002364,WKEC,908,08,3,3,2,2,4,0,0,0,0,0,0,0,0,0,0,0,0,0,0,0,1,1,2,6
20192020,079,MCCRACKEN,476,Paducah Independent,016,Choices Educational Center,476016,079476016,210465002364,WKEC,908,09,10,12,7,8,15,0,0,0,0,0,0,0,0,0,0,0,0,2,0,2,3,2,5,22
20192020,079,MCCRACKEN,476,Paducah Independent,020,Clark Elementary School,476020,079476020,210465001146,WKEC,908,04,51,63,8,17,25,0,0,0,2,0,2,4,2,6,0,0,0,9,6,15,40,26,66,114
20192020,079,MCCRACKEN,476,Paducah Independent,020,Clark Elementary School,476020,079476020,210465001146,WKEC,908,All Students,318,317,64,78,142,0,0,0,4,4,8,14,20,34,0,0,0,32,38,70,203,178,381,635
20192020,079,MCCRACKEN,476,Paducah Independent,020,Clark Elementary School,476020,079476020,210465001146,WKEC,908,KG,62,47,7,19,26,0,0,0,0,1,1,1,6,7,0,0,0,6,8,14,33,28,61,109
20192020,079,MCCRACKEN,476,Paducah Independent,020,Clark Elementary School,476020,079476020,210465001146,WKEC,908,01,61,50,12,8,20,0,0,0,1,1,2,2,6,8,0,0,0,4,11,15,31,35,66,111
20192020,079,MCCRACKEN,476,Paducah Independent,020,Clark Elementary School,476020,079476020,210465001146,WKEC,908,02,52,59,10,9,19,0,0,0,0,1,1,3,3,6,0,0,0,6,5,11,40,34,74,111
20192020,079,MCCRACKEN,476,Paducah Independent,020,Clark Elementary School,476020,079476020,210465001146,WKEC,908,03,46,50,13,13,26,0,0,0,1,0,1,2,0,2,0,0,0,2,3,5,32,30,62,96
20192020,079,MCCRACKEN,476,Paducah Independent,020,Clark Elementary School,476020,079476020,210465001146,WKEC,908,05,46,48,14,12,26,0,0,0,0,1,1,2,3,5,0,0,0,5,5,10,27,25,52,94
20192020,079,MCCRACKEN,476,Paducah Independent,080,McNabb Elementary School,476080,079476080,210465001150,WKEC,908,03,30,39,24,20,44,0,0,0,0,0,0,3,2,5,0,0,0,3,5,8,9,3,12,69
20192020,079,MCCRACKEN,476,Paducah Independent,080,McNabb Elementary School,476080,079476080,210465001150,WKEC,908,All Students,195,193,116,121,237,0,0,0,0,0,0,13,12,25,0,0,0,23,29,52,41,33,74,388
20192020,079,MCCRACKEN,476,Paducah Independent,080,McNabb Elementary School,476080,079476080,210465001150,WKEC,908,05,28,36,20,16,36,0,0,0,0,0,0,2,4,6,0,0,0,7,3,10,7,5,12,64
20192020,079,MCCRACKEN,476,Paducah Independent,080,McNabb Elementary School,476080,079476080,210465001150,WKEC,908,KG,41,38,21,25,46,0,0,0,0,0,0,3,1,4,0,0,0,6,8,14,8,7,15,79
20192020,079,MCCRACKEN,476,Paducah Independent,080,McNabb Elementary School,476080,079476080,210465001150,WKEC,908,01,37,34,23,23,46,0,0,0,0,0,0,2,4,6,0,0,0,1,3,4,8,7,15,71
20192020,079,MCCRACKEN,476,Paducah Independent,080,McNabb Elementary School,476080,079476080,210465001150,WKEC,908,02,31,22,14,17,31,0,0,0,0,0,0,1,1,2,0,0,0,2,7,9,5,6,11,53
20192020,079,MCCRACKEN,476,Paducah Independent,080,McNabb Elementary School,476080,079476080,210465001150,WKEC,908,04,28,24,14,20,34,0,0,0,0,0,0,2,0,2,0,0,0,4,3,7,4,5,9,52
20192020,079,MCCRACKEN,476,Paducah Independent,150,Morgan Elementary School,476150,079476150,210465001152,WKEC,908,05,37,27,6,13,19,0,0,0,0,0,0,2,3,5,0,0,0,5,5,10,14,16,30,64
20192020,079,MCCRACKEN,476,Paducah Independent,150,Morgan Elementary School,476150,079476150,210465001152,WKEC,908,All Students,179,191,74,68,142,0,0,0,0,0,0,16,14,30,0,0,0,30,40,70,71,57,128,370
20192020,079,MCCRACKEN,476,Paducah Independent,150,Morgan Elementary School,476150,079476150,210465001152,WKEC,908,KG,25,30,8,8,16,0,0,0,0,0,0,3,1,4,0,0,0,5,8,13,14,8,22,55
20192020,079,MCCRACKEN,476,Paducah Independent,150,Morgan Elementary School,476150,079476150,210465001152,WKEC,908,01,39,29,9,17,26,0,0,0,0,0,0,3,2,5,0,0,0,8,9,17,9,11,20,68
20192020,079,MCCRACKEN,476,Paducah Independent,150,Morgan Elementary School,476150,079476150,210465001152,WKEC,908,02,16,38,16,8,24,0,0,0,0,0,0,4,1,5,0,0,0,4,3,7,14,4,18,54
20192020,079,MCCRACKEN,476,Paducah Independent,150,Morgan Elementary School,476150,079476150,210465001152,WKEC,908,03,30,35,17,13,30,0,0,0,0,0,0,3,4,7,0,0,0,2,8,10,13,5,18,65
20192020,079,MCCRACKEN,476,Paducah Independent,150,Morgan Elementary School,476150,079476150,210465001152,WKEC,908,04,32,32,18,9,27,0,0,0,0,0,0,1,3,4,0,0,0,6,7,13,7,13,20,64
20192020,079,MCCRACKEN,476,Paducah Independent,170,Paducah Tilghman High School,476170,079476170,210465001154,WKEC,908,10,107,106,38,45,83,0,0,0,0,2,2,6,7,13,0,0,0,10,11,21,52,42,94,213
20192020,079,MCCRACKEN,476,Paducah Independent,170,Paducah Tilghman High School,476170,079476170,210465001154,WKEC,908,11,99,97,32,37,69,0,0,0,1,0,1,9,4,13,0,0,0,14,8,22,41,50,91,196
20192020,079,MCCRACKEN,476,Paducah Independent,170,Paducah Tilghman High School,476170,079476170,210465001154,WKEC,908,12,90,88,38,38,76,0,0,0,1,0,1,9,8,17,0,0,0,8,10,18,32,34,66,178
20192020,079,MCCRACKEN,476,Paducah Independent,170,Paducah Tilghman High School,476170,079476170,210465001154,WKEC,908,14,2,0,0,0,0,0,0,0,0,0,0,0,0,0,0,0,0,0,0,0,0,2,2,2
20192020,079,MCCRACKEN,476,Paducah Independent,170,Paducah Tilghman High School,476170,079476170,210465001154,WKEC,908,All Students,408,424,150,162,312,0,0,0,3,3,6,33,27,60,0,0,0,53,38,91,185,178,363,832
20192020,079,MCCRACKEN,476,Paducah Independent,170,Paducah Tilghman High School,476170,079476170,210465001154,WKEC,908,09,110,133,42,42,84,0,0,0,1,1,2,9,8,17,0,0,0,21,9,30,60,50,110,243
20192020,058,JOHNSON,477,Paintsville Independent,"",---District Total---,477,"","",KEDC,903,03,28,36,0,0,0,0,0,0,3,0,3,0,0,0,0,0,0,0,1,1,33,27,60,64
20192020,058,JOHNSON,477,Paintsville Independent,"",---District Total---,477,"","",KEDC,903,04,26,29,1,0,1,0,0,0,0,0,0,0,0,0,0,0,0,0,0,0,28,26,54,55
20192020,058,JOHNSON,477,Paintsville Independent,"",---District Total---,477,"","",KEDC,903,05,23,34,0,0,0,0,0,0,0,2,2,1,0,1,0,0,0,0,0,0,33,21,54,57
20192020,058,JOHNSON,477,Paintsville Independent,"",---District Total---,477,"","",KEDC,903,06,20,28,1,0,1,0,0,0,0,1,1,1,0,1,0,0,0,0,0,0,26,19,45,48
20192020,058,JOHNSON,477,Paintsville Independent,"",---District Total---,477,"","",KEDC,903,07,25,25,0,0,0,0,0,0,0,1,1,0,0,0,0,0,0,0,1,1,25,23,48,50
20192020,058,JOHNSON,477,Paintsville Independent,"",---District Total---,477,"","",KEDC,903,08,26,27,0,0,0,0,0,0,2,0,2,1,0,1,0,0,0,0,1,1,24,25,49,53
20192020,058,JOHNSON,477,Paintsville Independent,"",---District Total---,477,"","",KEDC,903,09,30,32,0,0,0,0,0,0,0,0,0,0,0,0,0,0,0,0,0,0,32,30,62,62
20192020,058,JOHNSON,477,Paintsville Independent,"",---District Total---,477,"","",KEDC,903,10,16,35,1,0,1,0,0,0,2,0,2,0,0,0,0,0,0,0,0,0,32,16,48,51
20192020,058,JOHNSON,477,Paintsville Independent,"",---District Total---,477,"","",KEDC,903,12,27,20,0,0,0,0,0,0,0,1,1,0,0,0,0,0,0,1,0,1,19,26,45,47
20192020,058,JOHNSON,477,Paintsville Independent,"",---District Total---,477,"","",KEDC,903,11,20,27,0,0,0,0,0,0,0,0,0,1,0,1,0,0,0,0,0,0,26,20,46,47
20192020,058,JOHNSON,477,Paintsville Independent,"",---District Total---,477,"","",KEDC,903,All Students,336,397,3,2,5,0,0,0,9,7,16,7,3,10,0,0,0,1,4,5,377,320,697,733
20192020,058,JOHNSON,477,Paintsville Independent,"",---District Total---,477,"","",KEDC,903,PS,2,0,0,0,0,0,0,0,0,0,0,0,0,0,0,0,0,0,0,0,0,2,2,2
20192020,058,JOHNSON,477,Paintsville Independent,"",---District Total---,477,"","",KEDC,903,KG,34,37,0,1,1,0,0,0,1,0,1,2,1,3,0,0,0,0,1,1,34,31,65,71
20192020,058,JOHNSON,477,Paintsville Independent,"",---District Total---,477,"","",KEDC,903,01,29,26,0,0,0,0,0,0,1,0,1,0,2,2,0,0,0,0,0,0,25,27,52,55
20192020,058,JOHNSON,477,Paintsville Independent,"",---District Total---,477,"","",KEDC,903,02,32,41,0,1,1,0,0,0,0,2,2,1,0,1,0,0,0,0,0,0,40,29,69,73
20192020,058,JOHNSON,477,Paintsville Independent,010,Paintsville Elementary School,477010,058477010,210468001155,KEDC,903,05,23,34,0,0,0,0,0,0,0,2,2,1,0,1,0,0,0,0,0,0,33,21,54,57
20192020,058,JOHNSON,477,Paintsville Independent,010,Paintsville Elementary School,477010,058477010,210468001155,KEDC,903,All Students,192,231,2,2,4,0,0,0,5,5,10,5,3,8,0,0,0,0,2,2,219,180,399,423
20192020,058,JOHNSON,477,Paintsville Independent,010,Paintsville Elementary School,477010,058477010,210468001155,KEDC,903,PS,2,0,0,0,0,0,0,0,0,0,0,0,0,0,0,0,0,0,0,0,0,2,2,2
20192020,058,JOHNSON,477,Paintsville Independent,010,Paintsville Elementary School,477010,058477010,210468001155,KEDC,903,KG,34,37,0,1,1,0,0,0,1,0,1,2,1,3,0,0,0,0,1,1,34,31,65,71
20192020,058,JOHNSON,477,Paintsville Independent,010,Paintsville Elementary School,477010,058477010,210468001155,KEDC,903,01,29,26,0,0,0,0,0,0,1,0,1,0,2,2,0,0,0,0,0,0,25,27,52,55
20192020,058,JOHNSON,477,Paintsville Independent,010,Paintsville Elementary School,477010,058477010,210468001155,KEDC,903,02,32,41,0,1,1,0,0,0,0,2,2,1,0,1,0,0,0,0,0,0,40,29,69,73
20192020,058,JOHNSON,477,Paintsville Independent,010,Paintsville Elementary School,477010,058477010,210468001155,KEDC,903,03,28,36,0,0,0,0,0,0,3,0,3,0,0,0,0,0,0,0,1,1,33,27,60,64
20192020,058,JOHNSON,477,Paintsville Independent,010,Paintsville Elementary School,477010,058477010,210468001155,KEDC,903,04,26,29,1,0,1,0,0,0,0,0,0,0,0,0,0,0,0,0,0,0,28,26,54,55
20192020,058,JOHNSON,477,Paintsville Independent,010,Paintsville Elementary School,477010,058477010,210468001155,KEDC,903,06,20,28,1,0,1,0,0,0,0,1,1,1,0,1,0,0,0,0,0,0,26,19,45,48
20192020,058,JOHNSON,477,Paintsville Independent,020,Paintsville High School,477020,058477020,210468001156,KEDC,903,11,20,27,0,0,0,0,0,0,0,0,0,1,0,1,0,0,0,0,0,0,26,20,46,47
20192020,058,JOHNSON,477,Paintsville Independent,020,Paintsville High School,477020,058477020,210468001156,KEDC,903,All Students,144,166,1,0,1,0,0,0,4,2,6,2,0,2,0,0,0,1,2,3,158,140,298,310
20192020,058,JOHNSON,477,Paintsville Independent,020,Paintsville High School,477020,058477020,210468001156,KEDC,903,07,25,25,0,0,0,0,0,0,0,1,1,0,0,0,0,0,0,0,1,1,25,23,48,50
20192020,058,JOHNSON,477,Paintsville Independent,020,Paintsville High School,477020,058477020,210468001156,KEDC,903,08,26,27,0,0,0,0,0,0,2,0,2,1,0,1,0,0,0,0,1,1,24,25,49,53
20192020,058,JOHNSON,477,Paintsville Independent,020,Paintsville High School,477020,058477020,210468001156,KEDC,903,09,30,32,0,0,0,0,0,0,0,0,0,0,0,0,0,0,0,0,0,0,32,30,62,62
20192020,058,JOHNSON,477,Paintsville Independent,020,Paintsville High School,477020,058477020,210468001156,KEDC,903,10,16,35,1,0,1,0,0,0,2,0,2,0,0,0,0,0,0,0,0,0,32,16,48,51
20192020,058,JOHNSON,477,Paintsville Independent,020,Paintsville High School,477020,058477020,210468001156,KEDC,903,12,27,20,0,0,0,0,0,0,0,1,1,0,0,0,0,0,0,1,0,1,19,26,45,47
20192020,009,BOURBON,478,Paris Independent,"",---District Total---,478,"","",CKEC,901,06,21,27,6,1,7,0,0,0,0,0,0,2,7,9,0,0,0,4,5,9,15,8,23,48
20192020,009,BOURBON,478,Paris Independent,"",---District Total---,478,"","",CKEC,901,All Students,323,353,59,46,105,1,1,2,0,0,0,62,61,123,1,0,1,45,41,86,185,174,359,676
20192020,009,BOURBON,478,Paris Independent,"",---District Total---,478,"","",CKEC,901,PS,20,30,2,3,5,0,0,0,0,0,0,1,2,3,0,0,0,5,3,8,22,12,34,50
20192020,009,BOURBON,478,Paris Independent,"",---District Total---,478,"","",CKEC,901,KG,25,42,5,7,12,0,0,0,0,0,0,7,4,11,0,0,0,2,1,3,28,13,41,67
20192020,009,BOURBON,478,Paris Independent,"",---District Total---,478,"","",CKEC,901,01,22,29,4,1,5,0,0,0,0,0,0,3,7,10,1,0,1,4,2,6,17,12,29,51
20192020,009,BOURBON,478,Paris Independent,"",---District Total---,478,"","",CKEC,901,02,19,25,4,1,5,0,0,0,0,0,0,3,3,6,0,0,0,4,2,6,14,13,27,44
20192020,009,BOURBON,478,Paris Independent,"",---District Total---,478,"","",CKEC,901,03,23,29,5,3,8,0,0,0,0,0,0,7,3,10,0,0,0,5,5,10,12,12,24,52
20192020,009,BOURBON,478,Paris Independent,"",---District Total---,478,"","",CKEC,901,04,29,22,1,4,5,1,0,1,0,0,0,6,6,12,0,0,0,4,3,7,10,16,26,51
20192020,009,BOURBON,478,Paris Independent,"",---District Total---,478,"","",CKEC,901,05,33,18,2,2,4,0,0,0,0,0,0,4,10,14,0,0,0,6,4,10,6,17,23,51
20192020,009,BOURBON,478,Paris Independent,"",---District Total---,478,"","",CKEC,901,07,30,30,2,4,6,0,0,0,0,0,0,4,4,8,0,0,0,3,6,9,21,16,37,60
20192020,009,BOURBON,478,Paris Independent,"",---District Total---,478,"","",CKEC,901,08,23,26,3,1,4,0,0,0,0,0,0,6,3,9,0,0,0,5,0,5,12,19,31,49
20192020,009,BOURBON,478,Paris Independent,"",---District Total---,478,"","",CKEC,901,09,21,30,7,5,12,0,0,0,0,0,0,5,2,7,0,0,0,1,1,2,17,13,30,51
20192020,009,BOURBON,478,Paris Independent,"",---District Total---,478,"","",CKEC,901,10,27,35,10,3,13,0,1,1,0,0,0,5,5,10,0,0,0,4,6,10,16,12,28,62
20192020,009,BOURBON,478,Paris Independent,"",---District Total---,478,"","",CKEC,901,11,24,21,5,8,13,0,0,0,0,0,0,5,4,9,0,0,0,2,3,5,9,9,18,45
20192020,009,BOURBON,478,Paris Independent,"",---District Total---,478,"","",CKEC,901,12,26,19,5,6,11,0,0,0,0,0,0,5,3,8,0,0,0,1,3,4,8,14,22,45
20192020,009,BOURBON,478,Paris Independent,010,Paris Elementary School,478010,009478010,210471001157,CKEC,901,05,33,18,2,2,4,0,0,0,0,0,0,4,10,14,0,0,0,6,4,10,6,17,23,51
20192020,009,BOURBON,478,Paris Independent,010,Paris Elementary School,478010,009478010,210471001157,CKEC,901,All Students,151,165,21,18,39,1,0,1,0,0,0,30,33,63,1,0,1,25,17,42,87,83,170,316
20192020,009,BOURBON,478,Paris Independent,010,Paris Elementary School,478010,009478010,210471001157,CKEC,901,KG,25,42,5,7,12,0,0,0,0,0,0,7,4,11,0,0,0,2,1,3,28,13,41,67
20192020,009,BOURBON,478,Paris Independent,010,Paris Elementary School,478010,009478010,210471001157,CKEC,901,01,22,29,4,1,5,0,0,0,0,0,0,3,7,10,1,0,1,4,2,6,17,12,29,51
20192020,009,BOURBON,478,Paris Independent,010,Paris Elementary School,478010,009478010,210471001157,CKEC,901,02,19,25,4,1,5,0,0,0,0,0,0,3,3,6,0,0,0,4,2,6,14,13,27,44
20192020,009,BOURBON,478,Paris Independent,010,Paris Elementary School,478010,009478010,210471001157,CKEC,901,03,23,29,5,3,8,0,0,0,0,0,0,7,3,10,0,0,0,5,5,10,12,12,24,52
20192020,009,BOURBON,478,Paris Independent,010,Paris Elementary School,478010,009478010,210471001157,CKEC,901,04,29,22,1,4,5,1,0,1,0,0,0,6,6,12,0,0,0,4,3,7,10,16,26,51
20192020,009,BOURBON,478,Paris Independent,020,Paris High School,478020,009478020,210471001158,CKEC,901,11,24,21,5,8,13,0,0,0,0,0,0,5,4,9,0,0,0,2,3,5,9,9,18,45
20192020,009,BOURBON,478,Paris Independent,020,Paris High School,478020,009478020,210471001158,CKEC,901,All Students,98,105,27,22,49,0,1,1,0,0,0,20,14,34,0,0,0,8,13,21,50,48,98,203
20192020,009,BOURBON,478,Paris Independent,020,Paris High School,478020,009478020,210471001158,CKEC,901,09,21,30,7,5,12,0,0,0,0,0,0,5,2,7,0,0,0,1,1,2,17,13,30,51
20192020,009,BOURBON,478,Paris Independent,020,Paris High School,478020,009478020,210471001158,CKEC,901,10,27,35,10,3,13,0,1,1,0,0,0,5,5,10,0,0,0,4,6,10,16,12,28,62
20192020,009,BOURBON,478,Paris Independent,020,Paris High School,478020,009478020,210471001158,CKEC,901,12,26,19,5,6,11,0,0,0,0,0,0,5,3,8,0,0,0,1,3,4,8,14,22,45
20192020,009,BOURBON,478,Paris Independent,030,Paris Middle School,478030,009478030,210471001159,CKEC,901,07,30,30,2,4,6,0,0,0,0,0,0,4,4,8,0,0,0,3,6,9,21,16,37,60
20192020,009,BOURBON,478,Paris Independent,030,Paris Middle School,478030,009478030,210471001159,CKEC,901,All Students,74,83,11,6,17,0,0,0,0,0,0,12,14,26,0,0,0,12,11,23,48,43,91,157
20192020,009,BOURBON,478,Paris Independent,030,Paris Middle School,478030,009478030,210471001159,CKEC,901,06,21,27,6,1,7,0,0,0,0,0,0,2,7,9,0,0,0,4,5,9,15,8,23,48
20192020,009,BOURBON,478,Paris Independent,030,Paris Middle School,478030,009478030,210471001159,CKEC,901,08,23,26,3,1,4,0,0,0,0,0,0,6,3,9,0,0,0,5,0,5,12,19,31,49
20192020,009,BOURBON,478,Paris Independent,040,Paris Preschool Center,478040,009478040,210471002226,CKEC,901,All Students,0,0,0,0,0,0,0,0,0,0,0,0,0,0,0,0,0,0,0,0,0,0,0,0
20192020,009,BOURBON,478,Paris Independent,040,Paris Preschool Center,478040,009478040,210471002226,CKEC,901,PS,20,30,2,3,5,0,0,0,0,0,0,1,2,3,0,0,0,5,3,8,22,12,34,50
20192020,096,PENDLETON,481,Pendleton County,"",---District Total---,481,"","",NKCES,905,04,69,85,0,1,1,0,0,0,0,0,0,0,1,1,0,0,0,2,0,2,83,67,150,154
20192020,096,PENDLETON,481,Pendleton County,"",---District Total---,481,"","",NKCES,905,All Students,1057,1198,12,14,26,1,1,2,2,7,9,15,13,28,0,0,0,22,30,52,1146,992,2138,2255
20192020,096,PENDLETON,481,Pendleton County,"",---District Total---,481,"","",NKCES,905,PS,59,74,0,0,0,0,0,0,1,0,1,0,0,0,0,0,0,3,4,7,70,55,125,133
20192020,096,PENDLETON,481,Pendleton County,"",---District Total---,481,"","",NKCES,905,KG,76,79,0,1,1,0,0,0,0,0,0,3,2,5,0,0,0,3,4,7,73,69,142,155
20192020,096,PENDLETON,481,Pendleton County,"",---District Total---,481,"","",NKCES,905,01,90,82,0,2,2,0,0,0,1,1,2,0,2,2,0,0,0,0,2,2,81,83,164,172
20192020,096,PENDLETON,481,Pendleton County,"",---District Total---,481,"","",NKCES,905,02,56,81,2,1,3,0,0,0,0,0,0,0,0,0,0,0,0,0,3,3,79,52,131,137
20192020,096,PENDLETON,481,Pendleton County,"",---District Total---,481,"","",NKCES,905,03,72,95,1,0,1,0,0,0,0,1,1,2,1,3,0,0,0,2,4,6,90,66,156,167
20192020,096,PENDLETON,481,Pendleton County,"",---District Total---,481,"","",NKCES,905,05,91,109,1,1,2,0,0,0,0,0,0,0,0,0,0,0,0,4,3,7,104,87,191,200
20192020,096,PENDLETON,481,Pendleton County,"",---District Total---,481,"","",NKCES,905,06,92,94,0,1,1,0,0,0,0,0,0,1,2,3,0,0,0,0,1,1,93,88,181,186
20192020,096,PENDLETON,481,Pendleton County,"",---District Total---,481,"","",NKCES,905,07,84,94,2,1,3,0,0,0,1,0,1,1,3,4,0,0,0,1,3,4,89,77,166,178
20192020,096,PENDLETON,481,Pendleton County,"",---District Total---,481,"","",NKCES,905,08,84,98,1,0,1,0,0,0,0,0,0,0,0,0,0,0,0,2,1,3,95,83,178,182
20192020,096,PENDLETON,481,Pendleton County,"",---District Total---,481,"","",NKCES,905,09,88,96,2,4,6,0,0,0,0,1,1,2,1,3,0,0,0,2,3,5,90,79,169,184
20192020,096,PENDLETON,481,Pendleton County,"",---District Total---,481,"","",NKCES,905,10,83,96,1,1,2,1,0,1,0,1,1,1,0,1,0,0,0,2,1,3,91,80,171,179
20192020,096,PENDLETON,481,Pendleton County,"",---District Total---,481,"","",NKCES,905,11,61,95,1,0,1,0,0,0,0,1,1,3,0,3,0,0,0,3,2,5,88,58,146,156
20192020,096,PENDLETON,481,Pendleton County,"",---District Total---,481,"","",NKCES,905,12,111,94,1,1,2,0,1,1,0,2,2,2,1,3,0,0,0,1,3,4,90,103,193,205
20192020,096,PENDLETON,481,Pendleton County,060,Northern Elementary School,481060,096481060,210474001160,NKCES,905,04,27,41,0,1,1,0,0,0,0,0,0,0,0,0,0,0,0,2,0,2,39,26,65,68
20192020,096,PENDLETON,481,Pendleton County,060,Northern Elementary School,481060,096481060,210474001160,NKCES,905,02,20,44,0,0,0,0,0,0,0,0,0,0,0,0,0,0,0,0,1,1,44,19,63,64
20192020,096,PENDLETON,481,Pendleton County,060,Northern Elementary School,481060,096481060,210474001160,NKCES,905,All Students,197,277,1,1,2,0,0,0,0,1,1,3,3,6,0,0,0,8,4,12,265,188,453,474
20192020,096,PENDLETON,481,Pendleton County,060,Northern Elementary School,481060,096481060,210474001160,NKCES,905,03,39,50,1,0,1,0,0,0,0,1,1,1,1,2,0,0,0,1,1,2,47,36,83,89
20192020,096,PENDLETON,481,Pendleton County,060,Northern Elementary School,481060,096481060,210474001160,NKCES,905,PS,24,33,0,0,0,0,0,0,0,0,0,0,0,0,0,0,0,2,1,3,31,23,54,57
20192020,096,PENDLETON,481,Pendleton County,060,Northern Elementary School,481060,096481060,210474001160,NKCES,905,KG,32,39,0,0,0,0,0,0,0,0,0,2,1,3,0,0,0,2,1,3,35,30,65,71
20192020,096,PENDLETON,481,Pendleton County,060,Northern Elementary School,481060,096481060,210474001160,NKCES,905,01,31,40,0,0,0,0,0,0,0,0,0,0,1,1,0,0,0,0,1,1,40,29,69,71
20192020,096,PENDLETON,481,Pendleton County,060,Northern Elementary School,481060,096481060,210474001160,NKCES,905,05,48,63,0,0,0,0,0,0,0,0,0,0,0,0,0,0,0,3,0,3,60,48,108,111
20192020,096,PENDLETON,481,Pendleton County,061,Phillip Sharp Middle School,481061,096481061,210474001646,NKCES,905,08,84,98,1,0,1,0,0,0,0,0,0,0,0,0,0,0,0,2,1,3,95,83,178,182
20192020,096,PENDLETON,481,Pendleton County,061,Phillip Sharp Middle School,481061,096481061,210474001646,NKCES,905,All Students,260,286,3,2,5,0,0,0,1,0,1,2,5,7,0,0,0,3,5,8,277,248,525,546
20192020,096,PENDLETON,481,Pendleton County,061,Phillip Sharp Middle School,481061,096481061,210474001646,NKCES,905,06,92,94,0,1,1,0,0,0,0,0,0,1,2,3,0,0,0,0,1,1,93,88,181,186
20192020,096,PENDLETON,481,Pendleton County,061,Phillip Sharp Middle School,481061,096481061,210474001646,NKCES,905,07,84,94,2,1,3,0,0,0,1,0,1,1,3,4,0,0,0,1,3,4,89,77,166,178
20192020,096,PENDLETON,481,Pendleton County,070,Pendleton County High School,481070,096481070,210474001161,NKCES,905,10,83,96,1,1,2,1,0,1,0,1,1,1,0,1,0,0,0,2,1,3,91,80,171,179
20192020,096,PENDLETON,481,Pendleton County,070,Pendleton County High School,481070,096481070,210474001161,NKCES,905,11,61,95,1,0,1,0,0,0,0,1,1,3,0,3,0,0,0,3,2,5,88,58,146,156
20192020,096,PENDLETON,481,Pendleton County,070,Pendleton County High School,481070,096481070,210474001161,NKCES,905,12,111,94,1,1,2,0,1,1,0,2,2,2,1,3,0,0,0,1,3,4,90,103,193,205
20192020,096,PENDLETON,481,Pendleton County,070,Pendleton County High School,481070,096481070,210474001161,NKCES,905,All Students,343,381,5,6,11,1,1,2,0,5,5,8,2,10,0,0,0,8,9,17,359,320,679,724
20192020,096,PENDLETON,481,Pendleton County,070,Pendleton County High School,481070,096481070,210474001161,NKCES,905,09,88,96,2,4,6,0,0,0,0,1,1,2,1,3,0,0,0,2,3,5,90,79,169,184
20192020,096,PENDLETON,481,Pendleton County,080,Southern Elementary School,481080,096481080,210474001163,NKCES,905,KG,44,40,0,1,1,0,0,0,0,0,0,1,1,2,0,0,0,1,3,4,38,39,77,84
20192020,096,PENDLETON,481,Pendleton County,080,Southern Elementary School,481080,096481080,210474001163,NKCES,905,01,59,42,0,2,2,0,0,0,1,1,2,0,1,1,0,0,0,0,1,1,41,54,95,101
20192020,096,PENDLETON,481,Pendleton County,080,Southern Elementary School,481080,096481080,210474001163,NKCES,905,02,36,37,2,1,3,0,0,0,0,0,0,0,0,0,0,0,0,0,2,2,35,33,68,73
20192020,096,PENDLETON,481,Pendleton County,080,Southern Elementary School,481080,096481080,210474001163,NKCES,905,03,33,45,0,0,0,0,0,0,0,0,0,1,0,1,0,0,0,1,3,4,43,30,73,78
20192020,096,PENDLETON,481,Pendleton County,080,Southern Elementary School,481080,096481080,210474001163,NKCES,905,04,42,44,0,0,0,0,0,0,0,0,0,0,1,1,0,0,0,0,0,0,44,41,85,86
20192020,096,PENDLETON,481,Pendleton County,080,Southern Elementary School,481080,096481080,210474001163,NKCES,905,05,43,46,1,1,2,0,0,0,0,0,0,0,0,0,0,0,0,1,3,4,44,39,83,89
20192020,096,PENDLETON,481,Pendleton County,080,Southern Elementary School,481080,096481080,210474001163,NKCES,905,All Students,257,254,3,5,8,0,0,0,1,1,2,2,3,5,0,0,0,3,12,15,245,236,481,511
20192020,096,PENDLETON,481,Pendleton County,080,Southern Elementary School,481080,096481080,210474001163,NKCES,905,PS,35,41,0,0,0,0,0,0,1,0,1,0,0,0,0,0,0,1,3,4,39,32,71,76
20192020,097,PERRY,485,Perry County,"",---District Total---,485,"","",KVEC,904,10,128,139,0,0,0,0,0,0,0,1,1,1,0,1,0,0,0,1,2,3,137,125,262,267
20192020,097,PERRY,485,Perry County,"",---District Total---,485,"","",KVEC,904,11,127,114,3,5,8,0,0,0,0,0,0,0,2,2,0,0,0,4,3,7,107,117,224,241
20192020,097,PERRY,485,Perry County,"",---District Total---,485,"","",KVEC,904,14,0,5,0,0,0,0,0,0,0,0,0,1,0,1,0,0,0,0,0,0,4,0,4,5
20192020,097,PERRY,485,Perry County,"",---District Total---,485,"","",KVEC,904,12,109,127,3,3,6,0,0,0,0,0,0,1,0,1,0,0,0,1,0,1,122,106,228,236
20192020,097,PERRY,485,Perry County,"",---District Total---,485,"","",KVEC,904,All Students,1781,1907,18,17,35,1,1,2,6,9,15,24,26,50,0,2,2,26,19,45,1832,1707,3539,3688
20192020,097,PERRY,485,Perry County,"",---District Total---,485,"","",KVEC,904,PS,117,179,1,1,2,2,0,2,0,0,0,4,3,7,0,0,0,2,2,4,170,111,281,296
20192020,097,PERRY,485,Perry County,"",---District Total---,485,"","",KVEC,904,KG,130,130,0,0,0,0,0,0,0,0,0,1,2,3,0,0,0,1,1,2,128,127,255,260
20192020,097,PERRY,485,Perry County,"",---District Total---,485,"","",KVEC,904,01,156,183,1,0,1,0,0,0,1,0,1,4,3,7,0,0,0,4,1,5,173,152,325,339
20192020,097,PERRY,485,Perry County,"",---District Total---,485,"","",KVEC,904,02,131,142,0,1,1,1,0,1,2,0,2,1,4,5,0,0,0,2,2,4,136,124,260,273
20192020,097,PERRY,485,Perry County,"",---District Total---,485,"","",KVEC,904,03,132,156,0,0,0,0,1,1,0,2,2,1,3,4,0,1,1,1,2,3,154,123,277,288
20192020,097,PERRY,485,Perry County,"",---District Total---,485,"","",KVEC,904,04,128,157,1,1,2,0,0,0,2,1,3,2,0,2,0,0,0,2,1,3,150,125,275,285
20192020,097,PERRY,485,Perry County,"",---District Total---,485,"","",KVEC,904,05,168,167,1,1,2,0,0,0,0,0,0,1,2,3,0,0,0,3,1,4,162,164,326,335
20192020,097,PERRY,485,Perry County,"",---District Total---,485,"","",KVEC,904,06,150,133,2,1,3,0,0,0,1,2,3,2,3,5,0,1,1,1,1,2,127,142,269,283
20192020,097,PERRY,485,Perry County,"",---District Total---,485,"","",KVEC,904,07,142,134,0,0,0,0,0,0,0,1,1,1,4,5,0,0,0,1,3,4,132,134,266,276
20192020,097,PERRY,485,Perry County,"",---District Total---,485,"","",KVEC,904,08,146,167,2,4,6,0,0,0,0,1,1,3,3,6,0,0,0,3,1,4,159,137,296,313
20192020,097,PERRY,485,Perry County,"",---District Total---,485,"","",KVEC,904,09,134,153,5,1,6,0,0,0,0,1,1,5,0,5,0,0,0,2,1,3,141,131,272,287
20192020,097,PERRY,485,Perry County,010,Buckhorn Childrens Center,485010,097485010,210477002422,KVEC,904,11,5,0,0,2,2,0,0,0,0,0,0,0,1,1,0,0,0,0,1,1,0,1,1,5
20192020,097,PERRY,485,Perry County,010,Buckhorn Childrens Center,485010,097485010,210477002422,KVEC,904,All Students,27,0,0,4,4,0,0,0,0,0,0,0,1,1,0,0,0,0,1,1,0,21,21,27
20192020,097,PERRY,485,Perry County,010,Buckhorn Childrens Center,485010,097485010,210477002422,KVEC,904,05,1,0,0,0,0,0,0,0,0,0,0,0,0,0,0,0,0,0,0,0,0,1,1,1
20192020,097,PERRY,485,Perry County,010,Buckhorn Childrens Center,485010,097485010,210477002422,KVEC,904,06,1,0,0,0,0,0,0,0,0,0,0,0,0,0,0,0,0,0,0,0,0,1,1,1
20192020,097,PERRY,485,Perry County,010,Buckhorn Childrens Center,485010,097485010,210477002422,KVEC,904,07,2,0,0,0,0,0,0,0,0,0,0,0,0,0,0,0,0,0,0,0,0,2,2,2
20192020,097,PERRY,485,Perry County,010,Buckhorn Childrens Center,485010,097485010,210477002422,KVEC,904,08,7,0,0,1,1,0,0,0,0,0,0,0,0,0,0,0,0,0,0,0,0,6,6,7
20192020,097,PERRY,485,Perry County,010,Buckhorn Childrens Center,485010,097485010,210477002422,KVEC,904,09,6,0,0,1,1,0,0,0,0,0,0,0,0,0,0,0,0,0,0,0,0,5,5,6
20192020,097,PERRY,485,Perry County,010,Buckhorn Childrens Center,485010,097485010,210477002422,KVEC,904,10,4,0,0,0,0,0,0,0,0,0,0,0,0,0,0,0,0,0,0,0,0,4,4,4
20192020,097,PERRY,485,Perry County,010,Buckhorn Childrens Center,485010,097485010,210477002422,KVEC,904,12,1,0,0,0,0,0,0,0,0,0,0,0,0,0,0,0,0,0,0,0,0,1,1,1
20192020,097,PERRY,485,Perry County,130,Buckhorn School,485130,097485130,210477001166,KVEC,904,11,14,16,0,0,0,0,0,0,0,0,0,0,1,1,0,0,0,0,0,0,16,13,29,30
20192020,097,PERRY,485,Perry County,130,Buckhorn School,485130,097485130,210477001166,KVEC,904,All Students,171,153,1,1,2,1,0,1,0,0,0,0,5,5,0,0,0,1,2,3,150,163,313,324
20192020,097,PERRY,485,Perry County,130,Buckhorn School,485130,097485130,210477001166,KVEC,904,KG,12,12,0,0,0,0,0,0,0,0,0,0,0,0,0,0,0,0,0,0,12,12,24,24
20192020,097,PERRY,485,Perry County,130,Buckhorn School,485130,097485130,210477001166,KVEC,904,01,13,10,0,0,0,0,0,0,0,0,0,0,0,0,0,0,0,0,0,0,10,13,23,23
20192020,097,PERRY,485,Perry County,130,Buckhorn School,485130,097485130,210477001166,KVEC,904,02,9,5,0,0,0,1,0,1,0,0,0,0,0,0,0,0,0,0,0,0,4,9,13,14
20192020,097,PERRY,485,Perry County,130,Buckhorn School,485130,097485130,210477001166,KVEC,904,03,8,16,0,0,0,0,0,0,0,0,0,0,0,0,0,0,0,0,0,0,16,8,24,24
20192020,097,PERRY,485,Perry County,130,Buckhorn School,485130,097485130,210477001166,KVEC,904,04,8,9,0,0,0,0,0,0,0,0,0,0,0,0,0,0,0,0,0,0,9,8,17,17
20192020,097,PERRY,485,Perry County,130,Buckhorn School,485130,097485130,210477001166,KVEC,904,05,7,13,0,0,0,0,0,0,0,0,0,0,1,1,0,0,0,0,0,0,13,6,19,20
20192020,097,PERRY,485,Perry County,130,Buckhorn School,485130,097485130,210477001166,KVEC,904,06,10,7,0,0,0,0,0,0,0,0,0,0,0,0,0,0,0,0,0,0,7,10,17,17
20192020,097,PERRY,485,Perry County,130,Buckhorn School,485130,097485130,210477001166,KVEC,904,07,13,7,0,0,0,0,0,0,0,0,0,0,1,1,0,0,0,0,0,0,7,12,19,20
20192020,097,PERRY,485,Perry County,130,Buckhorn School,485130,097485130,210477001166,KVEC,904,08,18,14,0,0,0,0,0,0,0,0,0,0,2,2,0,0,0,0,0,0,14,16,30,32
20192020,097,PERRY,485,Perry County,130,Buckhorn School,485130,097485130,210477001166,KVEC,904,09,21,18,1,0,1,0,0,0,0,0,0,0,0,0,0,0,0,1,1,2,16,20,36,39
20192020,097,PERRY,485,Perry County,130,Buckhorn School,485130,097485130,210477001166,KVEC,904,10,21,13,0,0,0,0,0,0,0,0,0,0,0,0,0,0,0,0,1,1,13,20,33,34
20192020,097,PERRY,485,Perry County,130,Buckhorn School,485130,097485130,210477001166,KVEC,904,12,17,13,0,1,1,0,0,0,0,0,0,0,0,0,0,0,0,0,0,0,13,16,29,30
20192020,097,PERRY,485,Perry County,140,Learning Academy,485140,097485140,210477002398,KVEC,904,All Students,7,28,2,1,3,0,0,0,0,0,0,2,0,2,0,0,0,2,0,2,22,6,28,35
20192020,097,PERRY,485,Perry County,140,Learning Academy,485140,097485140,210477002398,KVEC,904,09,3,6,2,0,2,0,0,0,0,0,0,0,0,0,0,0,0,0,0,0,4,3,7,9
20192020,097,PERRY,485,Perry County,140,Learning Academy,485140,097485140,210477002398,KVEC,904,10,0,6,0,0,0,0,0,0,0,0,0,0,0,0,0,0,0,0,0,0,6,0,6,6
20192020,097,PERRY,485,Perry County,140,Learning Academy,485140,097485140,210477002398,KVEC,904,11,3,6,0,0,0,0,0,0,0,0,0,0,0,0,0,0,0,1,0,1,5,3,8,9
20192020,097,PERRY,485,Perry County,140,Learning Academy,485140,097485140,210477002398,KVEC,904,12,1,8,0,1,1,0,0,0,0,0,0,1,0,1,0,0,0,1,0,1,6,0,6,9
20192020,097,PERRY,485,Perry County,140,Learning Academy,485140,097485140,210477002398,KVEC,904,14,0,2,0,0,0,0,0,0,0,0,0,1,0,1,0,0,0,0,0,0,1,0,1,2
20192020,097,PERRY,485,Perry County,190,Perry County Alternative School,485190,097485190,210477002387,KVEC,904,08,0,1,0,0,0,0,0,0,0,0,0,0,0,0,0,0,0,0,0,0,1,0,1,1
20192020,097,PERRY,485,Perry County,190,Perry County Alternative School,485190,097485190,210477002387,KVEC,904,07,0,5,0,0,0,0,0,0,0,0,0,0,0,0,0,0,0,0,0,0,5,0,5,5
20192020,097,PERRY,485,Perry County,190,Perry County Alternative School,485190,097485190,210477002387,KVEC,904,All Students,0,11,0,0,0,0,0,0,0,0,0,0,0,0,0,0,0,0,0,0,11,0,11,11
20192020,097,PERRY,485,Perry County,190,Perry County Alternative School,485190,097485190,210477002387,KVEC,904,01,0,2,0,0,0,0,0,0,0,0,0,0,0,0,0,0,0,0,0,0,2,0,2,2
20192020,097,PERRY,485,Perry County,190,Perry County Alternative School,485190,097485190,210477002387,KVEC,904,03,0,1,0,0,0,0,0,0,0,0,0,0,0,0,0,0,0,0,0,0,1,0,1,1
20192020,097,PERRY,485,Perry County,190,Perry County Alternative School,485190,097485190,210477002387,KVEC,904,04,0,1,0,0,0,0,0,0,0,0,0,0,0,0,0,0,0,0,0,0,1,0,1,1
20192020,097,PERRY,485,Perry County,190,Perry County Alternative School,485190,097485190,210477002387,KVEC,904,06,0,1,0,0,0,0,0,0,0,0,0,0,0,0,0,0,0,0,0,0,1,0,1,1
20192020,097,PERRY,485,Perry County,200,East Perry County Elementary School,485200,097485200,210477002354,KVEC,904,07,40,40,0,0,0,0,0,0,0,0,0,0,1,1,0,0,0,1,2,3,39,37,76,80
20192020,097,PERRY,485,Perry County,200,East Perry County Elementary School,485200,097485200,210477002354,KVEC,904,All Students,326,386,2,2,4,0,0,0,2,1,3,6,6,12,0,0,0,11,4,15,365,313,678,712
20192020,097,PERRY,485,Perry County,200,East Perry County Elementary School,485200,097485200,210477002354,KVEC,904,PS,40,65,0,0,0,0,0,0,0,0,0,1,2,3,0,0,0,1,2,3,63,36,99,105
20192020,097,PERRY,485,Perry County,200,East Perry County Elementary School,485200,097485200,210477002354,KVEC,904,KG,34,33,0,0,0,0,0,0,0,0,0,0,0,0,0,0,0,0,0,0,33,34,67,67
20192020,097,PERRY,485,Perry County,200,East Perry County Elementary School,485200,097485200,210477002354,KVEC,904,01,44,54,0,0,0,0,0,0,0,0,0,3,2,5,0,0,0,3,0,3,48,42,90,98
20192020,097,PERRY,485,Perry County,200,East Perry County Elementary School,485200,097485200,210477002354,KVEC,904,02,30,36,0,0,0,0,0,0,1,0,1,0,2,2,0,0,0,1,0,1,34,28,62,66
20192020,097,PERRY,485,Perry County,200,East Perry County Elementary School,485200,097485200,210477002354,KVEC,904,03,36,49,0,0,0,0,0,0,0,1,1,1,0,1,0,0,0,1,1,2,47,34,81,85
20192020,097,PERRY,485,Perry County,200,East Perry County Elementary School,485200,097485200,210477002354,KVEC,904,04,26,61,1,0,1,0,0,0,1,0,1,2,0,2,0,0,0,1,0,1,56,26,82,87
20192020,097,PERRY,485,Perry County,200,East Perry County Elementary School,485200,097485200,210477002354,KVEC,904,05,44,41,0,0,0,0,0,0,0,0,0,0,0,0,0,0,0,2,0,2,39,44,83,85
20192020,097,PERRY,485,Perry County,200,East Perry County Elementary School,485200,097485200,210477002354,KVEC,904,06,43,30,1,1,2,0,0,0,0,0,0,0,1,1,0,0,0,1,0,1,28,41,69,73
20192020,097,PERRY,485,Perry County,200,East Perry County Elementary School,485200,097485200,210477002354,KVEC,904,08,29,42,0,1,1,0,0,0,0,0,0,0,0,0,0,0,0,1,1,2,41,27,68,71
20192020,097,PERRY,485,Perry County,250,Perry County Central High School,485250,097485250,210477000755,KVEC,904,14,0,3,0,0,0,0,0,0,0,0,0,0,0,0,0,0,0,0,0,0,3,0,3,3
20192020,097,PERRY,485,Perry County,250,Perry County Central High School,485250,097485250,210477000755,KVEC,904,All Students,402,450,8,4,12,0,0,0,0,2,2,6,0,6,0,0,0,5,3,8,431,393,824,852
20192020,097,PERRY,485,Perry County,250,Perry County Central High School,485250,097485250,210477000755,KVEC,904,09,104,129,2,0,2,0,0,0,0,1,1,5,0,5,0,0,0,1,0,1,121,103,224,233
20192020,097,PERRY,485,Perry County,250,Perry County Central High School,485250,097485250,210477000755,KVEC,904,10,103,120,0,0,0,0,0,0,0,1,1,1,0,1,0,0,0,1,1,2,118,101,219,223
20192020,097,PERRY,485,Perry County,250,Perry County Central High School,485250,097485250,210477000755,KVEC,904,11,105,92,3,3,6,0,0,0,0,0,0,0,0,0,0,0,0,3,2,5,86,100,186,197
20192020,097,PERRY,485,Perry County,250,Perry County Central High School,485250,097485250,210477000755,KVEC,904,12,90,106,3,1,4,0,0,0,0,0,0,0,0,0,0,0,0,0,0,0,103,89,192,196
20192020,097,PERRY,485,Perry County,480,Leatherwood Elementary School,485480,097485480,210477001170,KVEC,904,05,11,8,0,0,0,0,0,0,0,0,0,0,0,0,0,0,0,0,0,0,8,11,19,19
20192020,097,PERRY,485,Perry County,480,Leatherwood Elementary School,485480,097485480,210477001170,KVEC,904,All Students,67,56,0,0,0,0,0,0,0,0,0,0,0,0,0,0,0,1,0,1,55,67,122,123
20192020,097,PERRY,485,Perry County,480,Leatherwood Elementary School,485480,097485480,210477001170,KVEC,904,KG,4,5,0,0,0,0,0,0,0,0,0,0,0,0,0,0,0,0,0,0,5,4,9,9
20192020,097,PERRY,485,Perry County,480,Leatherwood Elementary School,485480,097485480,210477001170,KVEC,904,01,5,7,0,0,0,0,0,0,0,0,0,0,0,0,0,0,0,0,0,0,7,5,12,12
20192020,097,PERRY,485,Perry County,480,Leatherwood Elementary School,485480,097485480,210477001170,KVEC,904,02,11,6,0,0,0,0,0,0,0,0,0,0,0,0,0,0,0,0,0,0,6,11,17,17
20192020,097,PERRY,485,Perry County,480,Leatherwood Elementary School,485480,097485480,210477001170,KVEC,904,03,7,6,0,0,0,0,0,0,0,0,0,0,0,0,0,0,0,0,0,0,6,7,13,13
20192020,097,PERRY,485,Perry County,480,Leatherwood Elementary School,485480,097485480,210477001170,KVEC,904,04,6,5,0,0,0,0,0,0,0,0,0,0,0,0,0,0,0,0,0,0,5,6,11,11
20192020,097,PERRY,485,Perry County,480,Leatherwood Elementary School,485480,097485480,210477001170,KVEC,904,06,7,5,0,0,0,0,0,0,0,0,0,0,0,0,0,0,0,0,0,0,5,7,12,12
20192020,097,PERRY,485,Perry County,480,Leatherwood Elementary School,485480,097485480,210477001170,KVEC,904,07,7,5,0,0,0,0,0,0,0,0,0,0,0,0,0,0,0,0,0,0,5,7,12,12
20192020,097,PERRY,485,Perry County,480,Leatherwood Elementary School,485480,097485480,210477001170,KVEC,904,08,9,9,0,0,0,0,0,0,0,0,0,0,0,0,0,0,0,1,0,1,8,9,17,18
20192020,097,PERRY,485,Perry County,635,Robert W Combs Elementary School,485635,097485635,210477001174,KVEC,904,08,14,24,0,0,0,0,0,0,0,0,0,0,0,0,0,0,0,0,0,0,24,14,38,38
20192020,097,PERRY,485,Perry County,635,Robert W Combs Elementary School,485635,097485635,210477001174,KVEC,904,All Students,164,206,0,0,0,0,0,0,1,0,1,1,2,3,0,0,0,2,1,3,202,161,363,370
20192020,097,PERRY,485,Perry County,635,Robert W Combs Elementary School,485635,097485635,210477001174,KVEC,904,PS,16,25,0,0,0,0,0,0,0,0,0,1,0,1,0,0,0,0,0,0,24,16,40,41
20192020,097,PERRY,485,Perry County,635,Robert W Combs Elementary School,485635,097485635,210477001174,KVEC,904,KG,13,20,0,0,0,0,0,0,0,0,0,1,1,2,0,0,0,0,0,0,19,12,31,33
20192020,097,PERRY,485,Perry County,635,Robert W Combs Elementary School,485635,097485635,210477001174,KVEC,904,01,25,29,0,0,0,0,0,0,0,0,0,0,0,0,0,0,0,1,0,1,28,25,53,54
20192020,097,PERRY,485,Perry County,635,Robert W Combs Elementary School,485635,097485635,210477001174,KVEC,904,02,16,23,0,0,0,0,0,0,1,0,1,0,0,0,0,0,0,0,0,0,22,16,38,39
20192020,097,PERRY,485,Perry County,635,Robert W Combs Elementary School,485635,097485635,210477001174,KVEC,904,03,10,21,0,0,0,0,0,0,0,0,0,0,0,0,0,0,0,0,0,0,21,10,31,31
20192020,097,PERRY,485,Perry County,635,Robert W Combs Elementary School,485635,097485635,210477001174,KVEC,904,04,20,25,0,0,0,0,0,0,0,0,0,0,0,0,0,0,0,1,1,2,24,19,43,45
20192020,097,PERRY,485,Perry County,635,Robert W Combs Elementary School,485635,097485635,210477001174,KVEC,904,05,25,28,0,0,0,0,0,0,0,0,0,0,0,0,0,0,0,0,0,0,28,25,53,53
20192020,097,PERRY,485,Perry County,635,Robert W Combs Elementary School,485635,097485635,210477001174,KVEC,904,06,21,18,0,0,0,0,0,0,0,0,0,0,1,1,0,0,0,0,0,0,18,20,38,39
20192020,097,PERRY,485,Perry County,635,Robert W Combs Elementary School,485635,097485635,210477001174,KVEC,904,07,20,18,0,0,0,0,0,0,0,0,0,0,0,0,0,0,0,0,0,0,18,20,38,38
20192020,097,PERRY,485,Perry County,640,Robinson Elementary School,485640,097485640,210477001175,KVEC,904,07,5,18,0,0,0,0,0,0,0,1,1,0,0,0,0,0,0,0,0,0,18,4,22,23
20192020,097,PERRY,485,Perry County,640,Robinson Elementary School,485640,097485640,210477001175,KVEC,904,All Students,130,134,0,0,0,0,0,0,0,3,3,2,3,5,0,0,0,0,0,0,132,124,256,264
20192020,097,PERRY,485,Perry County,640,Robinson Elementary School,485640,097485640,210477001175,KVEC,904,PS,16,18,0,1,1,0,0,0,0,0,0,1,1,2,0,0,0,0,0,0,17,14,31,34
20192020,097,PERRY,485,Perry County,640,Robinson Elementary School,485640,097485640,210477001175,KVEC,904,KG,17,10,0,0,0,0,0,0,0,0,0,0,0,0,0,0,0,0,0,0,10,17,27,27
20192020,097,PERRY,485,Perry County,640,Robinson Elementary School,485640,097485640,210477001175,KVEC,904,01,12,16,0,0,0,0,0,0,0,0,0,0,0,0,0,0,0,0,0,0,16,12,28,28
20192020,097,PERRY,485,Perry County,640,Robinson Elementary School,485640,097485640,210477001175,KVEC,904,02,12,17,0,0,0,0,0,0,0,0,0,1,1,2,0,0,0,0,0,0,16,11,27,29
20192020,097,PERRY,485,Perry County,640,Robinson Elementary School,485640,097485640,210477001175,KVEC,904,03,24,10,0,0,0,0,0,0,0,1,1,0,1,1,0,0,0,0,0,0,10,22,32,34
20192020,097,PERRY,485,Perry County,640,Robinson Elementary School,485640,097485640,210477001175,KVEC,904,04,15,13,0,0,0,0,0,0,0,0,0,0,0,0,0,0,0,0,0,0,13,15,28,28
20192020,097,PERRY,485,Perry County,640,Robinson Elementary School,485640,097485640,210477001175,KVEC,904,05,19,18,0,0,0,0,0,0,0,0,0,0,1,1,0,0,0,0,0,0,18,18,36,37
20192020,097,PERRY,485,Perry County,640,Robinson Elementary School,485640,097485640,210477001175,KVEC,904,06,13,17,0,0,0,0,0,0,0,1,1,0,0,0,0,0,0,0,0,0,17,12,29,30
20192020,097,PERRY,485,Perry County,640,Robinson Elementary School,485640,097485640,210477001175,KVEC,904,08,13,15,0,0,0,0,0,0,0,0,0,1,0,1,0,0,0,0,0,0,14,13,27,28
20192020,097,PERRY,485,Perry County,890,Viper Elementary School,485890,097485890,210477001177,KVEC,904,07,14,12,0,0,0,0,0,0,0,0,0,1,0,1,0,0,0,0,1,1,11,13,24,26
20192020,097,PERRY,485,Perry County,890,Viper Elementary School,485890,097485890,210477001177,KVEC,904,All Students,124,121,0,0,0,0,0,0,0,0,0,3,4,7,0,0,0,1,2,3,117,118,235,245
20192020,097,PERRY,485,Perry County,890,Viper Elementary School,485890,097485890,210477001177,KVEC,904,PS,9,12,0,0,0,0,0,0,0,0,0,1,0,1,0,0,0,0,0,0,11,9,20,21
20192020,097,PERRY,485,Perry County,890,Viper Elementary School,485890,097485890,210477001177,KVEC,904,KG,15,12,0,0,0,0,0,0,0,0,0,0,0,0,0,0,0,0,0,0,12,15,27,27
20192020,097,PERRY,485,Perry County,890,Viper Elementary School,485890,097485890,210477001177,KVEC,904,01,16,16,0,0,0,0,0,0,0,0,0,0,0,0,0,0,0,0,1,1,16,15,31,32
20192020,097,PERRY,485,Perry County,890,Viper Elementary School,485890,097485890,210477001177,KVEC,904,02,5,19,0,0,0,0,0,0,0,0,0,0,1,1,0,0,0,0,0,0,19,4,23,24
20192020,097,PERRY,485,Perry County,890,Viper Elementary School,485890,097485890,210477001177,KVEC,904,03,12,12,0,0,0,0,0,0,0,0,0,0,2,2,0,0,0,0,0,0,12,10,22,24
20192020,097,PERRY,485,Perry County,890,Viper Elementary School,485890,097485890,210477001177,KVEC,904,04,16,9,0,0,0,0,0,0,0,0,0,0,0,0,0,0,0,0,0,0,9,16,25,25
20192020,097,PERRY,485,Perry County,890,Viper Elementary School,485890,097485890,210477001177,KVEC,904,05,20,11,0,0,0,0,0,0,0,0,0,0,0,0,0,0,0,0,0,0,11,20,31,31
20192020,097,PERRY,485,Perry County,890,Viper Elementary School,485890,097485890,210477001177,KVEC,904,06,15,15,0,0,0,0,0,0,0,0,0,1,1,2,0,0,0,0,0,0,14,14,28,30
20192020,097,PERRY,485,Perry County,890,Viper Elementary School,485890,097485890,210477001177,KVEC,904,08,11,15,0,0,0,0,0,0,0,0,0,1,0,1,0,0,0,1,0,1,13,11,24,26
20192020,097,PERRY,485,Perry County,898,West Perry Elementary School,485898,097485898,210477002453,KVEC,904,07,41,29,0,0,0,0,0,0,0,0,0,0,2,2,0,0,0,0,0,0,29,39,68,70
20192020,097,PERRY,485,Perry County,898,West Perry Elementary School,485898,097485898,210477002453,KVEC,904,All Students,363,362,5,5,10,0,1,1,3,3,6,4,5,9,0,2,2,3,6,9,347,341,688,725
20192020,097,PERRY,485,Perry County,898,West Perry Elementary School,485898,097485898,210477002453,KVEC,904,PS,36,59,1,0,1,2,0,2,0,0,0,0,0,0,0,0,0,1,0,1,55,36,91,95
20192020,097,PERRY,485,Perry County,898,West Perry Elementary School,485898,097485898,210477002453,KVEC,904,KG,35,38,0,0,0,0,0,0,0,0,0,0,1,1,0,0,0,1,1,2,37,33,70,73
20192020,097,PERRY,485,Perry County,898,West Perry Elementary School,485898,097485898,210477002453,KVEC,904,01,41,49,1,0,1,0,0,0,1,0,1,1,1,2,0,0,0,0,0,0,46,40,86,90
20192020,097,PERRY,485,Perry County,898,West Perry Elementary School,485898,097485898,210477002453,KVEC,904,02,48,36,0,1,1,0,0,0,0,0,0,0,0,0,0,0,0,1,2,3,35,45,80,84
20192020,097,PERRY,485,Perry County,898,West Perry Elementary School,485898,097485898,210477002453,KVEC,904,03,35,41,0,0,0,0,1,1,0,0,0,0,0,0,0,1,1,0,1,1,41,32,73,76
20192020,097,PERRY,485,Perry County,898,West Perry Elementary School,485898,097485898,210477002453,KVEC,904,04,37,34,0,1,1,0,0,0,1,1,2,0,0,0,0,0,0,0,0,0,33,35,68,71
20192020,097,PERRY,485,Perry County,898,West Perry Elementary School,485898,097485898,210477002453,KVEC,904,05,41,48,1,1,2,0,0,0,0,0,0,1,0,1,0,0,0,1,1,2,45,39,84,89
20192020,097,PERRY,485,Perry County,898,West Perry Elementary School,485898,097485898,210477002453,KVEC,904,06,40,40,1,0,1,0,0,0,1,1,2,1,0,1,0,1,1,0,1,1,37,37,74,80
20192020,097,PERRY,485,Perry County,898,West Perry Elementary School,485898,097485898,210477002453,KVEC,904,08,45,47,2,2,4,0,0,0,0,1,1,1,1,2,0,0,0,0,0,0,44,41,85,92
20192020,098,PIKE,491,Pike County,"",---District Total---,491,"","",KVEC,904,12,290,307,6,2,8,0,0,0,0,1,1,1,3,4,0,0,0,3,1,4,297,283,580,597
20192020,098,PIKE,491,Pike County,"",---District Total---,491,"","",KVEC,904,All Students,3800,4007,42,31,73,1,2,3,11,9,20,38,41,79,0,0,0,55,35,90,3860,3682,7542,7807
20192020,098,PIKE,491,Pike County,"",---District Total---,491,"","",KVEC,904,PS,248,238,0,3,3,0,0,0,1,0,1,0,2,2,0,0,0,2,1,3,235,242,477,486
20192020,098,PIKE,491,Pike County,"",---District Total---,491,"","",KVEC,904,KG,277,330,3,0,3,1,0,1,2,1,3,3,5,8,0,0,0,6,2,8,315,269,584,607
20192020,098,PIKE,491,Pike County,"",---District Total---,491,"","",KVEC,904,01,290,335,4,1,5,0,0,0,0,0,0,3,1,4,0,0,0,4,8,12,324,280,604,625
20192020,098,PIKE,491,Pike County,"",---District Total---,491,"","",KVEC,904,02,262,284,0,2,2,0,0,0,0,0,0,4,2,6,0,0,0,6,4,10,274,254,528,546
20192020,098,PIKE,491,Pike County,"",---District Total---,491,"","",KVEC,904,03,271,283,1,4,5,0,0,0,0,0,0,8,2,10,0,0,0,4,1,5,270,264,534,554
20192020,098,PIKE,491,Pike County,"",---District Total---,491,"","",KVEC,904,04,251,274,0,4,4,0,0,0,0,0,0,6,2,8,0,0,0,4,3,7,264,242,506,525
20192020,098,PIKE,491,Pike County,"",---District Total---,491,"","",KVEC,904,05,297,318,5,3,8,0,0,0,0,1,1,2,6,8,0,0,0,4,3,7,307,284,591,615
20192020,098,PIKE,491,Pike County,"",---District Total---,491,"","",KVEC,904,06,307,292,4,2,6,0,0,0,2,2,4,2,7,9,0,0,0,4,1,5,280,295,575,599
20192020,098,PIKE,491,Pike County,"",---District Total---,491,"","",KVEC,904,07,323,311,3,4,7,0,0,0,1,0,1,3,5,8,0,0,0,5,2,7,299,312,611,634
20192020,098,PIKE,491,Pike County,"",---District Total---,491,"","",KVEC,904,08,322,302,4,6,10,0,0,0,3,0,3,1,2,3,0,0,0,1,4,5,293,310,603,624
20192020,098,PIKE,491,Pike County,"",---District Total---,491,"","",KVEC,904,09,345,322,4,2,6,0,2,2,1,2,3,4,1,5,0,0,0,6,4,10,307,334,641,667
20192020,098,PIKE,491,Pike County,"",---District Total---,491,"","",KVEC,904,10,319,321,2,1,3,0,0,0,0,1,1,0,2,2,0,0,0,5,1,6,314,314,628,640
20192020,098,PIKE,491,Pike County,"",---District Total---,491,"","",KVEC,904,11,246,328,6,0,6,0,0,0,2,1,3,1,3,4,0,0,0,3,1,4,316,241,557,574
20192020,098,PIKE,491,Pike County,010,Northpoint Academy,491010,098491010,210480002256,KVEC,904,All Students,9,29,0,0,0,0,0,0,0,0,0,0,0,0,0,0,0,0,0,0,29,9,38,38
20192020,098,PIKE,491,Pike County,010,Northpoint Academy,491010,098491010,210480002256,KVEC,904,06,1,3,0,0,0,0,0,0,0,0,0,0,0,0,0,0,0,0,0,0,3,1,4,4
20192020,098,PIKE,491,Pike County,010,Northpoint Academy,491010,098491010,210480002256,KVEC,904,07,0,2,0,0,0,0,0,0,0,0,0,0,0,0,0,0,0,0,0,0,2,0,2,2
20192020,098,PIKE,491,Pike County,010,Northpoint Academy,491010,098491010,210480002256,KVEC,904,08,0,3,0,0,0,0,0,0,0,0,0,0,0,0,0,0,0,0,0,0,3,0,3,3
20192020,098,PIKE,491,Pike County,010,Northpoint Academy,491010,098491010,210480002256,KVEC,904,09,1,1,0,0,0,0,0,0,0,0,0,0,0,0,0,0,0,0,0,0,1,1,2,2
20192020,098,PIKE,491,Pike County,010,Northpoint Academy,491010,098491010,210480002256,KVEC,904,10,2,4,0,0,0,0,0,0,0,0,0,0,0,0,0,0,0,0,0,0,4,2,6,6
20192020,098,PIKE,491,Pike County,010,Northpoint Academy,491010,098491010,210480002256,KVEC,904,11,4,15,0,0,0,0,0,0,0,0,0,0,0,0,0,0,0,0,0,0,15,4,19,19
20192020,098,PIKE,491,Pike County,010,Northpoint Academy,491010,098491010,210480002256,KVEC,904,12,1,1,0,0,0,0,0,0,0,0,0,0,0,0,0,0,0,0,0,0,1,1,2,2
20192020,098,PIKE,491,Pike County,015,Pike County Day Treatment,491015,098491015,210480002444,KVEC,904,06,0,3,0,0,0,0,0,0,0,0,0,0,0,0,0,0,0,0,0,0,3,0,3,3
20192020,098,PIKE,491,Pike County,015,Pike County Day Treatment,491015,098491015,210480002444,KVEC,904,07,0,6,0,0,0,0,0,0,0,0,0,0,0,0,0,0,0,0,0,0,6,0,6,6
20192020,098,PIKE,491,Pike County,015,Pike County Day Treatment,491015,098491015,210480002444,KVEC,904,08,0,3,0,0,0,0,0,0,0,0,0,0,0,0,0,0,0,0,0,0,3,0,3,3
20192020,098,PIKE,491,Pike County,015,Pike County Day Treatment,491015,098491015,210480002444,KVEC,904,09,0,3,0,0,0,0,0,0,0,0,0,0,0,0,0,0,0,0,0,0,3,0,3,3
20192020,098,PIKE,491,Pike County,015,Pike County Day Treatment,491015,098491015,210480002444,KVEC,904,10,1,4,0,0,0,0,0,0,0,0,0,0,0,0,0,0,0,0,0,0,4,1,5,5
20192020,098,PIKE,491,Pike County,015,Pike County Day Treatment,491015,098491015,210480002444,KVEC,904,All Students,1,20,0,0,0,0,0,0,0,0,0,0,0,0,0,0,0,0,0,0,20,1,21,21
20192020,098,PIKE,491,Pike County,015,Pike County Day Treatment,491015,098491015,210480002444,KVEC,904,11,0,1,0,0,0,0,0,0,0,0,0,0,0,0,0,0,0,0,0,0,1,0,1,1
20192020,098,PIKE,491,Pike County,051,Belfry Elementary,491051,098491051,210480001647,KVEC,904,04,34,33,0,0,0,0,0,0,0,0,0,1,0,1,0,0,0,0,1,1,32,33,65,67
20192020,098,PIKE,491,Pike County,051,Belfry Elementary,491051,098491051,210480001647,KVEC,904,03,44,41,1,2,3,0,0,0,0,0,0,1,2,3,0,0,0,1,0,1,38,40,78,85
20192020,098,PIKE,491,Pike County,051,Belfry Elementary,491051,098491051,210480001647,KVEC,904,05,41,53,3,0,3,0,0,0,0,0,0,0,1,1,0,0,0,0,0,0,50,40,90,94
20192020,098,PIKE,491,Pike County,051,Belfry Elementary,491051,098491051,210480001647,KVEC,904,All Students,248,271,8,3,11,0,0,0,1,0,1,5,3,8,0,0,0,6,5,11,251,237,488,519
20192020,098,PIKE,491,Pike County,051,Belfry Elementary,491051,098491051,210480001647,KVEC,904,PS,44,36,0,1,1,0,0,0,1,0,1,0,0,0,0,0,0,0,0,0,35,43,78,80
20192020,098,PIKE,491,Pike County,051,Belfry Elementary,491051,098491051,210480001647,KVEC,904,KG,45,48,1,0,1,0,0,0,1,0,1,0,0,0,0,0,0,3,0,3,43,45,88,93
20192020,098,PIKE,491,Pike County,051,Belfry Elementary,491051,098491051,210480001647,KVEC,904,01,41,61,3,0,3,0,0,0,0,0,0,1,0,1,0,0,0,1,3,4,56,38,94,102
20192020,098,PIKE,491,Pike County,051,Belfry Elementary,491051,098491051,210480001647,KVEC,904,02,43,35,0,1,1,0,0,0,0,0,0,2,0,2,0,0,0,1,1,2,32,41,73,78
20192020,098,PIKE,491,Pike County,054,East Ridge High School,491054,098491054,210480001948,KVEC,904,09,69,66,0,0,0,0,0,0,0,0,0,0,0,0,0,0,0,2,0,2,64,69,133,135
20192020,098,PIKE,491,Pike County,054,East Ridge High School,491054,098491054,210480001948,KVEC,904,10,57,54,0,0,0,0,0,0,0,0,0,0,0,0,0,0,0,0,1,1,54,56,110,111
20192020,098,PIKE,491,Pike County,054,East Ridge High School,491054,098491054,210480001948,KVEC,904,All Students,224,248,2,0,2,0,0,0,0,0,0,0,0,0,0,0,0,3,1,4,243,223,466,472
20192020,098,PIKE,491,Pike County,054,East Ridge High School,491054,098491054,210480001948,KVEC,904,12,52,58,0,0,0,0,0,0,0,0,0,0,0,0,0,0,0,0,0,0,58,52,110,110
20192020,098,PIKE,491,Pike County,054,East Ridge High School,491054,098491054,210480001948,KVEC,904,11,46,70,2,0,2,0,0,0,0,0,0,0,0,0,0,0,0,1,0,1,67,46,113,116
20192020,098,PIKE,491,Pike County,057,Feds Creek Elementary School,491057,098491057,210480002012,KVEC,904,02,9,10,0,0,0,0,0,0,0,0,0,0,0,0,0,0,0,0,0,0,10,9,19,19
20192020,098,PIKE,491,Pike County,057,Feds Creek Elementary School,491057,098491057,210480002012,KVEC,904,All Students,75,89,0,0,0,0,0,0,0,0,0,0,1,1,0,0,0,0,0,0,89,74,163,164
20192020,098,PIKE,491,Pike County,057,Feds Creek Elementary School,491057,098491057,210480002012,KVEC,904,PS,7,11,0,1,1,0,0,0,0,0,0,0,0,0,0,0,0,0,0,0,11,6,17,18
20192020,098,PIKE,491,Pike County,057,Feds Creek Elementary School,491057,098491057,210480002012,KVEC,904,KG,6,5,0,0,0,0,0,0,0,0,0,0,0,0,0,0,0,0,0,0,5,6,11,11
20192020,098,PIKE,491,Pike County,057,Feds Creek Elementary School,491057,098491057,210480002012,KVEC,904,01,7,6,0,0,0,0,0,0,0,0,0,0,0,0,0,0,0,0,0,0,6,7,13,13
20192020,098,PIKE,491,Pike County,057,Feds Creek Elementary School,491057,098491057,210480002012,KVEC,904,03,9,19,0,0,0,0,0,0,0,0,0,0,0,0,0,0,0,0,0,0,19,9,28,28
20192020,098,PIKE,491,Pike County,057,Feds Creek Elementary School,491057,098491057,210480002012,KVEC,904,04,5,8,0,0,0,0,0,0,0,0,0,0,0,0,0,0,0,0,0,0,8,5,13,13
20192020,098,PIKE,491,Pike County,057,Feds Creek Elementary School,491057,098491057,210480002012,KVEC,904,05,13,13,0,0,0,0,0,0,0,0,0,0,0,0,0,0,0,0,0,0,13,13,26,26
20192020,098,PIKE,491,Pike County,057,Feds Creek Elementary School,491057,098491057,210480002012,KVEC,904,06,9,11,0,0,0,0,0,0,0,0,0,0,1,1,0,0,0,0,0,0,11,8,19,20
20192020,098,PIKE,491,Pike County,057,Feds Creek Elementary School,491057,098491057,210480002012,KVEC,904,07,11,8,0,0,0,0,0,0,0,0,0,0,0,0,0,0,0,0,0,0,8,11,19,19
20192020,098,PIKE,491,Pike County,057,Feds Creek Elementary School,491057,098491057,210480002012,KVEC,904,08,6,9,0,0,0,0,0,0,0,0,0,0,0,0,0,0,0,0,0,0,9,6,15,15
20192020,098,PIKE,491,Pike County,058,Belfry Middle School,491058,098491058,210480002013,KVEC,904,07,62,56,1,1,2,0,0,0,0,0,0,0,4,4,0,0,0,2,0,2,53,57,110,118
20192020,098,PIKE,491,Pike County,058,Belfry Middle School,491058,098491058,210480002013,KVEC,904,08,75,70,3,6,9,0,0,0,2,0,2,1,0,1,0,0,0,0,2,2,64,67,131,145
20192020,098,PIKE,491,Pike County,058,Belfry Middle School,491058,098491058,210480002013,KVEC,904,All Students,203,191,5,7,12,0,0,0,2,1,3,1,7,8,0,0,0,4,2,6,179,186,365,394
20192020,098,PIKE,491,Pike County,058,Belfry Middle School,491058,098491058,210480002013,KVEC,904,06,66,65,1,0,1,0,0,0,0,1,1,0,3,3,0,0,0,2,0,2,62,62,124,131
20192020,098,PIKE,491,Pike County,059,Millard School,491059,098491059,210480002240,KVEC,904,01,27,44,1,0,1,0,0,0,0,0,0,0,0,0,0,0,0,0,0,0,43,27,70,71
20192020,098,PIKE,491,Pike County,059,Millard School,491059,098491059,210480002240,KVEC,904,02,34,26,0,1,1,0,0,0,0,0,0,0,0,0,0,0,0,0,0,0,26,33,59,60
20192020,098,PIKE,491,Pike County,059,Millard School,491059,098491059,210480002240,KVEC,904,03,37,28,0,0,0,0,0,0,0,0,0,3,0,3,0,0,0,0,0,0,25,37,62,65
20192020,098,PIKE,491,Pike County,059,Millard School,491059,098491059,210480002240,KVEC,904,04,24,30,0,1,1,0,0,0,0,0,0,0,1,1,0,0,0,0,0,0,30,22,52,54
20192020,098,PIKE,491,Pike County,059,Millard School,491059,098491059,210480002240,KVEC,904,05,38,31,1,2,3,0,0,0,0,0,0,0,1,1,0,0,0,0,0,0,30,35,65,69
20192020,098,PIKE,491,Pike County,059,Millard School,491059,098491059,210480002240,KVEC,904,06,26,32,0,0,0,0,0,0,0,0,0,0,0,0,0,0,0,0,0,0,32,26,58,58
20192020,098,PIKE,491,Pike County,059,Millard School,491059,098491059,210480002240,KVEC,904,08,24,27,1,0,1,0,0,0,0,0,0,0,0,0,0,0,0,0,0,0,26,24,50,51
20192020,098,PIKE,491,Pike County,059,Millard School,491059,098491059,210480002240,KVEC,904,07,38,30,0,1,1,0,0,0,0,0,0,0,0,0,0,0,0,0,0,0,30,37,67,68
20192020,098,PIKE,491,Pike County,059,Millard School,491059,098491059,210480002240,KVEC,904,All Students,268,287,3,5,8,0,0,0,0,0,0,4,2,6,0,0,0,0,0,0,280,261,541,555
20192020,098,PIKE,491,Pike County,059,Millard School,491059,098491059,210480002240,KVEC,904,PS,26,35,0,0,0,0,0,0,0,0,0,0,1,1,0,0,0,0,0,0,35,25,60,61
20192020,098,PIKE,491,Pike County,059,Millard School,491059,098491059,210480002240,KVEC,904,KG,20,39,0,0,0,0,0,0,0,0,0,1,0,1,0,0,0,0,0,0,38,20,58,59
20192020,098,PIKE,491,Pike County,060,Valley Elementary School,491060,098491060,210480002296,KVEC,904,07,62,53,0,1,1,0,0,0,0,0,0,0,1,1,0,0,0,0,0,0,53,60,113,115
20192020,098,PIKE,491,Pike County,060,Valley Elementary School,491060,098491060,210480002296,KVEC,904,All Students,412,411,0,2,2,0,0,0,0,0,0,3,5,8,0,0,0,7,3,10,401,402,803,823
20192020,098,PIKE,491,Pike County,060,Valley Elementary School,491060,098491060,210480002296,KVEC,904,PS,36,41,0,0,0,0,0,0,0,0,0,0,0,0,0,0,0,1,0,1,40,36,76,77
20192020,098,PIKE,491,Pike County,060,Valley Elementary School,491060,098491060,210480002296,KVEC,904,KG,47,52,0,0,0,0,0,0,0,0,0,0,0,0,0,0,0,1,1,2,51,46,97,99
20192020,098,PIKE,491,Pike County,060,Valley Elementary School,491060,098491060,210480002296,KVEC,904,01,45,53,0,0,0,0,0,0,0,0,0,0,0,0,0,0,0,1,1,2,52,44,96,98
20192020,098,PIKE,491,Pike County,060,Valley Elementary School,491060,098491060,210480002296,KVEC,904,02,33,42,0,0,0,0,0,0,0,0,0,0,1,1,0,0,0,3,0,3,39,32,71,75
20192020,098,PIKE,491,Pike County,060,Valley Elementary School,491060,098491060,210480002296,KVEC,904,03,45,39,0,0,0,0,0,0,0,0,0,0,0,0,0,0,0,0,0,0,39,45,84,84
20192020,098,PIKE,491,Pike County,060,Valley Elementary School,491060,098491060,210480002296,KVEC,904,04,42,39,0,0,0,0,0,0,0,0,0,2,0,2,0,0,0,0,0,0,37,42,79,81
20192020,098,PIKE,491,Pike County,060,Valley Elementary School,491060,098491060,210480002296,KVEC,904,05,42,40,0,0,0,0,0,0,0,0,0,0,2,2,0,0,0,1,0,1,39,40,79,82
20192020,098,PIKE,491,Pike County,060,Valley Elementary School,491060,098491060,210480002296,KVEC,904,06,47,47,0,1,1,0,0,0,0,0,0,1,1,2,0,0,0,0,1,1,46,44,90,94
20192020,098,PIKE,491,Pike County,060,Valley Elementary School,491060,098491060,210480002296,KVEC,904,08,49,46,0,0,0,0,0,0,0,0,0,0,0,0,0,0,0,1,0,1,45,49,94,95
20192020,098,PIKE,491,Pike County,090,Belfry High School,491090,098491090,210480001179,KVEC,904,11,54,82,2,0,2,0,0,0,2,1,3,1,1,2,0,0,0,2,0,2,75,52,127,136
20192020,098,PIKE,491,Pike County,090,Belfry High School,491090,098491090,210480001179,KVEC,904,All Students,267,320,7,2,9,0,1,1,2,4,6,1,4,5,0,0,0,9,2,11,301,254,555,587
20192020,098,PIKE,491,Pike County,090,Belfry High School,491090,098491090,210480001179,KVEC,904,09,85,77,1,0,1,0,1,1,0,1,1,0,1,1,0,0,0,1,2,3,75,80,155,162
20192020,098,PIKE,491,Pike County,090,Belfry High School,491090,098491090,210480001179,KVEC,904,10,68,79,0,1,1,0,0,0,0,1,1,0,1,1,0,0,0,4,0,4,75,65,140,147
20192020,098,PIKE,491,Pike County,090,Belfry High School,491090,098491090,210480001179,KVEC,904,12,60,82,4,1,5,0,0,0,0,1,1,0,1,1,0,0,0,2,0,2,76,57,133,142
20192020,098,PIKE,491,Pike County,130,Bevins Elementary School,491130,098491130,210480001180,KVEC,904,04,18,16,0,0,0,0,0,0,0,0,0,0,0,0,0,0,0,1,0,1,15,18,33,34
20192020,098,PIKE,491,Pike County,130,Bevins Elementary School,491130,098491130,210480001180,KVEC,904,All Students,83,113,1,2,3,0,0,0,0,0,0,2,1,3,0,0,0,3,0,3,107,80,187,196
20192020,098,PIKE,491,Pike County,130,Bevins Elementary School,491130,098491130,210480001180,KVEC,904,PS,17,17,0,1,1,0,0,0,0,0,0,0,0,0,0,0,0,0,1,1,17,15,32,34
20192020,098,PIKE,491,Pike County,130,Bevins Elementary School,491130,098491130,210480001180,KVEC,904,KG,15,25,0,0,0,0,0,0,0,0,0,0,1,1,0,0,0,1,0,1,24,14,38,40
20192020,098,PIKE,491,Pike County,130,Bevins Elementary School,491130,098491130,210480001180,KVEC,904,01,13,24,0,0,0,0,0,0,0,0,0,1,0,1,0,0,0,0,0,0,23,13,36,37
20192020,098,PIKE,491,Pike County,130,Bevins Elementary School,491130,098491130,210480001180,KVEC,904,02,15,12,0,0,0,0,0,0,0,0,0,0,0,0,0,0,0,0,0,0,12,15,27,27
20192020,098,PIKE,491,Pike County,130,Bevins Elementary School,491130,098491130,210480001180,KVEC,904,03,14,16,0,1,1,0,0,0,0,0,0,1,0,1,0,0,0,0,0,0,15,13,28,30
20192020,098,PIKE,491,Pike County,130,Bevins Elementary School,491130,098491130,210480001180,KVEC,904,05,8,20,1,1,2,0,0,0,0,0,0,0,0,0,0,0,0,1,0,1,18,7,25,28
20192020,098,PIKE,491,Pike County,190,Pike County Central High School,491190,098491190,210480000505,KVEC,904,12,83,73,1,0,1,0,0,0,0,0,0,0,0,0,0,0,0,1,0,1,71,83,154,156
20192020,098,PIKE,491,Pike County,190,Pike County Central High School,491190,098491190,210480000505,KVEC,904,All Students,324,292,5,1,6,0,1,1,1,1,2,2,1,3,0,0,0,4,3,7,280,317,597,616
20192020,098,PIKE,491,Pike County,190,Pike County Central High School,491190,098491190,210480000505,KVEC,904,09,87,73,2,1,3,0,1,1,1,1,2,2,0,2,0,0,0,2,2,4,66,82,148,160
20192020,098,PIKE,491,Pike County,190,Pike County Central High School,491190,098491190,210480000505,KVEC,904,10,84,87,1,0,1,0,0,0,0,0,0,0,0,0,0,0,0,1,0,1,85,84,169,171
20192020,098,PIKE,491,Pike County,190,Pike County Central High School,491190,098491190,210480000505,KVEC,904,11,70,59,1,0,1,0,0,0,0,0,0,0,1,1,0,0,0,0,1,1,58,68,126,129
20192020,098,PIKE,491,Pike County,250,Dorton Elementary School,491250,098491250,210480001183,KVEC,904,08,18,11,0,0,0,0,0,0,0,0,0,0,0,0,0,0,0,0,0,0,11,18,29,29
20192020,098,PIKE,491,Pike County,250,Dorton Elementary School,491250,098491250,210480001183,KVEC,904,All Students,125,133,0,1,1,0,0,0,0,0,0,0,0,0,0,0,0,1,1,2,132,123,255,258
20192020,098,PIKE,491,Pike County,250,Dorton Elementary School,491250,098491250,210480001183,KVEC,904,PS,11,9,0,0,0,0,0,0,0,0,0,0,0,0,0,0,0,0,0,0,9,11,20,20
20192020,098,PIKE,491,Pike County,250,Dorton Elementary School,491250,098491250,210480001183,KVEC,904,KG,20,16,0,0,0,0,0,0,0,0,0,0,0,0,0,0,0,0,0,0,16,20,36,36
20192020,098,PIKE,491,Pike County,250,Dorton Elementary School,491250,098491250,210480001183,KVEC,904,01,12,15,0,0,0,0,0,0,0,0,0,0,0,0,0,0,0,0,0,0,15,12,27,27
20192020,098,PIKE,491,Pike County,250,Dorton Elementary School,491250,098491250,210480001183,KVEC,904,02,13,17,0,0,0,0,0,0,0,0,0,0,0,0,0,0,0,0,1,1,17,12,29,30
20192020,098,PIKE,491,Pike County,250,Dorton Elementary School,491250,098491250,210480001183,KVEC,904,03,10,13,0,0,0,0,0,0,0,0,0,0,0,0,0,0,0,0,0,0,13,10,23,23
20192020,098,PIKE,491,Pike County,250,Dorton Elementary School,491250,098491250,210480001183,KVEC,904,04,13,14,0,1,1,0,0,0,0,0,0,0,0,0,0,0,0,0,0,0,14,12,26,27
20192020,098,PIKE,491,Pike County,250,Dorton Elementary School,491250,098491250,210480001183,KVEC,904,05,12,18,0,0,0,0,0,0,0,0,0,0,0,0,0,0,0,1,0,1,17,12,29,30
20192020,098,PIKE,491,Pike County,250,Dorton Elementary School,491250,098491250,210480001183,KVEC,904,06,15,18,0,0,0,0,0,0,0,0,0,0,0,0,0,0,0,0,0,0,18,15,33,33
20192020,098,PIKE,491,Pike County,250,Dorton Elementary School,491250,098491250,210480001183,KVEC,904,07,12,11,0,0,0,0,0,0,0,0,0,0,0,0,0,0,0,0,0,0,11,12,23,23
20192020,098,PIKE,491,Pike County,300,Elkhorn City Elementary School,491300,098491300,210480001185,KVEC,904,03,27,19,0,1,1,0,0,0,0,0,0,0,0,0,0,0,0,0,0,0,19,26,45,46
20192020,098,PIKE,491,Pike County,300,Elkhorn City Elementary School,491300,098491300,210480001185,KVEC,904,All Students,214,196,2,1,3,0,0,0,0,0,0,1,1,2,0,0,0,1,2,3,192,210,402,410
20192020,098,PIKE,491,Pike County,300,Elkhorn City Elementary School,491300,098491300,210480001185,KVEC,904,PS,22,18,0,0,0,0,0,0,0,0,0,0,0,0,0,0,0,0,0,0,18,22,40,40
20192020,098,PIKE,491,Pike County,300,Elkhorn City Elementary School,491300,098491300,210480001185,KVEC,904,KG,18,27,1,0,1,0,0,0,0,0,0,0,0,0,0,0,0,0,0,0,26,18,44,45
20192020,098,PIKE,491,Pike County,300,Elkhorn City Elementary School,491300,098491300,210480001185,KVEC,904,01,28,25,0,0,0,0,0,0,0,0,0,0,1,1,0,0,0,0,1,1,25,26,51,53
20192020,098,PIKE,491,Pike County,300,Elkhorn City Elementary School,491300,098491300,210480001185,KVEC,904,02,22,23,0,0,0,0,0,0,0,0,0,0,0,0,0,0,0,1,0,1,22,22,44,45
20192020,098,PIKE,491,Pike County,300,Elkhorn City Elementary School,491300,098491300,210480001185,KVEC,904,04,24,19,0,0,0,0,0,0,0,0,0,1,0,1,0,0,0,0,0,0,18,24,42,43
20192020,098,PIKE,491,Pike County,300,Elkhorn City Elementary School,491300,098491300,210480001185,KVEC,904,05,32,22,0,0,0,0,0,0,0,0,0,0,0,0,0,0,0,0,1,1,22,31,53,54
20192020,098,PIKE,491,Pike County,300,Elkhorn City Elementary School,491300,098491300,210480001185,KVEC,904,06,23,20,1,0,1,0,0,0,0,0,0,0,0,0,0,0,0,0,0,0,19,23,42,43
20192020,098,PIKE,491,Pike County,300,Elkhorn City Elementary School,491300,098491300,210480001185,KVEC,904,07,16,20,0,0,0,0,0,0,0,0,0,0,0,0,0,0,0,0,0,0,20,16,36,36
20192020,098,PIKE,491,Pike County,300,Elkhorn City Elementary School,491300,098491300,210480001185,KVEC,904,08,24,21,0,0,0,0,0,0,0,0,0,0,0,0,0,0,0,0,0,0,21,24,45,45
20192020,098,PIKE,491,Pike County,620,Johns Creek Elementary School,491620,098491620,210480001195,KVEC,904,08,47,33,0,0,0,0,0,0,1,0,1,0,0,0,0,0,0,0,1,1,32,46,78,80
20192020,098,PIKE,491,Pike County,620,Johns Creek Elementary School,491620,098491620,210480001195,KVEC,904,All Students,323,301,0,0,0,0,0,0,2,2,4,2,1,3,0,0,0,2,5,7,295,315,610,624
20192020,098,PIKE,491,Pike County,620,Johns Creek Elementary School,491620,098491620,210480001195,KVEC,904,PS,52,46,0,0,0,0,0,0,0,0,0,0,1,1,0,0,0,1,0,1,45,51,96,98
20192020,098,PIKE,491,Pike County,620,Johns Creek Elementary School,491620,098491620,210480001195,KVEC,904,KG,36,33,0,0,0,0,0,0,1,1,2,0,1,1,0,0,0,0,0,0,32,34,66,69
20192020,098,PIKE,491,Pike County,620,Johns Creek Elementary School,491620,098491620,210480001195,KVEC,904,01,35,31,0,0,0,0,0,0,0,0,0,0,0,0,0,0,0,0,0,0,31,35,66,66
20192020,098,PIKE,491,Pike County,620,Johns Creek Elementary School,491620,098491620,210480001195,KVEC,904,02,26,32,0,0,0,0,0,0,0,0,0,1,0,1,0,0,0,0,0,0,31,26,57,58
20192020,098,PIKE,491,Pike County,620,Johns Creek Elementary School,491620,098491620,210480001195,KVEC,904,03,31,27,0,0,0,0,0,0,0,0,0,1,0,1,0,0,0,0,0,0,26,31,57,58
20192020,098,PIKE,491,Pike County,620,Johns Creek Elementary School,491620,098491620,210480001195,KVEC,904,04,30,33,0,0,0,0,0,0,0,0,0,0,0,0,0,0,0,1,1,2,32,29,61,63
20192020,098,PIKE,491,Pike County,620,Johns Creek Elementary School,491620,098491620,210480001195,KVEC,904,05,34,38,0,0,0,0,0,0,0,1,1,0,0,0,0,0,0,0,1,1,38,32,70,72
20192020,098,PIKE,491,Pike County,620,Johns Creek Elementary School,491620,098491620,210480001195,KVEC,904,06,37,34,0,0,0,0,0,0,0,0,0,0,0,0,0,0,0,0,0,0,34,37,71,71
20192020,098,PIKE,491,Pike County,620,Johns Creek Elementary School,491620,098491620,210480001195,KVEC,904,07,47,40,0,0,0,0,0,0,0,0,0,0,0,0,0,0,0,1,2,3,39,45,84,87
20192020,098,PIKE,491,Pike County,650,Kimper Elementary School,491650,098491650,210480001197,KVEC,904,06,9,5,0,0,0,0,0,0,0,0,0,0,0,0,0,0,0,0,0,0,5,9,14,14
20192020,098,PIKE,491,Pike County,650,Kimper Elementary School,491650,098491650,210480001197,KVEC,904,All Students,56,65,0,0,0,0,0,0,0,0,0,2,0,2,0,0,0,2,0,2,61,56,117,121
20192020,098,PIKE,491,Pike County,650,Kimper Elementary School,491650,098491650,210480001197,KVEC,904,PS,11,8,0,0,0,0,0,0,0,0,0,0,0,0,0,0,0,0,0,0,8,11,19,19
20192020,098,PIKE,491,Pike County,650,Kimper Elementary School,491650,098491650,210480001197,KVEC,904,KG,5,5,0,0,0,0,0,0,0,0,0,0,0,0,0,0,0,0,0,0,5,5,10,10
20192020,098,PIKE,491,Pike County,650,Kimper Elementary School,491650,098491650,210480001197,KVEC,904,01,10,7,0,0,0,0,0,0,0,0,0,0,0,0,0,0,0,0,0,0,7,10,17,17
20192020,098,PIKE,491,Pike County,650,Kimper Elementary School,491650,098491650,210480001197,KVEC,904,02,6,9,0,0,0,0,0,0,0,0,0,0,0,0,0,0,0,0,0,0,9,6,15,15
20192020,098,PIKE,491,Pike County,650,Kimper Elementary School,491650,098491650,210480001197,KVEC,904,08,2,5,0,0,0,0,0,0,0,0,0,0,0,0,0,0,0,0,0,0,5,2,7,7
20192020,098,PIKE,491,Pike County,650,Kimper Elementary School,491650,098491650,210480001197,KVEC,904,03,4,7,0,0,0,0,0,0,0,0,0,1,0,1,0,0,0,1,0,1,5,4,9,11
20192020,098,PIKE,491,Pike County,650,Kimper Elementary School,491650,098491650,210480001197,KVEC,904,04,7,11,0,0,0,0,0,0,0,0,0,0,0,0,0,0,0,0,0,0,11,7,18,18
20192020,098,PIKE,491,Pike County,650,Kimper Elementary School,491650,098491650,210480001197,KVEC,904,05,7,11,0,0,0,0,0,0,0,0,0,0,0,0,0,0,0,1,0,1,10,7,17,18
20192020,098,PIKE,491,Pike County,650,Kimper Elementary School,491650,098491650,210480001197,KVEC,904,07,6,5,0,0,0,0,0,0,0,0,0,1,0,1,0,0,0,0,0,0,4,6,10,11
20192020,098,PIKE,491,Pike County,950,Mullins Elementary School,491950,098491950,210480001202,KVEC,904,All Students,358,409,5,3,8,1,0,1,3,1,4,5,6,11,0,0,0,9,8,17,386,340,726,767
20192020,098,PIKE,491,Pike County,950,Mullins Elementary School,491950,098491950,210480001202,KVEC,904,KG,42,49,1,0,1,1,0,1,0,0,0,2,3,5,0,0,0,1,1,2,44,38,82,91
20192020,098,PIKE,491,Pike County,950,Mullins Elementary School,491950,098491950,210480001202,KVEC,904,01,51,43,0,0,0,0,0,0,0,0,0,0,0,0,0,0,0,2,2,4,41,49,90,94
20192020,098,PIKE,491,Pike County,950,Mullins Elementary School,491950,098491950,210480001202,KVEC,904,02,41,47,0,0,0,0,0,0,0,0,0,0,1,1,0,0,0,0,2,2,47,38,85,88
20192020,098,PIKE,491,Pike County,950,Mullins Elementary School,491950,098491950,210480001202,KVEC,904,03,28,45,0,0,0,0,0,0,0,0,0,0,0,0,0,0,0,1,1,2,44,27,71,73
20192020,098,PIKE,491,Pike County,950,Mullins Elementary School,491950,098491950,210480001202,KVEC,904,04,37,50,0,2,2,0,0,0,0,0,0,1,0,1,0,0,0,1,1,2,48,34,82,87
20192020,098,PIKE,491,Pike County,950,Mullins Elementary School,491950,098491950,210480001202,KVEC,904,05,42,45,0,0,0,0,0,0,0,0,0,1,2,3,0,0,0,0,1,1,44,39,83,87
20192020,098,PIKE,491,Pike County,950,Mullins Elementary School,491950,098491950,210480001202,KVEC,904,06,37,38,2,1,3,0,0,0,2,1,3,1,0,1,0,0,0,2,0,2,31,35,66,75
20192020,098,PIKE,491,Pike County,950,Mullins Elementary School,491950,098491950,210480001202,KVEC,904,07,35,48,2,0,2,0,0,0,1,0,1,0,0,0,0,0,0,2,0,2,43,35,78,83
20192020,098,PIKE,491,Pike County,950,Mullins Elementary School,491950,098491950,210480001202,KVEC,904,08,45,44,0,0,0,0,0,0,0,0,0,0,0,0,0,0,0,0,0,0,44,45,89,89
20192020,098,PIKE,491,Pike County,952,Phelps Elementary School,491952,098491952,210480001203,KVEC,904,06,37,16,0,0,0,0,0,0,0,0,0,0,2,2,0,0,0,0,0,0,16,35,51,53
20192020,098,PIKE,491,Pike County,952,Phelps Elementary School,491952,098491952,210480001203,KVEC,904,All Students,168,181,0,1,1,0,0,0,0,0,0,5,3,8,0,0,0,3,1,4,173,163,336,349
20192020,098,PIKE,491,Pike County,952,Phelps Elementary School,491952,098491952,210480001203,KVEC,904,PS,22,17,0,0,0,0,0,0,0,0,0,0,0,0,0,0,0,0,0,0,17,22,39,39
20192020,098,PIKE,491,Pike County,952,Phelps Elementary School,491952,098491952,210480001203,KVEC,904,KG,23,31,0,0,0,0,0,0,0,0,0,0,0,0,0,0,0,0,0,0,31,23,54,54
20192020,098,PIKE,491,Pike County,952,Phelps Elementary School,491952,098491952,210480001203,KVEC,904,01,21,26,0,1,1,0,0,0,0,0,0,1,0,1,0,0,0,0,1,1,25,19,44,47
20192020,098,PIKE,491,Pike County,952,Phelps Elementary School,491952,098491952,210480001203,KVEC,904,02,20,31,0,0,0,0,0,0,0,0,0,1,0,1,0,0,0,1,0,1,29,20,49,51
20192020,098,PIKE,491,Pike County,952,Phelps Elementary School,491952,098491952,210480001203,KVEC,904,03,22,29,0,0,0,0,0,0,0,0,0,1,0,1,0,0,0,1,0,1,27,22,49,51
20192020,098,PIKE,491,Pike County,952,Phelps Elementary School,491952,098491952,210480001203,KVEC,904,04,17,21,0,0,0,0,0,0,0,0,0,1,1,2,0,0,0,1,0,1,19,16,35,38
20192020,098,PIKE,491,Pike County,952,Phelps Elementary School,491952,098491952,210480001203,KVEC,904,05,28,27,0,0,0,0,0,0,0,0,0,1,0,1,0,0,0,0,0,0,26,28,54,55
20192020,098,PIKE,491,Pike County,954,Phelps High School,491954,098491954,210480001204,KVEC,904,11,18,27,1,0,1,0,0,0,0,0,0,0,0,0,0,0,0,0,0,0,26,18,44,45
20192020,098,PIKE,491,Pike County,954,Phelps High School,491954,098491954,210480001204,KVEC,904,All Students,165,170,3,2,5,0,0,0,0,0,0,2,3,5,0,0,0,0,1,1,165,159,324,335
20192020,098,PIKE,491,Pike County,954,Phelps High School,491954,098491954,210480001204,KVEC,904,07,34,32,0,1,1,0,0,0,0,0,0,2,0,2,0,0,0,0,0,0,30,33,63,66
20192020,098,PIKE,491,Pike County,954,Phelps High School,491954,098491954,210480001204,KVEC,904,08,32,30,0,0,0,0,0,0,0,0,0,0,2,2,0,0,0,0,1,1,30,29,59,62
20192020,098,PIKE,491,Pike County,954,Phelps High School,491954,098491954,210480001204,KVEC,904,09,24,22,1,0,1,0,0,0,0,0,0,0,0,0,0,0,0,0,0,0,21,24,45,46
20192020,098,PIKE,491,Pike County,954,Phelps High School,491954,098491954,210480001204,KVEC,904,10,30,28,1,0,1,0,0,0,0,0,0,0,0,0,0,0,0,0,0,0,27,30,57,58
20192020,098,PIKE,491,Pike County,954,Phelps High School,491954,098491954,210480001204,KVEC,904,12,27,31,0,1,1,0,0,0,0,0,0,0,1,1,0,0,0,0,0,0,31,25,56,58
20192020,098,PIKE,491,Pike County,980,Shelby Valley High School,491980,098491980,210480001686,KVEC,904,11,54,74,0,0,0,0,0,0,0,0,0,0,1,1,0,0,0,0,0,0,74,53,127,128
20192020,098,PIKE,491,Pike County,980,Shelby Valley High School,491980,098491980,210480001686,KVEC,904,All Students,277,281,1,1,2,0,0,0,0,0,0,3,3,6,0,0,0,1,1,2,276,272,548,558
20192020,098,PIKE,491,Pike County,980,Shelby Valley High School,491980,098491980,210480001686,KVEC,904,09,79,80,0,1,1,0,0,0,0,0,0,2,0,2,0,0,0,1,0,1,77,78,155,159
20192020,098,PIKE,491,Pike County,980,Shelby Valley High School,491980,098491980,210480001686,KVEC,904,10,77,65,0,0,0,0,0,0,0,0,0,0,1,1,0,0,0,0,0,0,65,76,141,142
20192020,098,PIKE,491,Pike County,980,Shelby Valley High School,491980,098491980,210480001686,KVEC,904,12,67,62,1,0,1,0,0,0,0,0,0,1,1,2,0,0,0,0,1,1,60,65,125,129
20192020,098,PIKE,492,Pikeville Independent,"",---District Total---,492,"","",KVEC,904,11,34,44,1,0,1,0,0,0,1,0,1,0,0,0,1,0,1,2,0,2,39,34,73,78
20192020,098,PIKE,492,Pikeville Independent,"",---District Total---,492,"","",KVEC,904,All Students,530,615,9,11,20,0,0,0,15,17,32,12,10,22,1,0,1,15,14,29,563,478,1041,1145
20192020,098,PIKE,492,Pikeville Independent,"",---District Total---,492,"","",KVEC,904,KG,44,42,0,0,0,0,0,0,0,0,0,1,0,1,0,0,0,0,3,3,41,41,82,86
20192020,098,PIKE,492,Pikeville Independent,"",---District Total---,492,"","",KVEC,904,01,42,42,0,1,1,0,0,0,1,0,1,1,1,2,0,0,0,1,1,2,39,39,78,84
20192020,098,PIKE,492,Pikeville Independent,"",---District Total---,492,"","",KVEC,904,02,32,48,2,1,3,0,0,0,4,3,7,1,0,1,0,0,0,1,0,1,40,28,68,80
20192020,098,PIKE,492,Pikeville Independent,"",---District Total---,492,"","",KVEC,904,03,35,51,0,2,2,0,0,0,2,0,2,1,0,1,0,0,0,1,0,1,47,33,80,86
20192020,098,PIKE,492,Pikeville Independent,"",---District Total---,492,"","",KVEC,904,04,43,51,0,0,0,0,0,0,2,2,4,1,1,2,0,0,0,2,3,5,46,37,83,94
20192020,098,PIKE,492,Pikeville Independent,"",---District Total---,492,"","",KVEC,904,05,47,48,0,1,1,0,0,0,1,1,2,0,0,0,0,0,0,1,0,1,46,45,91,95
20192020,098,PIKE,492,Pikeville Independent,"",---District Total---,492,"","",KVEC,904,06,44,38,0,1,1,0,0,0,0,2,2,1,1,2,0,0,0,2,2,4,35,38,73,82
20192020,098,PIKE,492,Pikeville Independent,"",---District Total---,492,"","",KVEC,904,07,54,38,2,0,2,0,0,0,0,0,0,3,1,4,0,0,0,0,1,1,33,52,85,92
20192020,098,PIKE,492,Pikeville Independent,"",---District Total---,492,"","",KVEC,904,08,44,47,0,2,2,0,0,0,2,4,6,3,0,3,0,0,0,0,1,1,42,37,79,91
20192020,098,PIKE,492,Pikeville Independent,"",---District Total---,492,"","",KVEC,904,09,35,47,0,0,0,0,0,0,0,2,2,0,1,1,0,0,0,1,0,1,46,32,78,82
20192020,098,PIKE,492,Pikeville Independent,"",---District Total---,492,"","",KVEC,904,10,49,65,1,2,3,0,0,0,2,3,5,0,3,3,0,0,0,1,0,1,61,41,102,114
20192020,098,PIKE,492,Pikeville Independent,"",---District Total---,492,"","",KVEC,904,12,27,54,3,1,4,0,0,0,0,0,0,0,2,2,0,0,0,3,3,6,48,21,69,81
20192020,098,PIKE,492,Pikeville Independent,020,Pikeville Elementary School,492020,098492020,210483001213,KVEC,904,03,35,51,0,2,2,0,0,0,2,0,2,1,0,1,0,0,0,1,0,1,47,33,80,86
20192020,098,PIKE,492,Pikeville Independent,020,Pikeville Elementary School,492020,098492020,210483001213,KVEC,904,All Students,287,320,2,6,8,0,0,0,10,8,18,6,3,9,0,0,0,8,9,17,294,261,555,607
20192020,098,PIKE,492,Pikeville Independent,020,Pikeville Elementary School,492020,098492020,210483001213,KVEC,904,KG,44,42,0,0,0,0,0,0,0,0,0,1,0,1,0,0,0,0,3,3,41,41,82,86
20192020,098,PIKE,492,Pikeville Independent,020,Pikeville Elementary School,492020,098492020,210483001213,KVEC,904,01,42,42,0,1,1,0,0,0,1,0,1,1,1,2,0,0,0,1,1,2,39,39,78,84
20192020,098,PIKE,492,Pikeville Independent,020,Pikeville Elementary School,492020,098492020,210483001213,KVEC,904,02,32,48,2,1,3,0,0,0,4,3,7,1,0,1,0,0,0,1,0,1,40,28,68,80
20192020,098,PIKE,492,Pikeville Independent,020,Pikeville Elementary School,492020,098492020,210483001213,KVEC,904,04,43,51,0,0,0,0,0,0,2,2,4,1,1,2,0,0,0,2,3,5,46,37,83,94
20192020,098,PIKE,492,Pikeville Independent,020,Pikeville Elementary School,492020,098492020,210483001213,KVEC,904,05,47,48,0,1,1,0,0,0,1,1,2,0,0,0,0,0,0,1,0,1,46,45,91,95
20192020,098,PIKE,492,Pikeville Independent,020,Pikeville Elementary School,492020,098492020,210483001213,KVEC,904,06,44,38,0,1,1,0,0,0,0,2,2,1,1,2,0,0,0,2,2,4,35,38,73,82
20192020,098,PIKE,492,Pikeville Independent,030,Pikeville High School,492030,098492030,210483001214,KVEC,904,All Students,243,295,7,5,12,0,0,0,5,9,14,6,7,13,1,0,1,7,5,12,269,217,486,538
20192020,098,PIKE,492,Pikeville Independent,030,Pikeville High School,492030,098492030,210483001214,KVEC,904,07,54,38,2,0,2,0,0,0,0,0,0,3,1,4,0,0,0,0,1,1,33,52,85,92
20192020,098,PIKE,492,Pikeville Independent,030,Pikeville High School,492030,098492030,210483001214,KVEC,904,08,44,47,0,2,2,0,0,0,2,4,6,3,0,3,0,0,0,0,1,1,42,37,79,91
20192020,098,PIKE,492,Pikeville Independent,030,Pikeville High School,492030,098492030,210483001214,KVEC,904,09,35,47,0,0,0,0,0,0,0,2,2,0,1,1,0,0,0,1,0,1,46,32,78,82
20192020,098,PIKE,492,Pikeville Independent,030,Pikeville High School,492030,098492030,210483001214,KVEC,904,10,49,65,1,2,3,0,0,0,2,3,5,0,3,3,0,0,0,1,0,1,61,41,102,114
20192020,098,PIKE,492,Pikeville Independent,030,Pikeville High School,492030,098492030,210483001214,KVEC,904,11,34,44,1,0,1,0,0,0,1,0,1,0,0,0,1,0,1,2,0,2,39,34,73,78
20192020,098,PIKE,492,Pikeville Independent,030,Pikeville High School,492030,098492030,210483001214,KVEC,904,12,27,54,3,1,4,0,0,0,0,0,0,0,2,2,0,0,0,3,3,6,48,21,69,81
20192020,007,BELL,493,Pineville Independent,"",---District Total---,493,"","",SESC,907,04,24,26,0,0,0,0,0,0,0,0,0,0,1,1,0,0,0,0,1,1,26,22,48,50
20192020,007,BELL,493,Pineville Independent,"",---District Total---,493,"","",SESC,907,05,16,17,0,0,0,0,0,0,0,0,0,0,0,0,0,0,0,0,1,1,17,15,32,33
20192020,007,BELL,493,Pineville Independent,"",---District Total---,493,"","",SESC,907,06,21,20,0,0,0,0,0,0,0,0,0,0,0,0,0,0,0,2,0,2,18,21,39,41
20192020,007,BELL,493,Pineville Independent,"",---District Total---,493,"","",SESC,907,07,23,18,0,0,0,0,0,0,0,0,0,0,1,1,0,0,0,0,1,1,18,21,39,41
20192020,007,BELL,493,Pineville Independent,"",---District Total---,493,"","",SESC,907,08,20,25,2,0,2,0,0,0,0,0,0,1,0,1,0,0,0,0,0,0,22,20,42,45
20192020,007,BELL,493,Pineville Independent,"",---District Total---,493,"","",SESC,907,09,23,30,1,0,1,0,0,0,0,0,0,0,0,0,0,0,0,1,0,1,28,23,51,53
20192020,007,BELL,493,Pineville Independent,"",---District Total---,493,"","",SESC,907,10,21,23,1,0,1,0,0,0,0,0,0,0,0,0,0,0,0,0,0,0,22,21,43,44
20192020,007,BELL,493,Pineville Independent,"",---District Total---,493,"","",SESC,907,12,34,31,2,0,2,0,0,0,0,0,0,0,0,0,0,0,0,1,0,1,28,34,62,65
20192020,007,BELL,493,Pineville Independent,"",---District Total---,493,"","",SESC,907,11,19,25,1,0,1,0,0,0,0,0,0,0,0,0,0,0,0,0,1,1,24,18,42,44
20192020,007,BELL,493,Pineville Independent,"",---District Total---,493,"","",SESC,907,All Students,274,283,8,0,8,0,0,0,0,1,1,2,2,4,0,0,0,5,4,9,268,267,535,557
20192020,007,BELL,493,Pineville Independent,"",---District Total---,493,"","",SESC,907,PS,15,22,1,0,1,0,0,0,0,0,0,2,1,3,0,0,0,0,0,0,19,14,33,37
20192020,007,BELL,493,Pineville Independent,"",---District Total---,493,"","",SESC,907,KG,18,14,1,0,1,0,0,0,0,1,1,1,0,1,0,0,0,0,0,0,12,17,29,32
20192020,007,BELL,493,Pineville Independent,"",---District Total---,493,"","",SESC,907,01,18,13,0,0,0,0,0,0,0,0,0,0,0,0,0,0,0,0,0,0,13,18,31,31
20192020,007,BELL,493,Pineville Independent,"",---District Total---,493,"","",SESC,907,02,21,18,0,0,0,0,0,0,0,0,0,0,0,0,0,0,0,0,0,0,18,21,39,39
20192020,007,BELL,493,Pineville Independent,"",---District Total---,493,"","",SESC,907,03,16,23,0,0,0,0,0,0,0,0,0,0,0,0,0,0,0,1,0,1,22,16,38,39
20192020,007,BELL,493,Pineville Independent,030,Pineville Independent School,493030,007493030,210486002393,SESC,907,08,20,25,2,0,2,0,0,0,0,0,0,1,0,1,0,0,0,0,0,0,22,20,42,45
20192020,007,BELL,493,Pineville Independent,030,Pineville Independent School,493030,007493030,210486002393,SESC,907,All Students,274,283,8,0,8,0,0,0,0,1,1,2,2,4,0,0,0,5,4,9,268,267,535,557
20192020,007,BELL,493,Pineville Independent,030,Pineville Independent School,493030,007493030,210486002393,SESC,907,PS,15,22,1,0,1,0,0,0,0,0,0,2,1,3,0,0,0,0,0,0,19,14,33,37
20192020,007,BELL,493,Pineville Independent,030,Pineville Independent School,493030,007493030,210486002393,SESC,907,KG,18,14,1,0,1,0,0,0,0,1,1,1,0,1,0,0,0,0,0,0,12,17,29,32
20192020,007,BELL,493,Pineville Independent,030,Pineville Independent School,493030,007493030,210486002393,SESC,907,01,18,13,0,0,0,0,0,0,0,0,0,0,0,0,0,0,0,0,0,0,13,18,31,31
20192020,007,BELL,493,Pineville Independent,030,Pineville Independent School,493030,007493030,210486002393,SESC,907,02,21,18,0,0,0,0,0,0,0,0,0,0,0,0,0,0,0,0,0,0,18,21,39,39
20192020,007,BELL,493,Pineville Independent,030,Pineville Independent School,493030,007493030,210486002393,SESC,907,11,19,25,1,0,1,0,0,0,0,0,0,0,0,0,0,0,0,0,1,1,24,18,42,44
20192020,007,BELL,493,Pineville Independent,030,Pineville Independent School,493030,007493030,210486002393,SESC,907,03,16,23,0,0,0,0,0,0,0,0,0,0,0,0,0,0,0,1,0,1,22,16,38,39
20192020,007,BELL,493,Pineville Independent,030,Pineville Independent School,493030,007493030,210486002393,SESC,907,04,24,26,0,0,0,0,0,0,0,0,0,0,1,1,0,0,0,0,1,1,26,22,48,50
20192020,007,BELL,493,Pineville Independent,030,Pineville Independent School,493030,007493030,210486002393,SESC,907,05,16,17,0,0,0,0,0,0,0,0,0,0,0,0,0,0,0,0,1,1,17,15,32,33
20192020,007,BELL,493,Pineville Independent,030,Pineville Independent School,493030,007493030,210486002393,SESC,907,12,34,31,2,0,2,0,0,0,0,0,0,0,0,0,0,0,0,1,0,1,28,34,62,65
20192020,007,BELL,493,Pineville Independent,030,Pineville Independent School,493030,007493030,210486002393,SESC,907,06,21,20,0,0,0,0,0,0,0,0,0,0,0,0,0,0,0,2,0,2,18,21,39,41
20192020,007,BELL,493,Pineville Independent,030,Pineville Independent School,493030,007493030,210486002393,SESC,907,10,21,23,1,0,1,0,0,0,0,0,0,0,0,0,0,0,0,0,0,0,22,21,43,44
20192020,007,BELL,493,Pineville Independent,030,Pineville Independent School,493030,007493030,210486002393,SESC,907,07,23,18,0,0,0,0,0,0,0,0,0,0,1,1,0,0,0,0,1,1,18,21,39,41
20192020,007,BELL,493,Pineville Independent,030,Pineville Independent School,493030,007493030,210486002393,SESC,907,09,23,30,1,0,1,0,0,0,0,0,0,0,0,0,0,0,0,1,0,1,28,23,51,53
20192020,099,POWELL,495,Powell County,"",---District Total---,495,"","",CKEC,901,06,78,90,2,0,2,0,0,0,0,0,0,0,0,0,0,0,0,1,1,2,87,77,164,168
20192020,099,POWELL,495,Powell County,"",---District Total---,495,"","",CKEC,901,All Students,1026,1139,18,5,23,0,0,0,1,0,1,21,27,48,0,1,1,13,9,22,1086,984,2070,2165
20192020,099,POWELL,495,Powell County,"",---District Total---,495,"","",CKEC,901,PS,32,64,1,0,1,0,0,0,0,0,0,1,0,1,0,0,0,0,0,0,62,32,94,96
20192020,099,POWELL,495,Powell County,"",---District Total---,495,"","",CKEC,901,KG,89,94,1,2,3,0,0,0,0,0,0,1,0,1,0,0,0,1,2,3,91,85,176,183
20192020,099,POWELL,495,Powell County,"",---District Total---,495,"","",CKEC,901,01,74,74,0,0,0,0,0,0,0,0,0,2,4,6,0,0,0,2,2,4,70,68,138,148
20192020,099,POWELL,495,Powell County,"",---District Total---,495,"","",CKEC,901,02,70,83,2,1,3,0,0,0,0,0,0,2,3,5,0,0,0,1,0,1,78,66,144,153
20192020,099,POWELL,495,Powell County,"",---District Total---,495,"","",CKEC,901,03,73,81,1,0,1,0,0,0,0,0,0,2,5,7,0,0,0,1,0,1,77,68,145,154
20192020,099,POWELL,495,Powell County,"",---District Total---,495,"","",CKEC,901,04,80,81,0,1,1,0,0,0,0,0,0,0,0,0,0,0,0,0,1,1,81,78,159,161
20192020,099,POWELL,495,Powell County,"",---District Total---,495,"","",CKEC,901,05,74,88,1,0,1,0,0,0,0,0,0,2,1,3,0,0,0,0,1,1,85,72,157,162
20192020,099,POWELL,495,Powell County,"",---District Total---,495,"","",CKEC,901,07,94,117,0,0,0,0,0,0,0,0,0,5,3,8,0,0,0,1,0,1,111,91,202,211
20192020,099,POWELL,495,Powell County,"",---District Total---,495,"","",CKEC,901,08,83,88,2,1,3,0,0,0,0,0,0,0,5,5,0,1,1,3,0,3,83,76,159,171
20192020,099,POWELL,495,Powell County,"",---District Total---,495,"","",CKEC,901,09,82,88,4,0,4,0,0,0,0,0,0,0,2,2,0,0,0,1,2,3,83,78,161,170
20192020,099,POWELL,495,Powell County,"",---District Total---,495,"","",CKEC,901,10,82,89,2,0,2,0,0,0,0,0,0,0,2,2,0,0,0,0,0,0,87,80,167,171
20192020,099,POWELL,495,Powell County,"",---District Total---,495,"","",CKEC,901,11,76,79,1,0,1,0,0,0,1,0,1,2,1,3,0,0,0,2,0,2,73,75,148,155
20192020,099,POWELL,495,Powell County,"",---District Total---,495,"","",CKEC,901,12,71,87,2,0,2,0,0,0,0,0,0,5,1,6,0,0,0,0,0,0,80,70,150,158
20192020,099,POWELL,495,Powell County,010,Bowen Elementary School,495010,099495010,210489001217,CKEC,901,05,18,19,0,0,0,0,0,0,0,0,0,1,0,1,0,0,0,0,0,0,18,18,36,37
20192020,099,POWELL,495,Powell County,010,Bowen Elementary School,495010,099495010,210489001217,CKEC,901,All Students,102,102,2,1,3,0,0,0,0,0,0,2,4,6,0,0,0,2,3,5,96,94,190,204
20192020,099,POWELL,495,Powell County,010,Bowen Elementary School,495010,099495010,210489001217,CKEC,901,PS,5,15,0,0,0,0,0,0,0,0,0,0,0,0,0,0,0,0,0,0,15,5,20,20
20192020,099,POWELL,495,Powell County,010,Bowen Elementary School,495010,099495010,210489001217,CKEC,901,KG,20,21,0,1,1,0,0,0,0,0,0,0,0,0,0,0,0,1,1,2,20,18,38,41
20192020,099,POWELL,495,Powell County,010,Bowen Elementary School,495010,099495010,210489001217,CKEC,901,01,20,18,0,0,0,0,0,0,0,0,0,0,1,1,0,0,0,1,2,3,17,17,34,38
20192020,099,POWELL,495,Powell County,010,Bowen Elementary School,495010,099495010,210489001217,CKEC,901,02,12,14,1,0,1,0,0,0,0,0,0,1,1,2,0,0,0,0,0,0,12,11,23,26
20192020,099,POWELL,495,Powell County,010,Bowen Elementary School,495010,099495010,210489001217,CKEC,901,03,11,11,1,0,1,0,0,0,0,0,0,0,2,2,0,0,0,0,0,0,10,9,19,22
20192020,099,POWELL,495,Powell County,010,Bowen Elementary School,495010,099495010,210489001217,CKEC,901,04,21,19,0,0,0,0,0,0,0,0,0,0,0,0,0,0,0,0,0,0,19,21,40,40
20192020,099,POWELL,495,Powell County,012,Powell County Academy,495012,099495012,210489002360,CKEC,901,11,0,4,0,0,0,0,0,0,0,0,0,0,0,0,0,0,0,0,0,0,4,0,4,4
20192020,099,POWELL,495,Powell County,012,Powell County Academy,495012,099495012,210489002360,CKEC,901,All Students,6,13,0,0,0,0,0,0,0,0,0,0,0,0,0,0,0,0,0,0,13,6,19,19
20192020,099,POWELL,495,Powell County,012,Powell County Academy,495012,099495012,210489002360,CKEC,901,07,1,2,0,0,0,0,0,0,0,0,0,0,0,0,0,0,0,0,0,0,2,1,3,3
20192020,099,POWELL,495,Powell County,012,Powell County Academy,495012,099495012,210489002360,CKEC,901,08,0,2,0,0,0,0,0,0,0,0,0,0,0,0,0,0,0,0,0,0,2,0,2,2
20192020,099,POWELL,495,Powell County,012,Powell County Academy,495012,099495012,210489002360,CKEC,901,09,1,1,0,0,0,0,0,0,0,0,0,0,0,0,0,0,0,0,0,0,1,1,2,2
20192020,099,POWELL,495,Powell County,012,Powell County Academy,495012,099495012,210489002360,CKEC,901,10,1,2,0,0,0,0,0,0,0,0,0,0,0,0,0,0,0,0,0,0,2,1,3,3
20192020,099,POWELL,495,Powell County,012,Powell County Academy,495012,099495012,210489002360,CKEC,901,12,3,2,0,0,0,0,0,0,0,0,0,0,0,0,0,0,0,0,0,0,2,3,5,5
20192020,099,POWELL,495,Powell County,015,Powell County Middle School,495015,099495015,210489001218,CKEC,901,07,93,115,0,0,0,0,0,0,0,0,0,5,3,8,0,0,0,1,0,1,109,90,199,208
20192020,099,POWELL,495,Powell County,015,Powell County Middle School,495015,099495015,210489001218,CKEC,901,All Students,254,291,4,1,5,0,0,0,0,0,0,5,8,13,0,1,1,5,1,6,277,243,520,545
20192020,099,POWELL,495,Powell County,015,Powell County Middle School,495015,099495015,210489001218,CKEC,901,06,78,90,2,0,2,0,0,0,0,0,0,0,0,0,0,0,0,1,1,2,87,77,164,168
20192020,099,POWELL,495,Powell County,015,Powell County Middle School,495015,099495015,210489001218,CKEC,901,08,83,86,2,1,3,0,0,0,0,0,0,0,5,5,0,1,1,3,0,3,81,76,157,169
20192020,099,POWELL,495,Powell County,020,Clay City Elementary School,495020,099495020,210489001219,CKEC,901,04,32,33,0,1,1,0,0,0,0,0,0,0,0,0,0,0,0,0,0,0,33,31,64,65
20192020,099,POWELL,495,Powell County,020,Clay City Elementary School,495020,099495020,210489001219,CKEC,901,All Students,206,222,1,2,3,0,0,0,0,0,0,3,5,8,0,0,0,1,2,3,217,197,414,428
20192020,099,POWELL,495,Powell County,020,Clay City Elementary School,495020,099495020,210489001219,CKEC,901,PS,12,28,1,0,1,0,0,0,0,0,0,0,0,0,0,0,0,0,0,0,27,12,39,40
20192020,099,POWELL,495,Powell County,020,Clay City Elementary School,495020,099495020,210489001219,CKEC,901,KG,37,45,1,1,2,0,0,0,0,0,0,1,0,1,0,0,0,0,1,1,43,35,78,82
20192020,099,POWELL,495,Powell County,020,Clay City Elementary School,495020,099495020,210489001219,CKEC,901,01,32,35,0,0,0,0,0,0,0,0,0,1,1,2,0,0,0,1,0,1,33,31,64,67
20192020,099,POWELL,495,Powell County,020,Clay City Elementary School,495020,099495020,210489001219,CKEC,901,02,33,40,0,0,0,0,0,0,0,0,0,1,1,2,0,0,0,0,0,0,39,32,71,73
20192020,099,POWELL,495,Powell County,020,Clay City Elementary School,495020,099495020,210489001219,CKEC,901,03,43,34,0,0,0,0,0,0,0,0,0,0,2,2,0,0,0,0,0,0,34,41,75,77
20192020,099,POWELL,495,Powell County,020,Clay City Elementary School,495020,099495020,210489001219,CKEC,901,05,29,35,0,0,0,0,0,0,0,0,0,0,1,1,0,0,0,0,1,1,35,27,62,64
20192020,099,POWELL,495,Powell County,040,Powell County High School,495040,099495040,210489001220,CKEC,901,11,76,75,1,0,1,0,0,0,1,0,1,2,1,3,0,0,0,2,0,2,69,75,144,151
20192020,099,POWELL,495,Powell County,040,Powell County High School,495040,099495040,210489001220,CKEC,901,All Students,306,334,9,0,9,0,0,0,1,0,1,7,6,13,0,0,0,3,2,5,314,298,612,640
20192020,099,POWELL,495,Powell County,040,Powell County High School,495040,099495040,210489001220,CKEC,901,09,81,87,4,0,4,0,0,0,0,0,0,0,2,2,0,0,0,1,2,3,82,77,159,168
20192020,099,POWELL,495,Powell County,040,Powell County High School,495040,099495040,210489001220,CKEC,901,10,81,87,2,0,2,0,0,0,0,0,0,0,2,2,0,0,0,0,0,0,85,79,164,168
20192020,099,POWELL,495,Powell County,040,Powell County High School,495040,099495040,210489001220,CKEC,901,12,68,85,2,0,2,0,0,0,0,0,0,5,1,6,0,0,0,0,0,0,78,67,145,153
20192020,099,POWELL,495,Powell County,060,Stanton Elementary School,495060,099495060,210489001221,CKEC,901,04,27,29,0,0,0,0,0,0,0,0,0,0,0,0,0,0,0,0,1,1,29,26,55,56
20192020,099,POWELL,495,Powell County,060,Stanton Elementary School,495060,099495060,210489001221,CKEC,901,All Students,152,177,2,1,3,0,0,0,0,0,0,4,4,8,0,0,0,2,1,3,169,146,315,329
20192020,099,POWELL,495,Powell County,060,Stanton Elementary School,495060,099495060,210489001221,CKEC,901,PS,15,21,0,0,0,0,0,0,0,0,0,1,0,1,0,0,0,0,0,0,20,15,35,36
20192020,099,POWELL,495,Powell County,060,Stanton Elementary School,495060,099495060,210489001221,CKEC,901,KG,32,28,0,0,0,0,0,0,0,0,0,0,0,0,0,0,0,0,0,0,28,32,60,60
20192020,099,POWELL,495,Powell County,060,Stanton Elementary School,495060,099495060,210489001221,CKEC,901,01,22,21,0,0,0,0,0,0,0,0,0,1,2,3,0,0,0,0,0,0,20,20,40,43
20192020,099,POWELL,495,Powell County,060,Stanton Elementary School,495060,099495060,210489001221,CKEC,901,02,25,29,1,1,2,0,0,0,0,0,0,0,1,1,0,0,0,1,0,1,27,23,50,54
20192020,099,POWELL,495,Powell County,060,Stanton Elementary School,495060,099495060,210489001221,CKEC,901,03,19,36,0,0,0,0,0,0,0,0,0,2,1,3,0,0,0,1,0,1,33,18,51,55
20192020,099,POWELL,495,Powell County,060,Stanton Elementary School,495060,099495060,210489001221,CKEC,901,05,27,34,1,0,1,0,0,0,0,0,0,1,0,1,0,0,0,0,0,0,32,27,59,61
20192020,100,PULASKI,501,Pulaski County,"",---District Total---,501,"","",SESC,907,12,310,321,5,2,7,0,0,0,3,1,4,14,17,31,0,0,0,5,6,11,294,284,578,631
20192020,100,PULASKI,501,Pulaski County,"",---District Total---,501,"","",SESC,907,All Students,3928,4192,37,24,61,7,1,8,33,43,76,197,208,405,2,2,4,100,101,201,3816,3549,7365,8120
20192020,100,PULASKI,501,Pulaski County,"",---District Total---,501,"","",SESC,907,PS,195,229,2,0,2,1,0,1,3,4,7,16,10,26,0,1,1,7,8,15,200,172,372,424
20192020,100,PULASKI,501,Pulaski County,"",---District Total---,501,"","",SESC,907,KG,267,276,1,0,1,0,0,0,3,3,6,13,11,24,0,0,0,7,13,20,252,240,492,543
20192020,100,PULASKI,501,Pulaski County,"",---District Total---,501,"","",SESC,907,01,304,308,2,1,3,2,0,2,2,2,4,7,20,27,0,0,0,6,9,15,289,272,561,612
20192020,100,PULASKI,501,Pulaski County,"",---District Total---,501,"","",SESC,907,02,248,301,1,1,2,1,0,1,1,3,4,17,13,30,1,0,1,9,5,14,271,226,497,549
20192020,100,PULASKI,501,Pulaski County,"",---District Total---,501,"","",SESC,907,03,280,313,1,1,2,1,0,1,4,4,8,22,19,41,1,0,1,8,7,15,276,249,525,593
20192020,100,PULASKI,501,Pulaski County,"",---District Total---,501,"","",SESC,907,04,284,311,4,0,4,0,0,0,2,3,5,13,18,31,0,1,1,11,10,21,281,252,533,595
20192020,100,PULASKI,501,Pulaski County,"",---District Total---,501,"","",SESC,907,05,328,330,0,4,4,1,0,1,0,4,4,15,16,31,0,0,0,11,10,21,303,294,597,658
20192020,100,PULASKI,501,Pulaski County,"",---District Total---,501,"","",SESC,907,06,318,325,0,2,2,0,0,0,4,3,7,16,20,36,0,0,0,7,10,17,298,283,581,643
20192020,100,PULASKI,501,Pulaski County,"",---District Total---,501,"","",SESC,907,07,317,332,3,4,7,0,0,0,2,5,7,14,21,35,0,0,0,9,7,16,304,280,584,649
20192020,100,PULASKI,501,Pulaski County,"",---District Total---,501,"","",SESC,907,08,313,325,5,4,9,0,0,0,2,2,4,15,16,31,0,1,1,6,10,16,297,280,577,638
20192020,100,PULASKI,501,Pulaski County,"",---District Total---,501,"","",SESC,907,09,355,370,8,2,10,2,0,2,3,5,8,14,16,30,0,0,0,6,7,13,337,325,662,725
20192020,100,PULASKI,501,Pulaski County,"",---District Total---,501,"","",SESC,907,10,305,344,4,1,5,0,0,0,2,4,6,24,14,38,0,0,0,9,3,12,305,283,588,649
20192020,100,PULASKI,501,Pulaski County,"",---District Total---,501,"","",SESC,907,11,296,333,3,2,5,0,1,1,5,4,9,13,7,20,0,0,0,6,4,10,306,278,584,629
20192020,100,PULASKI,501,Pulaski County,"",---District Total---,501,"","",SESC,907,14,3,3,0,0,0,0,0,0,0,0,0,0,0,0,0,0,0,0,0,0,3,3,6,6
20192020,100,PULASKI,501,Pulaski County,070,Burnside Elementary School,501070,100501070,210495001225,SESC,907,05,36,36,0,0,0,0,0,0,0,0,0,0,2,2,0,0,0,1,0,1,35,34,69,72
20192020,100,PULASKI,501,Pulaski County,070,Burnside Elementary School,501070,100501070,210495001225,SESC,907,All Students,183,206,2,0,2,2,0,2,0,0,0,2,5,7,0,0,0,4,5,9,196,173,369,389
20192020,100,PULASKI,501,Pulaski County,070,Burnside Elementary School,501070,100501070,210495001225,SESC,907,PS,23,23,1,0,1,0,0,0,0,0,0,1,1,2,0,0,0,0,2,2,21,20,41,46
20192020,100,PULASKI,501,Pulaski County,070,Burnside Elementary School,501070,100501070,210495001225,SESC,907,KG,27,35,0,0,0,0,0,0,0,0,0,0,0,0,0,0,0,0,1,1,35,26,61,62
20192020,100,PULASKI,501,Pulaski County,070,Burnside Elementary School,501070,100501070,210495001225,SESC,907,01,33,38,0,0,0,1,0,1,0,0,0,0,1,1,0,0,0,1,0,1,36,32,68,71
20192020,100,PULASKI,501,Pulaski County,070,Burnside Elementary School,501070,100501070,210495001225,SESC,907,02,28,37,1,0,1,0,0,0,0,0,0,0,0,0,0,0,0,1,0,1,35,28,63,65
20192020,100,PULASKI,501,Pulaski County,070,Burnside Elementary School,501070,100501070,210495001225,SESC,907,03,29,28,0,0,0,1,0,1,0,0,0,0,0,0,0,0,0,0,3,3,27,26,53,57
20192020,100,PULASKI,501,Pulaski County,070,Burnside Elementary School,501070,100501070,210495001225,SESC,907,04,30,32,1,0,1,0,0,0,0,0,0,2,2,4,0,0,0,1,1,2,28,27,55,62
20192020,100,PULASKI,501,Pulaski County,071,Pulaski Day Treatment~Eagle Academy,501071,100501071,210495001554,SESC,907,11,1,10,1,0,1,0,0,0,0,0,0,0,0,0,0,0,0,1,0,1,8,1,9,11
20192020,100,PULASKI,501,Pulaski County,071,Pulaski Day Treatment~Eagle Academy,501071,100501071,210495001554,SESC,907,All Students,4,61,9,0,9,0,0,0,0,0,0,3,0,3,0,0,0,3,0,3,46,4,50,65
20192020,100,PULASKI,501,Pulaski County,071,Pulaski Day Treatment~Eagle Academy,501071,100501071,210495001554,SESC,907,07,0,2,1,0,1,0,0,0,0,0,0,0,0,0,0,0,0,1,0,1,0,0,0,2
20192020,100,PULASKI,501,Pulaski County,071,Pulaski Day Treatment~Eagle Academy,501071,100501071,210495001554,SESC,907,08,1,5,1,0,1,0,0,0,0,0,0,0,0,0,0,0,0,1,0,1,3,1,4,6
20192020,100,PULASKI,501,Pulaski County,071,Pulaski Day Treatment~Eagle Academy,501071,100501071,210495001554,SESC,907,09,2,20,2,0,2,0,0,0,0,0,0,1,0,1,0,0,0,0,0,0,17,2,19,22
20192020,100,PULASKI,501,Pulaski County,071,Pulaski Day Treatment~Eagle Academy,501071,100501071,210495001554,SESC,907,10,0,11,1,0,1,0,0,0,0,0,0,2,0,2,0,0,0,0,0,0,8,0,8,11
20192020,100,PULASKI,501,Pulaski County,071,Pulaski Day Treatment~Eagle Academy,501071,100501071,210495001554,SESC,907,12,0,13,3,0,3,0,0,0,0,0,0,0,0,0,0,0,0,0,0,0,10,0,10,13
20192020,100,PULASKI,501,Pulaski County,099,Memorial Education Center,501099,100501099,210495002065,SESC,907,All Students,0,0,0,0,0,0,0,0,0,0,0,0,0,0,0,0,0,0,0,0,0,0,0,0
20192020,100,PULASKI,501,Pulaski County,099,Memorial Education Center,501099,100501099,210495002065,SESC,907,PS,123,149,1,0,1,1,0,1,3,4,7,10,8,18,0,1,1,5,5,10,129,105,234,272
20192020,100,PULASKI,501,Pulaski County,180,Eubank Elementary School,501180,100501180,210495001227,SESC,907,04,25,20,0,0,0,0,0,0,0,0,0,0,3,3,0,0,0,0,2,2,20,20,40,45
20192020,100,PULASKI,501,Pulaski County,180,Eubank Elementary School,501180,100501180,210495001227,SESC,907,All Students,149,139,0,0,0,1,0,1,0,0,0,13,14,27,1,0,1,2,5,7,122,130,252,288
20192020,100,PULASKI,501,Pulaski County,180,Eubank Elementary School,501180,100501180,210495001227,SESC,907,PS,10,18,0,0,0,0,0,0,0,0,0,3,0,3,0,0,0,0,0,0,15,10,25,28
20192020,100,PULASKI,501,Pulaski County,180,Eubank Elementary School,501180,100501180,210495001227,SESC,907,KG,23,17,0,0,0,0,0,0,0,0,0,2,2,4,0,0,0,0,1,1,15,20,35,40
20192020,100,PULASKI,501,Pulaski County,180,Eubank Elementary School,501180,100501180,210495001227,SESC,907,01,24,24,0,0,0,0,0,0,0,0,0,0,2,2,0,0,0,0,1,1,24,21,45,48
20192020,100,PULASKI,501,Pulaski County,180,Eubank Elementary School,501180,100501180,210495001227,SESC,907,02,21,27,0,0,0,1,0,1,0,0,0,3,3,6,0,0,0,1,1,2,22,17,39,48
20192020,100,PULASKI,501,Pulaski County,180,Eubank Elementary School,501180,100501180,210495001227,SESC,907,03,29,27,0,0,0,0,0,0,0,0,0,7,2,9,1,0,1,1,0,1,18,27,45,56
20192020,100,PULASKI,501,Pulaski County,180,Eubank Elementary School,501180,100501180,210495001227,SESC,907,05,27,24,0,0,0,0,0,0,0,0,0,1,2,3,0,0,0,0,0,0,23,25,48,51
20192020,100,PULASKI,501,Pulaski County,280,Nancy Elementary School,501280,100501280,210495001231,SESC,907,05,28,36,0,0,0,0,0,0,0,0,0,0,1,1,0,0,0,0,0,0,36,27,63,64
20192020,100,PULASKI,501,Pulaski County,280,Nancy Elementary School,501280,100501280,210495001231,SESC,907,All Students,174,183,0,0,0,0,0,0,0,1,1,0,3,3,0,0,0,2,1,3,181,169,350,357
20192020,100,PULASKI,501,Pulaski County,280,Nancy Elementary School,501280,100501280,210495001231,SESC,907,PS,10,15,0,0,0,0,0,0,0,0,0,0,0,0,0,0,0,0,0,0,15,10,25,25
20192020,100,PULASKI,501,Pulaski County,280,Nancy Elementary School,501280,100501280,210495001231,SESC,907,KG,27,23,0,0,0,0,0,0,0,0,0,0,0,0,0,0,0,1,0,1,22,27,49,50
20192020,100,PULASKI,501,Pulaski County,280,Nancy Elementary School,501280,100501280,210495001231,SESC,907,01,37,34,0,0,0,0,0,0,0,0,0,0,0,0,0,0,0,0,0,0,34,37,71,71
20192020,100,PULASKI,501,Pulaski County,280,Nancy Elementary School,501280,100501280,210495001231,SESC,907,02,27,27,0,0,0,0,0,0,0,0,0,0,1,1,0,0,0,0,0,0,27,26,53,54
20192020,100,PULASKI,501,Pulaski County,280,Nancy Elementary School,501280,100501280,210495001231,SESC,907,03,24,32,0,0,0,0,0,0,0,0,0,0,0,0,0,0,0,0,0,0,32,24,56,56
20192020,100,PULASKI,501,Pulaski County,280,Nancy Elementary School,501280,100501280,210495001231,SESC,907,04,31,31,0,0,0,0,0,0,0,1,1,0,1,1,0,0,0,1,1,2,30,28,58,62
20192020,100,PULASKI,501,Pulaski County,380,Pulaski County High School,501380,100501380,210495001233,SESC,907,09,158,164,1,0,1,0,0,0,1,0,1,6,6,12,0,0,0,2,3,5,154,149,303,322
20192020,100,PULASKI,501,Pulaski County,380,Pulaski County High School,501380,100501380,210495001233,SESC,907,All Students,608,642,4,1,5,0,0,0,5,1,6,30,24,54,0,0,0,11,8,19,592,574,1166,1250
20192020,100,PULASKI,501,Pulaski County,380,Pulaski County High School,501380,100501380,210495001233,SESC,907,10,149,165,1,0,1,0,0,0,0,1,1,8,3,11,0,0,0,6,0,6,150,145,295,314
20192020,100,PULASKI,501,Pulaski County,380,Pulaski County High School,501380,100501380,210495001233,SESC,907,11,149,167,2,1,3,0,0,0,2,0,2,7,4,11,0,0,0,1,1,2,155,143,298,316
20192020,100,PULASKI,501,Pulaski County,380,Pulaski County High School,501380,100501380,210495001233,SESC,907,12,150,145,0,0,0,0,0,0,2,0,2,9,11,20,0,0,0,2,4,6,132,135,267,295
20192020,100,PULASKI,501,Pulaski County,380,Pulaski County High School,501380,100501380,210495001233,SESC,907,14,2,1,0,0,0,0,0,0,0,0,0,0,0,0,0,0,0,0,0,0,1,2,3,3
20192020,100,PULASKI,501,Pulaski County,385,Pulaski Elementary School,501385,100501385,210495001234,SESC,907,05,59,57,0,1,1,0,0,0,0,0,0,4,3,7,0,0,0,1,2,3,52,53,105,116
20192020,100,PULASKI,501,Pulaski County,385,Pulaski Elementary School,501385,100501385,210495001234,SESC,907,All Students,284,316,0,2,2,1,0,1,2,1,3,20,24,44,1,1,2,9,6,15,283,250,533,600
20192020,100,PULASKI,501,Pulaski County,385,Pulaski Elementary School,501385,100501385,210495001234,SESC,907,KG,48,48,0,0,0,0,0,0,0,0,0,4,3,7,0,0,0,0,3,3,44,42,86,96
20192020,100,PULASKI,501,Pulaski County,385,Pulaski Elementary School,501385,100501385,210495001234,SESC,907,01,50,47,0,1,1,1,0,1,0,0,0,3,5,8,0,0,0,3,0,3,40,44,84,97
20192020,100,PULASKI,501,Pulaski County,385,Pulaski Elementary School,501385,100501385,210495001234,SESC,907,02,36,56,0,0,0,0,0,0,0,1,1,3,4,7,1,0,1,1,0,1,51,31,82,92
20192020,100,PULASKI,501,Pulaski County,385,Pulaski Elementary School,501385,100501385,210495001234,SESC,907,03,40,47,0,0,0,0,0,0,2,0,2,3,5,8,0,0,0,1,0,1,41,35,76,87
20192020,100,PULASKI,501,Pulaski County,385,Pulaski Elementary School,501385,100501385,210495001234,SESC,907,04,51,61,0,0,0,0,0,0,0,0,0,3,4,7,0,1,1,3,1,4,55,45,100,112
20192020,100,PULASKI,501,Pulaski County,390,Southern Middle School,501390,100501390,210495001572,SESC,907,07,176,186,1,3,4,0,0,0,1,4,5,12,11,23,0,0,0,5,3,8,167,155,322,362
20192020,100,PULASKI,501,Pulaski County,390,Southern Middle School,501390,100501390,210495001572,SESC,907,All Students,498,534,3,8,11,0,0,0,7,9,16,25,29,54,0,0,0,14,14,28,485,438,923,1032
20192020,100,PULASKI,501,Pulaski County,390,Southern Middle School,501390,100501390,210495001572,SESC,907,06,153,181,0,2,2,0,0,0,4,3,7,7,12,19,0,0,0,5,5,10,165,131,296,334
20192020,100,PULASKI,501,Pulaski County,390,Southern Middle School,501390,100501390,210495001572,SESC,907,08,169,167,2,3,5,0,0,0,2,2,4,6,6,12,0,0,0,4,6,10,153,152,305,336
20192020,100,PULASKI,501,Pulaski County,395,Northern Middle School,501395,100501395,210495001573,SESC,907,07,141,144,1,1,2,0,0,0,1,1,2,2,10,12,0,0,0,3,4,7,137,125,262,285
20192020,100,PULASKI,501,Pulaski County,395,Northern Middle School,501395,100501395,210495001573,SESC,907,All Students,449,441,3,2,5,0,0,0,1,1,2,20,28,48,0,1,1,6,13,19,411,404,815,890
20192020,100,PULASKI,501,Pulaski County,395,Northern Middle School,501395,100501395,210495001573,SESC,907,06,165,144,0,0,0,0,0,0,0,0,0,9,8,17,0,0,0,2,5,7,133,152,285,309
20192020,100,PULASKI,501,Pulaski County,395,Northern Middle School,501395,100501395,210495001573,SESC,907,08,143,153,2,1,3,0,0,0,0,0,0,9,10,19,0,1,1,1,4,5,141,127,268,296
20192020,100,PULASKI,501,Pulaski County,400,Southwestern High School,501400,100501400,210495000506,SESC,907,12,160,163,2,2,4,0,0,0,1,1,2,5,6,11,0,0,0,3,2,5,152,149,301,323
20192020,100,PULASKI,501,Pulaski County,400,Southwestern High School,501400,100501400,210495000506,SESC,907,All Students,658,675,9,6,15,2,1,3,8,13,21,32,30,62,0,0,0,14,12,26,610,596,1206,1333
20192020,100,PULASKI,501,Pulaski County,400,Southwestern High School,501400,100501400,210495000506,SESC,907,09,195,186,5,2,7,2,0,2,2,5,7,7,10,17,0,0,0,4,4,8,166,174,340,381
20192020,100,PULASKI,501,Pulaski County,400,Southwestern High School,501400,100501400,210495000506,SESC,907,10,156,168,2,1,3,0,0,0,2,3,5,14,11,25,0,0,0,3,3,6,147,138,285,324
20192020,100,PULASKI,501,Pulaski County,400,Southwestern High School,501400,100501400,210495000506,SESC,907,11,146,156,0,1,1,0,1,1,3,4,7,6,3,9,0,0,0,4,3,7,143,134,277,302
20192020,100,PULASKI,501,Pulaski County,400,Southwestern High School,501400,100501400,210495000506,SESC,907,14,1,2,0,0,0,0,0,0,0,0,0,0,0,0,0,0,0,0,0,0,2,1,3,3
20192020,100,PULASKI,501,Pulaski County,420,Oak Hill Elementary School,501420,100501420,210495000779,SESC,907,04,48,34,1,0,1,0,0,0,1,2,3,0,3,3,0,0,0,2,2,4,30,41,71,82
20192020,100,PULASKI,501,Pulaski County,420,Oak Hill Elementary School,501420,100501420,210495000779,SESC,907,All Students,268,264,2,2,4,0,0,0,3,9,12,9,13,22,0,0,0,9,10,19,241,234,475,532
20192020,100,PULASKI,501,Pulaski County,420,Oak Hill Elementary School,501420,100501420,210495000779,SESC,907,KG,40,43,1,0,1,0,0,0,1,1,2,2,1,3,0,0,0,2,2,4,37,36,73,83
20192020,100,PULASKI,501,Pulaski County,420,Oak Hill Elementary School,501420,100501420,210495000779,SESC,907,01,36,46,0,0,0,0,0,0,1,1,2,1,4,5,0,0,0,0,2,2,44,29,73,82
20192020,100,PULASKI,501,Pulaski County,420,Oak Hill Elementary School,501420,100501420,210495000779,SESC,907,02,44,41,0,0,0,0,0,0,0,0,0,2,2,4,0,0,0,3,0,3,36,42,78,85
20192020,100,PULASKI,501,Pulaski County,420,Oak Hill Elementary School,501420,100501420,210495000779,SESC,907,03,48,46,0,1,1,0,0,0,0,3,3,1,2,3,0,0,0,0,0,0,45,42,87,94
20192020,100,PULASKI,501,Pulaski County,420,Oak Hill Elementary School,501420,100501420,210495000779,SESC,907,05,52,54,0,1,1,0,0,0,0,2,2,3,1,4,0,0,0,2,4,6,49,44,93,106
20192020,100,PULASKI,501,Pulaski County,440,Shopville Elementary School,501440,100501440,210495001235,SESC,907,04,21,25,0,0,0,0,0,0,0,0,0,0,0,0,0,0,0,0,1,1,25,20,45,46
20192020,100,PULASKI,501,Pulaski County,440,Shopville Elementary School,501440,100501440,210495001235,SESC,907,All Students,164,147,0,0,0,1,0,1,1,0,1,4,4,8,0,0,0,2,5,7,139,155,294,311
20192020,100,PULASKI,501,Pulaski County,440,Shopville Elementary School,501440,100501440,210495001235,SESC,907,PS,14,10,0,0,0,0,0,0,0,0,0,0,0,0,0,0,0,2,1,3,8,13,21,24
20192020,100,PULASKI,501,Pulaski County,440,Shopville Elementary School,501440,100501440,210495001235,SESC,907,KG,29,23,0,0,0,0,0,0,1,0,1,0,0,0,0,0,0,0,1,1,22,28,50,52
20192020,100,PULASKI,501,Pulaski County,440,Shopville Elementary School,501440,100501440,210495001235,SESC,907,01,29,24,0,0,0,0,0,0,0,0,0,1,0,1,0,0,0,0,2,2,23,27,50,53
20192020,100,PULASKI,501,Pulaski County,440,Shopville Elementary School,501440,100501440,210495001235,SESC,907,02,18,21,0,0,0,0,0,0,0,0,0,0,0,0,0,0,0,0,0,0,21,18,39,39
20192020,100,PULASKI,501,Pulaski County,440,Shopville Elementary School,501440,100501440,210495001235,SESC,907,03,27,32,0,0,0,0,0,0,0,0,0,1,3,4,0,0,0,2,0,2,29,24,53,59
20192020,100,PULASKI,501,Pulaski County,440,Shopville Elementary School,501440,100501440,210495001235,SESC,907,05,40,22,0,0,0,1,0,1,0,0,0,2,1,3,0,0,0,0,1,1,19,38,57,62
20192020,100,PULASKI,501,Pulaski County,560,Northern Elementary School,501560,100501560,210495001238,SESC,907,04,26,38,0,0,0,0,0,0,0,0,0,2,0,2,0,0,0,1,2,3,35,24,59,64
20192020,100,PULASKI,501,Pulaski County,560,Northern Elementary School,501560,100501560,210495001238,SESC,907,All Students,176,231,1,0,1,0,0,0,0,1,1,9,8,17,0,0,0,8,10,18,213,157,370,407
20192020,100,PULASKI,501,Pulaski County,560,Northern Elementary School,501560,100501560,210495001238,SESC,907,PS,15,14,0,0,0,0,0,0,0,0,0,2,1,3,0,0,0,0,0,0,12,14,26,29
20192020,100,PULASKI,501,Pulaski County,560,Northern Elementary School,501560,100501560,210495001238,SESC,907,KG,28,31,0,0,0,0,0,0,0,0,0,2,2,4,0,0,0,1,0,1,28,26,54,59
20192020,100,PULASKI,501,Pulaski County,560,Northern Elementary School,501560,100501560,210495001238,SESC,907,01,37,37,1,0,1,0,0,0,0,0,0,0,4,4,0,0,0,1,1,2,35,32,67,74
20192020,100,PULASKI,501,Pulaski County,560,Northern Elementary School,501560,100501560,210495001238,SESC,907,02,25,38,0,0,0,0,0,0,0,1,1,2,0,2,0,0,0,0,4,4,36,20,56,63
20192020,100,PULASKI,501,Pulaski County,560,Northern Elementary School,501560,100501560,210495001238,SESC,907,03,30,45,0,0,0,0,0,0,0,0,0,3,2,5,0,0,0,1,1,2,41,27,68,75
20192020,100,PULASKI,501,Pulaski County,560,Northern Elementary School,501560,100501560,210495001238,SESC,907,05,30,42,0,0,0,0,0,0,0,0,0,0,0,0,0,0,0,4,2,6,38,28,66,72
20192020,100,PULASKI,501,Pulaski County,570,Southern Elementary School,501570,100501570,210495001464,SESC,907,05,56,59,0,2,2,0,0,0,0,2,2,5,6,11,0,0,0,3,1,4,51,45,96,115
20192020,100,PULASKI,501,Pulaski County,570,Southern Elementary School,501570,100501570,210495001464,SESC,907,All Students,313,353,4,3,7,0,0,0,6,7,13,30,26,56,0,0,0,16,12,28,297,265,562,666
20192020,100,PULASKI,501,Pulaski County,570,Southern Elementary School,501570,100501570,210495001464,SESC,907,KG,45,56,0,0,0,0,0,0,1,2,3,3,3,6,0,0,0,3,5,8,49,35,84,101
20192020,100,PULASKI,501,Pulaski County,570,Southern Elementary School,501570,100501570,210495001464,SESC,907,01,58,58,1,0,1,0,0,0,1,1,2,2,4,6,0,0,0,1,3,4,53,50,103,116
20192020,100,PULASKI,501,Pulaski County,570,Southern Elementary School,501570,100501570,210495001464,SESC,907,02,49,54,0,1,1,0,0,0,1,1,2,7,3,10,0,0,0,3,0,3,43,44,87,103
20192020,100,PULASKI,501,Pulaski County,570,Southern Elementary School,501570,100501570,210495001464,SESC,907,03,53,56,1,0,1,0,0,0,2,1,3,7,5,12,0,0,0,3,3,6,43,44,87,109
20192020,100,PULASKI,501,Pulaski County,570,Southern Elementary School,501570,100501570,210495001464,SESC,907,04,52,70,2,0,2,0,0,0,1,0,1,6,5,11,0,0,0,3,0,3,58,47,105,122
20192020,045,GREENUP,502,Raceland-Worthington Independent,"",---District Total---,502,"","",KEDC,903,KG,37,44,0,0,0,0,0,0,0,0,0,1,0,1,0,0,0,0,0,0,43,37,80,81
20192020,045,GREENUP,502,Raceland-Worthington Independent,"",---District Total---,502,"","",KEDC,903,All Students,484,499,10,4,14,0,0,0,0,1,1,9,6,15,0,0,0,9,10,19,471,463,934,983
20192020,045,GREENUP,502,Raceland-Worthington Independent,"",---District Total---,502,"","",KEDC,903,PS,42,43,0,0,0,0,0,0,0,0,0,1,0,1,0,0,0,0,0,0,42,42,84,85
20192020,045,GREENUP,502,Raceland-Worthington Independent,"",---District Total---,502,"","",KEDC,903,01,43,38,0,0,0,0,0,0,0,0,0,1,1,2,0,0,0,0,1,1,37,41,78,81
20192020,045,GREENUP,502,Raceland-Worthington Independent,"",---District Total---,502,"","",KEDC,903,02,34,28,0,0,0,0,0,0,0,0,0,1,1,2,0,0,0,0,1,1,27,32,59,62
20192020,045,GREENUP,502,Raceland-Worthington Independent,"",---District Total---,502,"","",KEDC,903,03,29,22,0,0,0,0,0,0,0,0,0,0,1,1,0,0,0,1,0,1,21,28,49,51
20192020,045,GREENUP,502,Raceland-Worthington Independent,"",---District Total---,502,"","",KEDC,903,04,30,30,0,0,0,0,0,0,0,0,0,0,0,0,0,0,0,0,2,2,30,28,58,60
20192020,045,GREENUP,502,Raceland-Worthington Independent,"",---District Total---,502,"","",KEDC,903,05,38,26,0,0,0,0,0,0,0,0,0,2,0,2,0,0,0,0,0,0,24,38,62,64
20192020,045,GREENUP,502,Raceland-Worthington Independent,"",---District Total---,502,"","",KEDC,903,06,38,42,0,1,1,0,0,0,0,0,0,0,2,2,0,0,0,2,2,4,40,33,73,80
20192020,045,GREENUP,502,Raceland-Worthington Independent,"",---District Total---,502,"","",KEDC,903,07,34,44,1,0,1,0,0,0,0,0,0,1,1,2,0,0,0,2,1,3,40,32,72,78
20192020,045,GREENUP,502,Raceland-Worthington Independent,"",---District Total---,502,"","",KEDC,903,08,33,45,1,1,2,0,0,0,0,0,0,1,0,1,0,0,0,2,0,2,41,32,73,78
20192020,045,GREENUP,502,Raceland-Worthington Independent,"",---District Total---,502,"","",KEDC,903,09,49,47,2,0,2,0,0,0,0,1,1,0,0,0,0,0,0,0,1,1,45,47,92,96
20192020,045,GREENUP,502,Raceland-Worthington Independent,"",---District Total---,502,"","",KEDC,903,10,37,46,3,2,5,0,0,0,0,0,0,0,0,0,0,0,0,1,1,2,42,34,76,83
20192020,045,GREENUP,502,Raceland-Worthington Independent,"",---District Total---,502,"","",KEDC,903,11,46,47,0,0,0,0,0,0,0,0,0,1,0,1,0,0,0,1,0,1,45,46,91,93
20192020,045,GREENUP,502,Raceland-Worthington Independent,"",---District Total---,502,"","",KEDC,903,12,36,40,3,0,3,0,0,0,0,0,0,1,0,1,0,0,0,0,1,1,36,35,71,76
20192020,045,GREENUP,502,Raceland-Worthington Independent,010,Campbell Elementary School,502010,045502010,210498001239,KEDC,903,All Students,143,132,0,0,0,0,0,0,0,0,0,3,3,6,0,0,0,1,2,3,128,138,266,275
20192020,045,GREENUP,502,Raceland-Worthington Independent,010,Campbell Elementary School,502010,045502010,210498001239,KEDC,903,KG,37,44,0,0,0,0,0,0,0,0,0,1,0,1,0,0,0,0,0,0,43,37,80,81
20192020,045,GREENUP,502,Raceland-Worthington Independent,010,Campbell Elementary School,502010,045502010,210498001239,KEDC,903,01,43,38,0,0,0,0,0,0,0,0,0,1,1,2,0,0,0,0,1,1,37,41,78,81
20192020,045,GREENUP,502,Raceland-Worthington Independent,010,Campbell Elementary School,502010,045502010,210498001239,KEDC,903,02,34,28,0,0,0,0,0,0,0,0,0,1,1,2,0,0,0,0,1,1,27,32,59,62
20192020,045,GREENUP,502,Raceland-Worthington Independent,010,Campbell Elementary School,502010,045502010,210498001239,KEDC,903,03,29,22,0,0,0,0,0,0,0,0,0,0,1,1,0,0,0,1,0,1,21,28,49,51
20192020,045,GREENUP,502,Raceland-Worthington Independent,010,Campbell Elementary School,502010,045502010,210498001239,KEDC,903,PS,42,43,0,0,0,0,0,0,0,0,0,1,0,1,0,0,0,0,0,0,42,42,84,85
20192020,045,GREENUP,502,Raceland-Worthington Independent,011,Raceland-Worthington Schools Campus B,502011,045502011,210498002015,KEDC,903,10,0,5,3,0,3,0,0,0,0,0,0,0,0,0,0,0,0,0,0,0,2,0,2,5
20192020,045,GREENUP,502,Raceland-Worthington Independent,011,Raceland-Worthington Schools Campus B,502011,045502011,210498002015,KEDC,903,06,0,1,0,0,0,0,0,0,0,0,0,0,0,0,0,0,0,0,0,0,1,0,1,1
20192020,045,GREENUP,502,Raceland-Worthington Independent,011,Raceland-Worthington Schools Campus B,502011,045502011,210498002015,KEDC,903,09,1,2,2,0,2,0,0,0,0,0,0,0,0,0,0,0,0,0,0,0,0,1,1,3
20192020,045,GREENUP,502,Raceland-Worthington Independent,011,Raceland-Worthington Schools Campus B,502011,045502011,210498002015,KEDC,903,All Students,1,8,5,0,5,0,0,0,0,0,0,0,0,0,0,0,0,0,0,0,3,1,4,9
20192020,045,GREENUP,502,Raceland-Worthington Independent,020,Raceland-Worthington High School,502020,045502020,210498001240,KEDC,903,10,37,35,0,2,2,0,0,0,0,0,0,0,0,0,0,0,0,1,1,2,34,34,68,72
20192020,045,GREENUP,502,Raceland-Worthington Independent,020,Raceland-Worthington High School,502020,045502020,210498001240,KEDC,903,12,36,32,2,0,2,0,0,0,0,0,0,0,0,0,0,0,0,0,1,1,30,35,65,68
20192020,045,GREENUP,502,Raceland-Worthington Independent,020,Raceland-Worthington High School,502020,045502020,210498001240,KEDC,903,All Students,230,229,4,3,7,0,0,0,0,1,1,2,1,3,0,0,0,6,3,9,217,222,439,459
20192020,045,GREENUP,502,Raceland-Worthington Independent,020,Raceland-Worthington High School,502020,045502020,210498001240,KEDC,903,07,32,43,1,0,1,0,0,0,0,0,0,1,1,2,0,0,0,2,0,2,39,31,70,75
20192020,045,GREENUP,502,Raceland-Worthington Independent,020,Raceland-Worthington High School,502020,045502020,210498001240,KEDC,903,08,33,41,1,1,2,0,0,0,0,0,0,1,0,1,0,0,0,2,0,2,37,32,69,74
20192020,045,GREENUP,502,Raceland-Worthington Independent,020,Raceland-Worthington High School,502020,045502020,210498001240,KEDC,903,09,47,39,0,0,0,0,0,0,0,1,1,0,0,0,0,0,0,0,1,1,39,45,84,86
20192020,045,GREENUP,502,Raceland-Worthington Independent,020,Raceland-Worthington High School,502020,045502020,210498001240,KEDC,903,11,45,39,0,0,0,0,0,0,0,0,0,0,0,0,0,0,0,1,0,1,38,45,83,84
20192020,045,GREENUP,502,Raceland-Worthington Independent,030,Raceland-Worthington Middle School,502030,045502030,210498001241,KEDC,903,All Students,106,97,0,1,1,0,0,0,0,0,0,2,2,4,0,0,0,2,4,6,93,99,192,203
20192020,045,GREENUP,502,Raceland-Worthington Independent,030,Raceland-Worthington Middle School,502030,045502030,210498001241,KEDC,903,04,30,30,0,0,0,0,0,0,0,0,0,0,0,0,0,0,0,0,2,2,30,28,58,60
20192020,045,GREENUP,502,Raceland-Worthington Independent,030,Raceland-Worthington Middle School,502030,045502030,210498001241,KEDC,903,06,38,41,0,1,1,0,0,0,0,0,0,0,2,2,0,0,0,2,2,4,39,33,72,79
20192020,045,GREENUP,502,Raceland-Worthington Independent,030,Raceland-Worthington Middle School,502030,045502030,210498001241,KEDC,903,05,38,26,0,0,0,0,0,0,0,0,0,2,0,2,0,0,0,0,0,0,24,38,62,64
20192020,045,GREENUP,502,Raceland-Worthington Independent,160,Raceland-Worthington Schools Campus A,502160,045502160,210498001465,KEDC,903,09,1,6,0,0,0,0,0,0,0,0,0,0,0,0,0,0,0,0,0,0,6,1,7,7
20192020,045,GREENUP,502,Raceland-Worthington Independent,160,Raceland-Worthington Schools Campus A,502160,045502160,210498001465,KEDC,903,All Students,4,33,1,0,1,0,0,0,0,0,0,2,0,2,0,0,0,0,1,1,30,3,33,37
20192020,045,GREENUP,502,Raceland-Worthington Independent,160,Raceland-Worthington Schools Campus A,502160,045502160,210498001465,KEDC,903,07,2,1,0,0,0,0,0,0,0,0,0,0,0,0,0,0,0,0,1,1,1,1,2,3
20192020,045,GREENUP,502,Raceland-Worthington Independent,160,Raceland-Worthington Schools Campus A,502160,045502160,210498001465,KEDC,903,08,0,4,0,0,0,0,0,0,0,0,0,0,0,0,0,0,0,0,0,0,4,0,4,4
20192020,045,GREENUP,502,Raceland-Worthington Independent,160,Raceland-Worthington Schools Campus A,502160,045502160,210498001465,KEDC,903,10,0,6,0,0,0,0,0,0,0,0,0,0,0,0,0,0,0,0,0,0,6,0,6,6
20192020,045,GREENUP,502,Raceland-Worthington Independent,160,Raceland-Worthington Schools Campus A,502160,045502160,210498001465,KEDC,903,11,1,8,0,0,0,0,0,0,0,0,0,1,0,1,0,0,0,0,0,0,7,1,8,9
20192020,045,GREENUP,502,Raceland-Worthington Independent,160,Raceland-Worthington Schools Campus A,502160,045502160,210498001465,KEDC,903,12,0,8,1,0,1,0,0,0,0,0,0,1,0,1,0,0,0,0,0,0,6,0,6,8
20192020,101,ROBERTSON,505,Robertson County,"",---District Total---,505,"","",KEDC,903,14,1,0,0,0,0,0,0,0,0,0,0,0,0,0,0,0,0,0,0,0,0,1,1,1
20192020,101,ROBERTSON,505,Robertson County,"",---District Total---,505,"","",KEDC,903,All Students,200,202,1,2,3,0,1,1,0,0,0,5,3,8,0,0,0,0,2,2,196,192,388,402
20192020,101,ROBERTSON,505,Robertson County,"",---District Total---,505,"","",KEDC,903,PS,22,13,0,0,0,0,0,0,0,0,0,0,0,0,0,0,0,0,0,0,13,22,35,35
20192020,101,ROBERTSON,505,Robertson County,"",---District Total---,505,"","",KEDC,903,KG,15,18,0,0,0,0,0,0,0,0,0,0,0,0,0,0,0,0,0,0,18,15,33,33
20192020,101,ROBERTSON,505,Robertson County,"",---District Total---,505,"","",KEDC,903,01,19,9,0,0,0,0,1,1,0,0,0,0,0,0,0,0,0,0,0,0,9,18,27,28
20192020,101,ROBERTSON,505,Robertson County,"",---District Total---,505,"","",KEDC,903,02,17,12,0,0,0,0,0,0,0,0,0,0,0,0,0,0,0,0,0,0,12,17,29,29
20192020,101,ROBERTSON,505,Robertson County,"",---District Total---,505,"","",KEDC,903,03,16,17,0,0,0,0,0,0,0,0,0,0,0,0,0,0,0,0,2,2,17,14,31,33
20192020,101,ROBERTSON,505,Robertson County,"",---District Total---,505,"","",KEDC,903,04,12,9,0,1,1,0,0,0,0,0,0,1,0,1,0,0,0,0,0,0,8,11,19,21
20192020,101,ROBERTSON,505,Robertson County,"",---District Total---,505,"","",KEDC,903,05,11,17,0,0,0,0,0,0,0,0,0,0,0,0,0,0,0,0,0,0,17,11,28,28
20192020,101,ROBERTSON,505,Robertson County,"",---District Total---,505,"","",KEDC,903,06,23,23,0,0,0,0,0,0,0,0,0,0,1,1,0,0,0,0,0,0,23,22,45,46
20192020,101,ROBERTSON,505,Robertson County,"",---District Total---,505,"","",KEDC,903,07,26,12,0,1,1,0,0,0,0,0,0,0,0,0,0,0,0,0,0,0,12,25,37,38
20192020,101,ROBERTSON,505,Robertson County,"",---District Total---,505,"","",KEDC,903,08,13,11,0,0,0,0,0,0,0,0,0,0,0,0,0,0,0,0,0,0,11,13,24,24
20192020,101,ROBERTSON,505,Robertson County,"",---District Total---,505,"","",KEDC,903,09,16,16,0,0,0,0,0,0,0,0,0,1,0,1,0,0,0,0,0,0,15,16,31,32
20192020,101,ROBERTSON,505,Robertson County,"",---District Total---,505,"","",KEDC,903,10,9,13,0,0,0,0,0,0,0,0,0,1,0,1,0,0,0,0,0,0,12,9,21,22
20192020,101,ROBERTSON,505,Robertson County,"",---District Total---,505,"","",KEDC,903,11,10,26,1,0,1,0,0,0,0,0,0,1,1,2,0,0,0,0,0,0,24,9,33,36
20192020,101,ROBERTSON,505,Robertson County,"",---District Total---,505,"","",KEDC,903,12,12,19,0,0,0,0,0,0,0,0,0,1,1,2,0,0,0,0,0,0,18,11,29,31
20192020,101,ROBERTSON,505,Robertson County,010,Robertson County School,505010,101505010,210504001246,KEDC,903,12,12,19,0,0,0,0,0,0,0,0,0,1,1,2,0,0,0,0,0,0,18,11,29,31
20192020,101,ROBERTSON,505,Robertson County,010,Robertson County School,505010,101505010,210504001246,KEDC,903,All Students,200,202,1,2,3,0,1,1,0,0,0,5,3,8,0,0,0,0,2,2,196,192,388,402
20192020,101,ROBERTSON,505,Robertson County,010,Robertson County School,505010,101505010,210504001246,KEDC,903,PS,22,13,0,0,0,0,0,0,0,0,0,0,0,0,0,0,0,0,0,0,13,22,35,35
20192020,101,ROBERTSON,505,Robertson County,010,Robertson County School,505010,101505010,210504001246,KEDC,903,KG,15,18,0,0,0,0,0,0,0,0,0,0,0,0,0,0,0,0,0,0,18,15,33,33
20192020,101,ROBERTSON,505,Robertson County,010,Robertson County School,505010,101505010,210504001246,KEDC,903,01,19,9,0,0,0,0,1,1,0,0,0,0,0,0,0,0,0,0,0,0,9,18,27,28
20192020,101,ROBERTSON,505,Robertson County,010,Robertson County School,505010,101505010,210504001246,KEDC,903,02,17,12,0,0,0,0,0,0,0,0,0,0,0,0,0,0,0,0,0,0,12,17,29,29
20192020,101,ROBERTSON,505,Robertson County,010,Robertson County School,505010,101505010,210504001246,KEDC,903,03,16,17,0,0,0,0,0,0,0,0,0,0,0,0,0,0,0,0,2,2,17,14,31,33
20192020,101,ROBERTSON,505,Robertson County,010,Robertson County School,505010,101505010,210504001246,KEDC,903,04,12,9,0,1,1,0,0,0,0,0,0,1,0,1,0,0,0,0,0,0,8,11,19,21
20192020,101,ROBERTSON,505,Robertson County,010,Robertson County School,505010,101505010,210504001246,KEDC,903,05,11,17,0,0,0,0,0,0,0,0,0,0,0,0,0,0,0,0,0,0,17,11,28,28
20192020,101,ROBERTSON,505,Robertson County,010,Robertson County School,505010,101505010,210504001246,KEDC,903,06,23,23,0,0,0,0,0,0,0,0,0,0,1,1,0,0,0,0,0,0,23,22,45,46
20192020,101,ROBERTSON,505,Robertson County,010,Robertson County School,505010,101505010,210504001246,KEDC,903,07,26,12,0,1,1,0,0,0,0,0,0,0,0,0,0,0,0,0,0,0,12,25,37,38
20192020,101,ROBERTSON,505,Robertson County,010,Robertson County School,505010,101505010,210504001246,KEDC,903,08,13,11,0,0,0,0,0,0,0,0,0,0,0,0,0,0,0,0,0,0,11,13,24,24
20192020,101,ROBERTSON,505,Robertson County,010,Robertson County School,505010,101505010,210504001246,KEDC,903,09,16,16,0,0,0,0,0,0,0,0,0,1,0,1,0,0,0,0,0,0,15,16,31,32
20192020,101,ROBERTSON,505,Robertson County,010,Robertson County School,505010,101505010,210504001246,KEDC,903,10,9,13,0,0,0,0,0,0,0,0,0,1,0,1,0,0,0,0,0,0,12,9,21,22
20192020,101,ROBERTSON,505,Robertson County,010,Robertson County School,505010,101505010,210504001246,KEDC,903,11,10,26,1,0,1,0,0,0,0,0,0,1,1,2,0,0,0,0,0,0,24,9,33,36
20192020,101,ROBERTSON,505,Robertson County,010,Robertson County School,505010,101505010,210504001246,KEDC,903,14,1,0,0,0,0,0,0,0,0,0,0,0,0,0,0,0,0,0,0,0,0,1,1,1
20192020,102,ROCKCASTLE,511,Rockcastle County,"",---District Total---,511,"","",SESC,907,All Students,1339,1344,5,9,14,1,1,2,3,2,5,24,18,42,0,0,0,17,26,43,1294,1283,2577,2683
20192020,102,ROCKCASTLE,511,Rockcastle County,"",---District Total---,511,"","",SESC,907,PS,42,60,2,0,2,0,0,0,0,0,0,0,0,0,0,0,0,1,0,1,57,42,99,102
20192020,102,ROCKCASTLE,511,Rockcastle County,"",---District Total---,511,"","",SESC,907,KG,87,99,0,1,1,0,0,0,0,0,0,1,1,2,0,0,0,3,1,4,95,84,179,186
20192020,102,ROCKCASTLE,511,Rockcastle County,"",---District Total---,511,"","",SESC,907,01,99,110,0,3,3,0,0,0,0,0,0,2,4,6,0,0,0,1,4,5,107,88,195,209
20192020,102,ROCKCASTLE,511,Rockcastle County,"",---District Total---,511,"","",SESC,907,02,120,97,0,0,0,0,0,0,0,0,0,0,2,2,0,0,0,3,3,6,94,115,209,217
20192020,102,ROCKCASTLE,511,Rockcastle County,"",---District Total---,511,"","",SESC,907,03,88,92,0,0,0,0,0,0,1,0,1,2,1,3,0,0,0,1,3,4,88,84,172,180
20192020,102,ROCKCASTLE,511,Rockcastle County,"",---District Total---,511,"","",SESC,907,04,92,93,0,0,0,0,0,0,0,0,0,1,3,4,0,0,0,0,3,3,92,86,178,185
20192020,102,ROCKCASTLE,511,Rockcastle County,"",---District Total---,511,"","",SESC,907,05,106,108,1,0,1,0,0,0,1,0,1,2,2,4,0,0,0,2,1,3,102,103,205,214
20192020,102,ROCKCASTLE,511,Rockcastle County,"",---District Total---,511,"","",SESC,907,06,110,102,0,0,0,0,1,1,0,0,0,4,2,6,0,0,0,2,4,6,96,103,199,212
20192020,102,ROCKCASTLE,511,Rockcastle County,"",---District Total---,511,"","",SESC,907,07,113,106,0,1,1,0,0,0,0,0,0,3,2,5,0,0,0,0,1,1,103,109,212,219
20192020,102,ROCKCASTLE,511,Rockcastle County,"",---District Total---,511,"","",SESC,907,08,108,103,1,0,1,0,0,0,1,0,1,3,0,3,0,0,0,0,2,2,98,106,204,211
20192020,102,ROCKCASTLE,511,Rockcastle County,"",---District Total---,511,"","",SESC,907,09,110,93,2,1,3,0,0,0,0,0,0,2,1,3,0,0,0,1,2,3,88,106,194,203
20192020,102,ROCKCASTLE,511,Rockcastle County,"",---District Total---,511,"","",SESC,907,10,101,118,0,1,1,0,0,0,0,0,0,1,0,1,0,0,0,3,0,3,114,100,214,219
20192020,102,ROCKCASTLE,511,Rockcastle County,"",---District Total---,511,"","",SESC,907,11,95,95,1,2,3,1,0,1,0,1,1,2,0,2,0,0,0,0,0,0,91,92,183,190
20192020,102,ROCKCASTLE,511,Rockcastle County,"",---District Total---,511,"","",SESC,907,12,110,127,0,0,0,0,0,0,0,1,1,1,0,1,0,0,0,1,2,3,125,107,232,237
20192020,102,ROCKCASTLE,511,Rockcastle County,"",---District Total---,511,"","",SESC,907,14,0,1,0,0,0,0,0,0,0,0,0,0,0,0,0,0,0,0,0,0,1,0,1,1
20192020,102,ROCKCASTLE,511,Rockcastle County,020,Brodhead Elementary School,511020,102511020,210507001249,SESC,907,05,37,34,0,0,0,0,0,0,1,0,1,0,0,0,0,0,0,1,0,1,32,37,69,71
20192020,102,ROCKCASTLE,511,Rockcastle County,020,Brodhead Elementary School,511020,102511020,210507001249,SESC,907,All Students,204,174,0,0,0,0,0,0,1,0,1,1,4,5,0,0,0,3,4,7,169,196,365,378
20192020,102,ROCKCASTLE,511,Rockcastle County,020,Brodhead Elementary School,511020,102511020,210507001249,SESC,907,PS,15,29,1,0,1,0,0,0,0,0,0,0,0,0,0,0,0,0,0,0,28,15,43,44
20192020,102,ROCKCASTLE,511,Rockcastle County,020,Brodhead Elementary School,511020,102511020,210507001249,SESC,907,KG,28,33,0,0,0,0,0,0,0,0,0,1,0,1,0,0,0,1,0,1,31,28,59,61
20192020,102,ROCKCASTLE,511,Rockcastle County,020,Brodhead Elementary School,511020,102511020,210507001249,SESC,907,01,32,29,0,0,0,0,0,0,0,0,0,0,2,2,0,0,0,0,1,1,29,29,58,61
20192020,102,ROCKCASTLE,511,Rockcastle County,020,Brodhead Elementary School,511020,102511020,210507001249,SESC,907,02,41,24,0,0,0,0,0,0,0,0,0,0,1,1,0,0,0,0,0,0,24,40,64,65
20192020,102,ROCKCASTLE,511,Rockcastle County,020,Brodhead Elementary School,511020,102511020,210507001249,SESC,907,03,28,30,0,0,0,0,0,0,0,0,0,0,0,0,0,0,0,1,1,2,29,27,56,58
20192020,102,ROCKCASTLE,511,Rockcastle County,020,Brodhead Elementary School,511020,102511020,210507001249,SESC,907,04,38,24,0,0,0,0,0,0,0,0,0,0,1,1,0,0,0,0,2,2,24,35,59,62
20192020,102,ROCKCASTLE,511,Rockcastle County,022,Rockcastle Academy for Academic Achievement,511022,102511022,210507001906,SESC,907,11,7,10,1,0,1,1,0,1,0,0,0,1,0,1,0,0,0,0,0,0,7,7,14,17
20192020,102,ROCKCASTLE,511,Rockcastle County,022,Rockcastle Academy for Academic Achievement,511022,102511022,210507001906,SESC,907,All Students,28,35,1,0,1,1,0,1,0,0,0,1,0,1,0,0,0,0,1,1,32,27,59,63
20192020,102,ROCKCASTLE,511,Rockcastle County,022,Rockcastle Academy for Academic Achievement,511022,102511022,210507001906,SESC,907,07,2,0,0,0,0,0,0,0,0,0,0,0,0,0,0,0,0,0,0,0,0,2,2,2
20192020,102,ROCKCASTLE,511,Rockcastle County,022,Rockcastle Academy for Academic Achievement,511022,102511022,210507001906,SESC,907,08,1,4,0,0,0,0,0,0,0,0,0,0,0,0,0,0,0,0,0,0,4,1,5,5
20192020,102,ROCKCASTLE,511,Rockcastle County,022,Rockcastle Academy for Academic Achievement,511022,102511022,210507001906,SESC,907,09,1,2,0,0,0,0,0,0,0,0,0,0,0,0,0,0,0,0,1,1,2,0,2,3
20192020,102,ROCKCASTLE,511,Rockcastle County,022,Rockcastle Academy for Academic Achievement,511022,102511022,210507001906,SESC,907,10,2,4,0,0,0,0,0,0,0,0,0,0,0,0,0,0,0,0,0,0,4,2,6,6
20192020,102,ROCKCASTLE,511,Rockcastle County,022,Rockcastle Academy for Academic Achievement,511022,102511022,210507001906,SESC,907,12,15,15,0,0,0,0,0,0,0,0,0,0,0,0,0,0,0,0,0,0,15,15,30,30
20192020,102,ROCKCASTLE,511,Rockcastle County,100,Rockcastle County Middle School,511100,102511100,210507000782,SESC,907,07,111,106,0,1,1,0,0,0,0,0,0,3,2,5,0,0,0,0,1,1,103,107,210,217
20192020,102,ROCKCASTLE,511,Rockcastle County,100,Rockcastle County Middle School,511100,102511100,210507000782,SESC,907,All Students,328,307,1,1,2,0,1,1,1,0,1,10,4,14,0,0,0,2,7,9,293,315,608,635
20192020,102,ROCKCASTLE,511,Rockcastle County,100,Rockcastle County Middle School,511100,102511100,210507000782,SESC,907,06,110,102,0,0,0,0,1,1,0,0,0,4,2,6,0,0,0,2,4,6,96,103,199,212
20192020,102,ROCKCASTLE,511,Rockcastle County,100,Rockcastle County Middle School,511100,102511100,210507000782,SESC,907,08,107,99,1,0,1,0,0,0,1,0,1,3,0,3,0,0,0,0,2,2,94,105,199,206
20192020,102,ROCKCASTLE,511,Rockcastle County,170,Mt. Vernon Elementary,511170,102511170,210507001251,SESC,907,03,46,42,0,0,0,0,0,0,1,0,1,2,0,2,0,0,0,0,2,2,39,44,83,88
20192020,102,ROCKCASTLE,511,Rockcastle County,170,Mt. Vernon Elementary,511170,102511170,210507001251,SESC,907,All Students,272,296,0,4,4,0,0,0,1,0,1,5,3,8,0,0,0,3,8,11,287,257,544,568
20192020,102,ROCKCASTLE,511,Rockcastle County,170,Mt. Vernon Elementary,511170,102511170,210507001251,SESC,907,PS,16,18,0,0,0,0,0,0,0,0,0,0,0,0,0,0,0,1,0,1,17,16,33,34
20192020,102,ROCKCASTLE,511,Rockcastle County,170,Mt. Vernon Elementary,511170,102511170,210507001251,SESC,907,KG,44,45,0,1,1,0,0,0,0,0,0,0,1,1,0,0,0,0,1,1,45,41,86,89
20192020,102,ROCKCASTLE,511,Rockcastle County,170,Mt. Vernon Elementary,511170,102511170,210507001251,SESC,907,01,47,54,0,3,3,0,0,0,0,0,0,1,0,1,0,0,0,0,2,2,53,42,95,101
20192020,102,ROCKCASTLE,511,Rockcastle County,170,Mt. Vernon Elementary,511170,102511170,210507001251,SESC,907,02,54,54,0,0,0,0,0,0,0,0,0,0,0,0,0,0,0,2,2,4,52,52,104,108
20192020,102,ROCKCASTLE,511,Rockcastle County,170,Mt. Vernon Elementary,511170,102511170,210507001251,SESC,907,04,33,52,0,0,0,0,0,0,0,0,0,1,2,3,0,0,0,0,1,1,51,30,81,85
20192020,102,ROCKCASTLE,511,Rockcastle County,170,Mt. Vernon Elementary,511170,102511170,210507001251,SESC,907,05,48,49,0,0,0,0,0,0,0,0,0,1,0,1,0,0,0,1,0,1,47,48,95,97
20192020,102,ROCKCASTLE,511,Rockcastle County,310,Rockcastle County High School,511310,102511310,210507001252,SESC,907,All Students,391,403,2,4,6,0,0,0,0,2,2,5,1,6,0,0,0,5,3,8,391,381,772,794
20192020,102,ROCKCASTLE,511,Rockcastle County,310,Rockcastle County High School,511310,102511310,210507001252,SESC,907,09,109,91,2,1,3,0,0,0,0,0,0,2,1,3,0,0,0,1,1,2,86,106,192,200
20192020,102,ROCKCASTLE,511,Rockcastle County,310,Rockcastle County High School,511310,102511310,210507001252,SESC,907,10,99,114,0,1,1,0,0,0,0,0,0,1,0,1,0,0,0,3,0,3,110,98,208,213
20192020,102,ROCKCASTLE,511,Rockcastle County,310,Rockcastle County High School,511310,102511310,210507001252,SESC,907,11,88,85,0,2,2,0,0,0,0,1,1,1,0,1,0,0,0,0,0,0,84,85,169,173
20192020,102,ROCKCASTLE,511,Rockcastle County,310,Rockcastle County High School,511310,102511310,210507001252,SESC,907,12,95,112,0,0,0,0,0,0,0,1,1,1,0,1,0,0,0,1,2,3,110,92,202,207
20192020,102,ROCKCASTLE,511,Rockcastle County,310,Rockcastle County High School,511310,102511310,210507001252,SESC,907,14,0,1,0,0,0,0,0,0,0,0,0,0,0,0,0,0,0,0,0,0,1,0,1,1
20192020,102,ROCKCASTLE,511,Rockcastle County,320,Roundstone Elementary School,511320,102511320,210507001253,SESC,907,04,21,17,0,0,0,0,0,0,0,0,0,0,0,0,0,0,0,0,0,0,17,21,38,38
20192020,102,ROCKCASTLE,511,Rockcastle County,320,Roundstone Elementary School,511320,102511320,210507001253,SESC,907,02,25,19,0,0,0,0,0,0,0,0,0,0,1,1,0,0,0,1,1,2,18,23,41,44
20192020,102,ROCKCASTLE,511,Rockcastle County,320,Roundstone Elementary School,511320,102511320,210507001253,SESC,907,05,21,25,1,0,1,0,0,0,0,0,0,1,2,3,0,0,0,0,1,1,23,18,41,46
20192020,102,ROCKCASTLE,511,Rockcastle County,320,Roundstone Elementary School,511320,102511320,210507001253,SESC,907,03,14,20,0,0,0,0,0,0,0,0,0,0,1,1,0,0,0,0,0,0,20,13,33,34
20192020,102,ROCKCASTLE,511,Rockcastle County,320,Roundstone Elementary School,511320,102511320,210507001253,SESC,907,All Students,116,129,1,0,1,0,0,0,0,0,0,2,6,8,0,0,0,4,3,7,122,107,229,245
20192020,102,ROCKCASTLE,511,Rockcastle County,320,Roundstone Elementary School,511320,102511320,210507001253,SESC,907,PS,11,13,1,0,1,0,0,0,0,0,0,0,0,0,0,0,0,0,0,0,12,11,23,24
20192020,102,ROCKCASTLE,511,Rockcastle County,320,Roundstone Elementary School,511320,102511320,210507001253,SESC,907,KG,15,21,0,0,0,0,0,0,0,0,0,0,0,0,0,0,0,2,0,2,19,15,34,36
20192020,102,ROCKCASTLE,511,Rockcastle County,320,Roundstone Elementary School,511320,102511320,210507001253,SESC,907,01,20,27,0,0,0,0,0,0,0,0,0,1,2,3,0,0,0,1,1,2,25,17,42,47
20192020,103,ROWAN,515,Rowan County,"",---District Total---,515,"","",KEDC,903,PS,85,103,0,0,0,0,0,0,1,1,2,4,2,6,0,0,0,1,0,1,97,82,179,188
20192020,103,ROWAN,515,Rowan County,"",---District Total---,515,"","",KEDC,903,All Students,1566,1695,22,17,39,0,2,2,17,13,30,55,59,114,0,0,0,24,38,62,1577,1437,3014,3261
20192020,103,ROWAN,515,Rowan County,"",---District Total---,515,"","",KEDC,903,KG,121,135,0,2,2,0,0,0,2,0,2,3,7,10,0,0,0,1,5,6,129,107,236,256
20192020,103,ROWAN,515,Rowan County,"",---District Total---,515,"","",KEDC,903,01,124,144,2,2,4,0,0,0,0,0,0,2,8,10,0,0,0,3,2,5,137,112,249,268
20192020,103,ROWAN,515,Rowan County,"",---District Total---,515,"","",KEDC,903,02,101,121,0,2,2,0,0,0,0,0,0,4,4,8,0,0,0,1,4,5,116,91,207,222
20192020,103,ROWAN,515,Rowan County,"",---District Total---,515,"","",KEDC,903,03,122,127,1,0,1,0,0,0,2,0,2,4,0,4,0,0,0,3,4,7,117,118,235,249
20192020,103,ROWAN,515,Rowan County,"",---District Total---,515,"","",KEDC,903,04,122,120,0,1,1,0,0,0,2,0,2,2,3,5,0,0,0,2,1,3,114,117,231,242
20192020,103,ROWAN,515,Rowan County,"",---District Total---,515,"","",KEDC,903,05,128,148,1,1,2,0,0,0,1,0,1,7,7,14,0,0,0,4,5,9,135,115,250,276
20192020,103,ROWAN,515,Rowan County,"",---District Total---,515,"","",KEDC,903,06,110,145,2,1,3,0,0,0,4,0,4,6,4,10,0,0,0,1,0,1,132,105,237,255
20192020,103,ROWAN,515,Rowan County,"",---District Total---,515,"","",KEDC,903,07,136,130,0,1,1,0,0,0,1,1,2,3,5,8,0,0,0,1,5,6,125,124,249,266
20192020,103,ROWAN,515,Rowan County,"",---District Total---,515,"","",KEDC,903,08,134,137,3,1,4,0,1,1,0,2,2,7,3,10,0,0,0,1,1,2,126,126,252,271
20192020,103,ROWAN,515,Rowan County,"",---District Total---,515,"","",KEDC,903,09,125,130,3,4,7,0,0,0,0,0,0,5,6,11,0,0,0,2,4,6,120,111,231,255
20192020,103,ROWAN,515,Rowan County,"",---District Total---,515,"","",KEDC,903,10,114,121,5,2,7,0,0,0,2,4,6,6,5,11,0,0,0,3,2,5,105,101,206,235
20192020,103,ROWAN,515,Rowan County,"",---District Total---,515,"","",KEDC,903,11,110,118,3,0,3,0,1,1,2,4,6,2,3,5,0,0,0,0,2,2,111,100,211,228
20192020,103,ROWAN,515,Rowan County,"",---District Total---,515,"","",KEDC,903,12,119,118,2,0,2,0,0,0,1,2,3,4,4,8,0,0,0,2,3,5,109,110,219,237
20192020,103,ROWAN,515,Rowan County,"",---District Total---,515,"","",KEDC,903,14,0,1,0,0,0,0,0,0,0,0,0,0,0,0,0,0,0,0,0,0,1,0,1,1
20192020,103,ROWAN,515,Rowan County,040,Clearfield Elementary School,515040,103515040,210510001254,KEDC,903,05,30,32,0,0,0,0,0,0,0,0,0,1,3,4,0,0,0,2,0,2,29,27,56,62
20192020,103,ROWAN,515,Rowan County,040,Clearfield Elementary School,515040,103515040,210510001254,KEDC,903,All Students,141,187,0,1,1,0,0,0,0,0,0,5,6,11,0,0,0,3,5,8,179,129,308,328
20192020,103,ROWAN,515,Rowan County,040,Clearfield Elementary School,515040,103515040,210510001254,KEDC,903,KG,18,31,0,0,0,0,0,0,0,0,0,0,0,0,0,0,0,0,1,1,31,17,48,49
20192020,103,ROWAN,515,Rowan County,040,Clearfield Elementary School,515040,103515040,210510001254,KEDC,903,01,23,31,0,0,0,0,0,0,0,0,0,1,1,2,0,0,0,1,0,1,29,22,51,54
20192020,103,ROWAN,515,Rowan County,040,Clearfield Elementary School,515040,103515040,210510001254,KEDC,903,02,21,30,0,1,1,0,0,0,0,0,0,2,2,4,0,0,0,0,2,2,28,16,44,51
20192020,103,ROWAN,515,Rowan County,040,Clearfield Elementary School,515040,103515040,210510001254,KEDC,903,03,26,36,0,0,0,0,0,0,0,0,0,1,0,1,0,0,0,0,2,2,35,24,59,62
20192020,103,ROWAN,515,Rowan County,040,Clearfield Elementary School,515040,103515040,210510001254,KEDC,903,04,23,27,0,0,0,0,0,0,0,0,0,0,0,0,0,0,0,0,0,0,27,23,50,50
20192020,103,ROWAN,515,Rowan County,043,McBrayer Elementary School,515043,103515043,210510002016,KEDC,903,04,46,39,0,0,0,0,0,0,2,0,2,0,3,3,0,0,0,2,1,3,35,42,77,85
20192020,103,ROWAN,515,Rowan County,043,McBrayer Elementary School,515043,103515043,210510002016,KEDC,903,All Students,260,287,2,3,5,0,0,0,4,0,4,7,14,21,0,0,0,5,9,14,269,234,503,547
20192020,103,ROWAN,515,Rowan County,043,McBrayer Elementary School,515043,103515043,210510002016,KEDC,903,KG,39,52,0,2,2,0,0,0,0,0,0,1,5,6,0,0,0,0,1,1,51,31,82,91
20192020,103,ROWAN,515,Rowan County,043,McBrayer Elementary School,515043,103515043,210510002016,KEDC,903,01,41,49,1,1,2,0,0,0,0,0,0,1,5,6,0,0,0,2,2,4,45,33,78,90
20192020,103,ROWAN,515,Rowan County,043,McBrayer Elementary School,515043,103515043,210510002016,KEDC,903,02,35,43,0,0,0,0,0,0,0,0,0,1,0,1,0,0,0,0,1,1,42,34,76,78
20192020,103,ROWAN,515,Rowan County,043,McBrayer Elementary School,515043,103515043,210510002016,KEDC,903,03,50,45,1,0,1,0,0,0,1,0,1,2,0,2,0,0,0,0,2,2,41,48,89,95
20192020,103,ROWAN,515,Rowan County,043,McBrayer Elementary School,515043,103515043,210510002016,KEDC,903,05,49,59,0,0,0,0,0,0,1,0,1,2,1,3,0,0,0,1,2,3,55,46,101,108
20192020,103,ROWAN,515,Rowan County,044,Rowan County Preschool Center,515044,103515044,210510002033,KEDC,903,All Students,0,0,0,0,0,0,0,0,0,0,0,0,0,0,0,0,0,0,0,0,0,0,0,0
20192020,103,ROWAN,515,Rowan County,044,Rowan County Preschool Center,515044,103515044,210510002033,KEDC,903,PS,85,103,0,0,0,0,0,0,1,1,2,4,2,6,0,0,0,1,0,1,97,82,179,188
20192020,103,ROWAN,515,Rowan County,130,Morehead Youth Development Center,515130,103515130,210510001258,KEDC,903,11,1,4,0,0,0,0,0,0,0,0,0,0,0,0,0,0,0,0,0,0,4,1,5,5
20192020,103,ROWAN,515,Rowan County,130,Morehead Youth Development Center,515130,103515130,210510001258,KEDC,903,All Students,9,6,0,0,0,0,0,0,0,0,0,0,1,1,0,0,0,0,1,1,6,7,13,15
20192020,103,ROWAN,515,Rowan County,130,Morehead Youth Development Center,515130,103515130,210510001258,KEDC,903,08,1,0,0,0,0,0,0,0,0,0,0,0,0,0,0,0,0,0,0,0,0,1,1,1
20192020,103,ROWAN,515,Rowan County,130,Morehead Youth Development Center,515130,103515130,210510001258,KEDC,903,09,1,0,0,0,0,0,0,0,0,0,0,0,0,0,0,0,0,0,0,0,0,1,1,1
20192020,103,ROWAN,515,Rowan County,130,Morehead Youth Development Center,515130,103515130,210510001258,KEDC,903,10,1,2,0,0,0,0,0,0,0,0,0,0,0,0,0,0,0,0,0,0,2,1,3,3
20192020,103,ROWAN,515,Rowan County,130,Morehead Youth Development Center,515130,103515130,210510001258,KEDC,903,12,5,0,0,0,0,0,0,0,0,0,0,0,1,1,0,0,0,0,1,1,0,3,3,5
20192020,103,ROWAN,515,Rowan County,132,Bluegrass Discovery Academy High,515132,103515132,210510002342,KEDC,903,11,0,3,1,0,1,0,0,0,0,0,0,0,0,0,0,0,0,0,0,0,2,0,2,3
20192020,103,ROWAN,515,Rowan County,132,Bluegrass Discovery Academy High,515132,103515132,210510002342,KEDC,903,All Students,4,18,3,0,3,0,0,0,0,0,0,0,0,0,0,0,0,1,0,1,14,4,18,22
20192020,103,ROWAN,515,Rowan County,132,Bluegrass Discovery Academy High,515132,103515132,210510002342,KEDC,903,09,4,6,0,0,0,0,0,0,0,0,0,0,0,0,0,0,0,0,0,0,6,4,10,10
20192020,103,ROWAN,515,Rowan County,132,Bluegrass Discovery Academy High,515132,103515132,210510002342,KEDC,903,10,0,4,1,0,1,0,0,0,0,0,0,0,0,0,0,0,0,1,0,1,2,0,2,4
20192020,103,ROWAN,515,Rowan County,132,Bluegrass Discovery Academy High,515132,103515132,210510002342,KEDC,903,12,0,5,1,0,1,0,0,0,0,0,0,0,0,0,0,0,0,0,0,0,4,0,4,5
20192020,103,ROWAN,515,Rowan County,133,Bluegrass Discovery Academy Middle,515133,103515133,210510002336,KEDC,903,07,2,2,0,0,0,0,0,0,0,0,0,0,0,0,0,0,0,0,0,0,2,2,4,4
20192020,103,ROWAN,515,Rowan County,133,Bluegrass Discovery Academy Middle,515133,103515133,210510002336,KEDC,903,All Students,6,6,0,0,0,0,0,0,0,0,0,0,0,0,0,0,0,0,0,0,6,6,12,12
20192020,103,ROWAN,515,Rowan County,133,Bluegrass Discovery Academy Middle,515133,103515133,210510002336,KEDC,903,08,4,4,0,0,0,0,0,0,0,0,0,0,0,0,0,0,0,0,0,0,4,4,8,8
20192020,103,ROWAN,515,Rowan County,180,Rowan County Senior High School,515180,103515180,210510001260,KEDC,903,12,114,113,1,0,1,0,0,0,1,2,3,4,3,7,0,0,0,2,2,4,105,107,212,227
20192020,103,ROWAN,515,Rowan County,180,Rowan County Senior High School,515180,103515180,210510001260,KEDC,903,All Students,456,464,10,6,16,0,1,1,5,10,15,17,17,34,0,0,0,6,10,16,426,412,838,920
20192020,103,ROWAN,515,Rowan County,180,Rowan County Senior High School,515180,103515180,210510001260,KEDC,903,09,120,124,3,4,7,0,0,0,0,0,0,5,6,11,0,0,0,2,4,6,114,106,220,244
20192020,103,ROWAN,515,Rowan County,180,Rowan County Senior High School,515180,103515180,210510001260,KEDC,903,10,113,115,4,2,6,0,0,0,2,4,6,6,5,11,0,0,0,2,2,4,101,100,201,228
20192020,103,ROWAN,515,Rowan County,180,Rowan County Senior High School,515180,103515180,210510001260,KEDC,903,11,109,111,2,0,2,0,1,1,2,4,6,2,3,5,0,0,0,0,2,2,105,99,204,220
20192020,103,ROWAN,515,Rowan County,180,Rowan County Senior High School,515180,103515180,210510001260,KEDC,903,14,0,1,0,0,0,0,0,0,0,0,0,0,0,0,0,0,0,0,0,0,1,0,1,1
20192020,103,ROWAN,515,Rowan County,200,Tilden Hogge Elementary School,515200,103515200,210510001261,KEDC,903,01,22,19,0,0,0,0,0,0,0,0,0,0,1,1,0,0,0,0,0,0,19,21,40,41
20192020,103,ROWAN,515,Rowan County,200,Tilden Hogge Elementary School,515200,103515200,210510001261,KEDC,903,All Students,110,95,0,1,1,0,0,0,0,0,0,2,3,5,0,0,0,3,3,6,90,103,193,205
20192020,103,ROWAN,515,Rowan County,200,Tilden Hogge Elementary School,515200,103515200,210510001261,KEDC,903,KG,18,16,0,0,0,0,0,0,0,0,0,1,0,1,0,0,0,0,2,2,15,16,31,34
20192020,103,ROWAN,515,Rowan County,200,Tilden Hogge Elementary School,515200,103515200,210510001261,KEDC,903,02,20,12,0,1,1,0,0,0,0,0,0,1,1,2,0,0,0,1,0,1,10,18,28,32
20192020,103,ROWAN,515,Rowan County,200,Tilden Hogge Elementary School,515200,103515200,210510001261,KEDC,903,03,12,13,0,0,0,0,0,0,0,0,0,0,0,0,0,0,0,1,0,1,12,12,24,25
20192020,103,ROWAN,515,Rowan County,200,Tilden Hogge Elementary School,515200,103515200,210510001261,KEDC,903,04,21,13,0,0,0,0,0,0,0,0,0,0,0,0,0,0,0,0,0,0,13,21,34,34
20192020,103,ROWAN,515,Rowan County,200,Tilden Hogge Elementary School,515200,103515200,210510001261,KEDC,903,05,17,22,0,0,0,0,0,0,0,0,0,0,1,1,0,0,0,1,1,2,21,15,36,39
20192020,103,ROWAN,515,Rowan County,210,Rowan County Middle School,515210,103515210,210510001478,KEDC,903,06,110,145,2,1,3,0,0,0,4,0,4,6,4,10,0,0,0,1,0,1,132,105,237,255
20192020,103,ROWAN,515,Rowan County,210,Rowan County Middle School,515210,103515210,210510001478,KEDC,903,07,134,128,0,1,1,0,0,0,1,1,2,3,5,8,0,0,0,1,5,6,123,122,245,262
20192020,103,ROWAN,515,Rowan County,210,Rowan County Middle School,515210,103515210,210510001478,KEDC,903,08,129,133,3,1,4,0,1,1,0,2,2,7,3,10,0,0,0,1,1,2,122,121,243,262
20192020,103,ROWAN,515,Rowan County,210,Rowan County Middle School,515210,103515210,210510001478,KEDC,903,All Students,373,406,5,3,8,0,1,1,5,3,8,16,12,28,0,0,0,3,6,9,377,348,725,779
20192020,103,ROWAN,515,Rowan County,250,Rodburn Elementary School,515250,103515250,210510000787,KEDC,903,04,32,41,0,1,1,0,0,0,0,0,0,2,0,2,0,0,0,0,0,0,39,31,70,73
20192020,103,ROWAN,515,Rowan County,250,Rodburn Elementary School,515250,103515250,210510000787,KEDC,903,05,32,35,1,1,2,0,0,0,0,0,0,4,2,6,0,0,0,0,2,2,30,27,57,67
20192020,103,ROWAN,515,Rowan County,250,Rodburn Elementary School,515250,103515250,210510000787,KEDC,903,KG,46,36,0,0,0,0,0,0,2,0,2,1,2,3,0,0,0,1,1,2,32,43,75,82
20192020,103,ROWAN,515,Rowan County,250,Rodburn Elementary School,515250,103515250,210510000787,KEDC,903,All Students,207,226,2,3,5,0,0,0,3,0,3,8,6,14,0,0,0,3,4,7,210,194,404,433
20192020,103,ROWAN,515,Rowan County,250,Rodburn Elementary School,515250,103515250,210510000787,KEDC,903,01,38,45,1,1,2,0,0,0,0,0,0,0,1,1,0,0,0,0,0,0,44,36,80,83
20192020,103,ROWAN,515,Rowan County,250,Rodburn Elementary School,515250,103515250,210510000787,KEDC,903,02,25,36,0,0,0,0,0,0,0,0,0,0,1,1,0,0,0,0,1,1,36,23,59,61
20192020,103,ROWAN,515,Rowan County,250,Rodburn Elementary School,515250,103515250,210510000787,KEDC,903,03,34,33,0,0,0,0,0,0,1,0,1,1,0,1,0,0,0,2,0,2,29,34,63,67
20192020,104,RUSSELL,521,Russell County,"",---District Total---,521,"","",GRREC,902,07,111,109,1,0,1,0,0,0,1,2,3,14,16,30,0,1,1,0,3,3,93,89,182,220
20192020,104,RUSSELL,521,Russell County,"",---District Total---,521,"","",GRREC,902,08,104,124,0,0,0,0,0,0,2,0,2,14,10,24,0,0,0,4,3,7,104,91,195,228
20192020,104,RUSSELL,521,Russell County,"",---District Total---,521,"","",GRREC,902,09,108,101,2,1,3,0,0,0,1,1,2,11,10,21,0,0,0,2,0,2,85,96,181,209
20192020,104,RUSSELL,521,Russell County,"",---District Total---,521,"","",GRREC,902,10,90,117,2,2,4,0,1,1,1,0,1,9,2,11,0,0,0,1,2,3,104,83,187,207
20192020,104,RUSSELL,521,Russell County,"",---District Total---,521,"","",GRREC,902,12,90,120,0,1,1,1,0,1,1,0,1,6,4,10,0,0,0,0,0,0,112,85,197,210
20192020,104,RUSSELL,521,Russell County,"",---District Total---,521,"","",GRREC,902,11,100,107,1,0,1,0,0,0,0,1,1,4,5,9,0,0,0,0,1,1,102,93,195,207
20192020,104,RUSSELL,521,Russell County,"",---District Total---,521,"","",GRREC,902,14,1,1,0,0,0,0,0,0,0,0,0,0,0,0,0,0,0,0,0,0,1,1,2,2
20192020,104,RUSSELL,521,Russell County,"",---District Total---,521,"","",GRREC,902,All Students,1410,1523,7,10,17,2,2,4,13,7,20,164,141,305,1,6,7,21,19,40,1315,1225,2540,2933
20192020,104,RUSSELL,521,Russell County,"",---District Total---,521,"","",GRREC,902,PS,61,85,0,0,0,0,0,0,1,0,1,17,8,25,0,0,0,0,3,3,67,50,117,146
20192020,104,RUSSELL,521,Russell County,"",---District Total---,521,"","",GRREC,902,KG,113,123,1,0,1,0,0,0,0,1,1,13,13,26,0,0,0,5,0,5,104,99,203,236
20192020,104,RUSSELL,521,Russell County,"",---District Total---,521,"","",GRREC,902,01,133,126,0,2,2,1,0,1,0,0,0,18,18,36,0,0,0,3,3,6,104,110,214,259
20192020,104,RUSSELL,521,Russell County,"",---District Total---,521,"","",GRREC,902,02,105,111,0,0,0,0,0,0,3,0,3,16,10,26,0,0,0,0,1,1,92,94,186,216
20192020,104,RUSSELL,521,Russell County,"",---District Total---,521,"","",GRREC,902,03,112,121,0,1,1,0,1,1,0,0,0,26,11,37,0,1,1,3,1,4,92,97,189,233
20192020,104,RUSSELL,521,Russell County,"",---District Total---,521,"","",GRREC,902,04,109,120,0,1,1,0,0,0,1,2,3,9,12,21,1,0,1,1,2,3,108,92,200,229
20192020,104,RUSSELL,521,Russell County,"",---District Total---,521,"","",GRREC,902,05,119,121,0,1,1,0,0,0,2,0,2,15,19,34,0,1,1,2,0,2,102,98,200,240
20192020,104,RUSSELL,521,Russell County,"",---District Total---,521,"","",GRREC,902,06,115,122,0,1,1,0,0,0,1,0,1,9,11,20,0,3,3,0,3,3,112,97,209,237
20192020,104,RUSSELL,521,Russell County,140,Jamestown Elementary School,521140,104521140,210516001263,GRREC,902,04,38,42,0,0,0,0,0,0,0,2,2,3,3,6,1,0,1,1,1,2,37,32,69,80
20192020,104,RUSSELL,521,Russell County,140,Jamestown Elementary School,521140,104521140,210516001263,GRREC,902,03,33,40,0,0,0,0,0,0,0,0,0,8,2,10,0,0,0,1,0,1,31,31,62,73
20192020,104,RUSSELL,521,Russell County,140,Jamestown Elementary School,521140,104521140,210516001263,GRREC,902,All Students,216,228,0,0,0,0,0,0,2,2,4,25,17,42,1,0,1,8,3,11,192,194,386,444
20192020,104,RUSSELL,521,Russell County,140,Jamestown Elementary School,521140,104521140,210516001263,GRREC,902,05,34,39,0,0,0,0,0,0,1,0,1,4,3,7,0,0,0,2,0,2,32,31,63,73
20192020,104,RUSSELL,521,Russell County,140,Jamestown Elementary School,521140,104521140,210516001263,GRREC,902,02,32,32,0,0,0,0,0,0,1,0,1,4,2,6,0,0,0,0,1,1,27,29,56,64
20192020,104,RUSSELL,521,Russell County,140,Jamestown Elementary School,521140,104521140,210516001263,GRREC,902,PS,21,32,0,0,0,0,0,0,0,0,0,3,1,4,0,0,0,0,2,2,29,18,47,53
20192020,104,RUSSELL,521,Russell County,140,Jamestown Elementary School,521140,104521140,210516001263,GRREC,902,KG,36,39,0,0,0,0,0,0,0,0,0,3,3,6,0,0,0,3,0,3,33,33,66,75
20192020,104,RUSSELL,521,Russell County,140,Jamestown Elementary School,521140,104521140,210516001263,GRREC,902,01,43,36,0,0,0,0,0,0,0,0,0,3,4,7,0,0,0,1,1,2,32,38,70,79
20192020,104,RUSSELL,521,Russell County,230,Russell Springs Elementary School,521230,104521230,210516001264,GRREC,902,04,49,53,0,0,0,0,0,0,0,0,0,4,6,10,0,0,0,0,1,1,49,42,91,102
20192020,104,RUSSELL,521,Russell County,230,Russell Springs Elementary School,521230,104521230,210516001264,GRREC,902,All Students,313,321,0,4,4,1,0,1,2,1,3,53,45,98,0,2,2,4,4,8,261,257,518,634
20192020,104,RUSSELL,521,Russell County,230,Russell Springs Elementary School,521230,104521230,210516001264,GRREC,902,PS,27,35,0,0,0,0,0,0,1,0,1,11,5,16,0,0,0,0,1,1,23,21,44,62
20192020,104,RUSSELL,521,Russell County,230,Russell Springs Elementary School,521230,104521230,210516001264,GRREC,902,KG,51,54,0,0,0,0,0,0,0,1,1,9,7,16,0,0,0,1,0,1,44,43,87,105
20192020,104,RUSSELL,521,Russell County,230,Russell Springs Elementary School,521230,104521230,210516001264,GRREC,902,01,61,57,0,2,2,1,0,1,0,0,0,10,9,19,0,0,0,2,2,4,44,48,92,118
20192020,104,RUSSELL,521,Russell County,230,Russell Springs Elementary School,521230,104521230,210516001264,GRREC,902,02,48,50,0,0,0,0,0,0,1,0,1,10,5,15,0,0,0,0,0,0,39,43,82,98
20192020,104,RUSSELL,521,Russell County,230,Russell Springs Elementary School,521230,104521230,210516001264,GRREC,902,03,52,53,0,1,1,0,0,0,0,0,0,12,7,19,0,1,1,1,1,2,40,42,82,105
20192020,104,RUSSELL,521,Russell County,230,Russell Springs Elementary School,521230,104521230,210516001264,GRREC,902,05,52,54,0,1,1,0,0,0,1,0,1,8,11,19,0,1,1,0,0,0,45,39,84,106
20192020,104,RUSSELL,521,Russell County,240,Russell County High School,521240,104521240,210516001265,GRREC,902,09,108,101,2,1,3,0,0,0,1,1,2,11,10,21,0,0,0,2,0,2,85,96,181,209
20192020,104,RUSSELL,521,Russell County,240,Russell County High School,521240,104521240,210516001265,GRREC,902,10,90,117,2,2,4,0,1,1,1,0,1,9,2,11,0,0,0,1,2,3,104,83,187,207
20192020,104,RUSSELL,521,Russell County,240,Russell County High School,521240,104521240,210516001265,GRREC,902,11,100,107,1,0,1,0,0,0,0,1,1,4,5,9,0,0,0,0,1,1,102,93,195,207
20192020,104,RUSSELL,521,Russell County,240,Russell County High School,521240,104521240,210516001265,GRREC,902,12,90,120,0,1,1,1,0,1,1,0,1,6,4,10,0,0,0,0,0,0,112,85,197,210
20192020,104,RUSSELL,521,Russell County,240,Russell County High School,521240,104521240,210516001265,GRREC,902,14,1,1,0,0,0,0,0,0,0,0,0,0,0,0,0,0,0,0,0,0,1,1,2,2
20192020,104,RUSSELL,521,Russell County,240,Russell County High School,521240,104521240,210516001265,GRREC,902,All Students,389,446,5,4,9,1,1,2,3,2,5,30,21,51,0,0,0,3,3,6,404,358,762,835
20192020,104,RUSSELL,521,Russell County,250,Salem Elementary School,521250,104521250,210516001266,GRREC,902,03,27,28,0,0,0,0,1,1,0,0,0,6,2,8,0,0,0,1,0,1,21,24,45,55
20192020,104,RUSSELL,521,Russell County,250,Salem Elementary School,521250,104521250,210516001266,GRREC,902,05,33,28,0,0,0,0,0,0,0,0,0,3,5,8,0,0,0,0,0,0,25,28,53,61
20192020,104,RUSSELL,521,Russell County,250,Salem Elementary School,521250,104521250,210516001266,GRREC,902,04,22,25,0,1,1,0,0,0,1,0,1,2,3,5,0,0,0,0,0,0,22,18,40,47
20192020,104,RUSSELL,521,Russell County,250,Salem Elementary School,521250,104521250,210516001266,GRREC,902,All Students,162,173,1,1,2,0,1,1,2,0,2,19,21,40,0,0,0,2,0,2,149,139,288,335
20192020,104,RUSSELL,521,Russell County,250,Salem Elementary School,521250,104521250,210516001266,GRREC,902,PS,13,18,0,0,0,0,0,0,0,0,0,3,2,5,0,0,0,0,0,0,15,11,26,31
20192020,104,RUSSELL,521,Russell County,250,Salem Elementary School,521250,104521250,210516001266,GRREC,902,KG,26,30,1,0,1,0,0,0,0,0,0,1,3,4,0,0,0,1,0,1,27,23,50,56
20192020,104,RUSSELL,521,Russell County,250,Salem Elementary School,521250,104521250,210516001266,GRREC,902,01,29,33,0,0,0,0,0,0,0,0,0,5,5,10,0,0,0,0,0,0,28,24,52,62
20192020,104,RUSSELL,521,Russell County,250,Salem Elementary School,521250,104521250,210516001266,GRREC,902,02,25,29,0,0,0,0,0,0,1,0,1,2,3,5,0,0,0,0,0,0,26,22,48,54
20192020,104,RUSSELL,521,Russell County,260,Russell County Middle School,521260,104521260,210516001599,GRREC,902,07,111,109,1,0,1,0,0,0,1,2,3,14,16,30,0,1,1,0,3,3,93,89,182,220
20192020,104,RUSSELL,521,Russell County,260,Russell County Middle School,521260,104521260,210516001599,GRREC,902,All Students,330,355,1,1,2,0,0,0,4,2,6,37,37,74,0,4,4,4,9,13,309,277,586,685
20192020,104,RUSSELL,521,Russell County,260,Russell County Middle School,521260,104521260,210516001599,GRREC,902,06,115,122,0,1,1,0,0,0,1,0,1,9,11,20,0,3,3,0,3,3,112,97,209,237
20192020,104,RUSSELL,521,Russell County,260,Russell County Middle School,521260,104521260,210516001599,GRREC,902,08,104,124,0,0,0,0,0,0,2,0,2,14,10,24,0,0,0,4,3,7,104,91,195,228
20192020,045,GREENUP,522,Russell Independent,"",---District Total---,522,"","",KEDC,903,11,78,97,0,0,0,0,0,0,2,0,2,1,2,3,0,0,0,3,3,6,91,73,164,175
20192020,045,GREENUP,522,Russell Independent,"",---District Total---,522,"","",KEDC,903,All Students,1035,1157,13,6,19,3,3,6,10,13,23,13,10,23,1,0,1,34,32,66,1083,971,2054,2192
20192020,045,GREENUP,522,Russell Independent,"",---District Total---,522,"","",KEDC,903,PS,32,40,0,0,0,1,0,1,2,0,2,0,1,1,0,0,0,1,1,2,36,30,66,72
20192020,045,GREENUP,522,Russell Independent,"",---District Total---,522,"","",KEDC,903,KG,73,81,1,2,3,1,0,1,1,1,2,0,1,1,0,0,0,2,1,3,76,68,144,154
20192020,045,GREENUP,522,Russell Independent,"",---District Total---,522,"","",KEDC,903,01,71,79,0,0,0,1,0,1,0,1,1,0,0,0,1,0,1,3,1,4,74,69,143,150
20192020,045,GREENUP,522,Russell Independent,"",---District Total---,522,"","",KEDC,903,02,79,104,1,0,1,0,0,0,1,0,1,1,2,3,0,0,0,2,2,4,99,75,174,183
20192020,045,GREENUP,522,Russell Independent,"",---District Total---,522,"","",KEDC,903,03,76,97,2,1,3,0,1,1,0,2,2,1,1,2,0,0,0,4,2,6,90,69,159,173
20192020,045,GREENUP,522,Russell Independent,"",---District Total---,522,"","",KEDC,903,04,75,108,1,0,1,1,1,2,0,1,1,4,1,5,0,0,0,2,0,2,100,72,172,183
20192020,045,GREENUP,522,Russell Independent,"",---District Total---,522,"","",KEDC,903,05,80,88,2,2,4,0,1,1,1,2,3,2,0,2,0,0,0,3,4,7,80,71,151,168
20192020,045,GREENUP,522,Russell Independent,"",---District Total---,522,"","",KEDC,903,06,84,80,0,0,0,0,0,0,1,3,4,1,1,2,0,0,0,3,4,7,75,76,151,164
20192020,045,GREENUP,522,Russell Independent,"",---District Total---,522,"","",KEDC,903,07,91,85,1,0,1,0,0,0,1,1,2,0,1,1,0,0,0,3,3,6,80,86,166,176
20192020,045,GREENUP,522,Russell Independent,"",---District Total---,522,"","",KEDC,903,08,105,74,0,0,0,0,0,0,0,1,1,0,1,1,0,0,0,3,7,10,71,96,167,179
20192020,045,GREENUP,522,Russell Independent,"",---District Total---,522,"","",KEDC,903,09,76,95,4,0,4,0,0,0,1,0,1,2,0,2,0,0,0,4,2,6,84,74,158,171
20192020,045,GREENUP,522,Russell Independent,"",---District Total---,522,"","",KEDC,903,10,87,101,0,0,0,0,0,0,0,1,1,0,0,0,0,0,0,1,3,4,100,83,183,188
20192020,045,GREENUP,522,Russell Independent,"",---District Total---,522,"","",KEDC,903,12,60,68,1,1,2,0,0,0,2,0,2,1,0,1,0,0,0,1,0,1,63,59,122,128
20192020,045,GREENUP,522,Russell Independent,011,Russell Primary School,522011,045522011,210513001626,KEDC,903,01,71,79,0,0,0,1,0,1,0,1,1,0,0,0,1,0,1,3,1,4,74,69,143,150
20192020,045,GREENUP,522,Russell Independent,011,Russell Primary School,522011,045522011,210513001626,KEDC,903,All Students,223,264,2,2,4,2,0,2,2,2,4,1,3,4,1,0,1,7,4,11,249,212,461,487
20192020,045,GREENUP,522,Russell Independent,011,Russell Primary School,522011,045522011,210513001626,KEDC,903,PS,32,40,0,0,0,1,0,1,2,0,2,0,1,1,0,0,0,1,1,2,36,30,66,72
20192020,045,GREENUP,522,Russell Independent,011,Russell Primary School,522011,045522011,210513001626,KEDC,903,KG,73,81,1,2,3,1,0,1,1,1,2,0,1,1,0,0,0,2,1,3,76,68,144,154
20192020,045,GREENUP,522,Russell Independent,011,Russell Primary School,522011,045522011,210513001626,KEDC,903,02,79,104,1,0,1,0,0,0,1,0,1,1,2,3,0,0,0,2,2,4,99,75,174,183
20192020,045,GREENUP,522,Russell Independent,030,Russell-McDowell Intermediate School,522030,045522030,210513001270,KEDC,903,05,80,88,2,2,4,0,1,1,1,2,3,2,0,2,0,0,0,3,4,7,80,71,151,168
20192020,045,GREENUP,522,Russell Independent,030,Russell-McDowell Intermediate School,522030,045522030,210513001270,KEDC,903,All Students,231,293,5,3,8,1,3,4,1,5,6,7,2,9,0,0,0,9,6,15,270,212,482,524
20192020,045,GREENUP,522,Russell Independent,030,Russell-McDowell Intermediate School,522030,045522030,210513001270,KEDC,903,03,76,97,2,1,3,0,1,1,0,2,2,1,1,2,0,0,0,4,2,6,90,69,159,173
20192020,045,GREENUP,522,Russell Independent,030,Russell-McDowell Intermediate School,522030,045522030,210513001270,KEDC,903,04,75,108,1,0,1,1,1,2,0,1,1,4,1,5,0,0,0,2,0,2,100,72,172,183
20192020,045,GREENUP,522,Russell Independent,050,Russell High School,522050,045522050,210513001272,KEDC,903,12,60,68,1,1,2,0,0,0,2,0,2,1,0,1,0,0,0,1,0,1,63,59,122,128
20192020,045,GREENUP,522,Russell Independent,050,Russell High School,522050,045522050,210513001272,KEDC,903,All Students,301,361,5,1,6,0,0,0,5,1,6,4,2,6,0,0,0,9,8,17,338,289,627,662
20192020,045,GREENUP,522,Russell Independent,050,Russell High School,522050,045522050,210513001272,KEDC,903,09,76,95,4,0,4,0,0,0,1,0,1,2,0,2,0,0,0,4,2,6,84,74,158,171
20192020,045,GREENUP,522,Russell Independent,050,Russell High School,522050,045522050,210513001272,KEDC,903,10,87,101,0,0,0,0,0,0,0,1,1,0,0,0,0,0,0,1,3,4,100,83,183,188
20192020,045,GREENUP,522,Russell Independent,050,Russell High School,522050,045522050,210513001272,KEDC,903,11,78,97,0,0,0,0,0,0,2,0,2,1,2,3,0,0,0,3,3,6,91,73,164,175
20192020,045,GREENUP,522,Russell Independent,060,Russell Middle School,522060,045522060,210513001273,KEDC,903,07,91,85,1,0,1,0,0,0,1,1,2,0,1,1,0,0,0,3,3,6,80,86,166,176
20192020,045,GREENUP,522,Russell Independent,060,Russell Middle School,522060,045522060,210513001273,KEDC,903,All Students,280,239,1,0,1,0,0,0,2,5,7,1,3,4,0,0,0,9,14,23,226,258,484,519
20192020,045,GREENUP,522,Russell Independent,060,Russell Middle School,522060,045522060,210513001273,KEDC,903,06,84,80,0,0,0,0,0,0,1,3,4,1,1,2,0,0,0,3,4,7,75,76,151,164
20192020,045,GREENUP,522,Russell Independent,060,Russell Middle School,522060,045522060,210513001273,KEDC,903,08,105,74,0,0,0,0,0,0,0,1,1,0,1,1,0,0,0,3,7,10,71,96,167,179
20192020,071,LOGAN,523,Russellville Independent,"",---District Total---,523,"","",GRREC,902,All Students,494,510,103,94,197,1,0,1,6,6,12,69,69,138,0,0,0,63,69,132,268,256,524,1004
20192020,071,LOGAN,523,Russellville Independent,"",---District Total---,523,"","",GRREC,902,KG,39,48,9,6,15,0,0,0,0,1,1,7,11,18,0,0,0,8,6,14,24,15,39,87
20192020,071,LOGAN,523,Russellville Independent,"",---District Total---,523,"","",GRREC,902,01,48,34,3,8,11,0,0,0,1,0,1,7,4,11,0,0,0,7,3,10,16,33,49,82
20192020,071,LOGAN,523,Russellville Independent,"",---District Total---,523,"","",GRREC,902,02,42,38,14,7,21,0,0,0,0,0,0,2,10,12,0,0,0,5,6,11,17,19,36,80
20192020,071,LOGAN,523,Russellville Independent,"",---District Total---,523,"","",GRREC,902,03,39,31,9,8,17,0,0,0,0,0,0,4,6,10,0,0,0,3,6,9,15,19,34,70
20192020,071,LOGAN,523,Russellville Independent,"",---District Total---,523,"","",GRREC,902,04,35,47,6,7,13,1,0,1,0,0,0,4,8,12,0,0,0,8,5,13,28,15,43,82
20192020,071,LOGAN,523,Russellville Independent,"",---District Total---,523,"","",GRREC,902,05,27,48,8,7,15,0,0,0,0,1,1,8,3,11,0,0,0,5,4,9,27,12,39,75
20192020,071,LOGAN,523,Russellville Independent,"",---District Total---,523,"","",GRREC,902,06,42,37,7,6,13,0,0,0,0,0,0,7,6,13,0,0,0,5,9,14,18,21,39,79
20192020,071,LOGAN,523,Russellville Independent,"",---District Total---,523,"","",GRREC,902,07,37,41,6,6,12,0,0,0,0,1,1,9,6,15,0,0,0,5,4,9,21,20,41,78
20192020,071,LOGAN,523,Russellville Independent,"",---District Total---,523,"","",GRREC,902,08,36,42,12,8,20,0,0,0,2,0,2,7,5,12,0,0,0,2,7,9,19,16,35,78
20192020,071,LOGAN,523,Russellville Independent,"",---District Total---,523,"","",GRREC,902,09,55,46,9,12,21,0,0,0,0,0,0,2,3,5,0,0,0,8,10,18,27,30,57,101
20192020,071,LOGAN,523,Russellville Independent,"",---District Total---,523,"","",GRREC,902,10,35,45,7,11,18,0,0,0,0,2,2,6,2,8,0,0,0,3,2,5,29,18,47,80
20192020,071,LOGAN,523,Russellville Independent,"",---District Total---,523,"","",GRREC,902,11,31,24,9,5,14,0,0,0,0,0,0,4,3,7,0,0,0,2,4,6,9,19,28,55
20192020,071,LOGAN,523,Russellville Independent,"",---District Total---,523,"","",GRREC,902,12,27,27,4,3,7,0,0,0,3,1,4,2,2,4,0,0,0,2,3,5,16,18,34,54
20192020,071,LOGAN,523,Russellville Independent,"",---District Total---,523,"","",GRREC,902,14,1,2,0,0,0,0,0,0,0,0,0,0,0,0,0,0,0,0,0,0,2,1,3,3
20192020,071,LOGAN,523,Russellville Independent,025,R E Stevenson Elementary School,523025,071523025,210519001274,GRREC,902,04,35,46,6,7,13,1,0,1,0,0,0,4,8,12,0,0,0,8,5,13,27,15,42,81
20192020,071,LOGAN,523,Russellville Independent,025,R E Stevenson Elementary School,523025,071523025,210519001274,GRREC,902,05,27,44,8,7,15,0,0,0,0,1,1,8,3,11,0,0,0,3,4,7,25,12,37,71
20192020,071,LOGAN,523,Russellville Independent,025,R E Stevenson Elementary School,523025,071523025,210519001274,GRREC,902,KG,39,48,9,6,15,0,0,0,0,1,1,7,11,18,0,0,0,8,6,14,24,15,39,87
20192020,071,LOGAN,523,Russellville Independent,025,R E Stevenson Elementary School,523025,071523025,210519001274,GRREC,902,01,48,34,3,8,11,0,0,0,1,0,1,7,4,11,0,0,0,7,3,10,16,33,49,82
20192020,071,LOGAN,523,Russellville Independent,025,R E Stevenson Elementary School,523025,071523025,210519001274,GRREC,902,02,42,38,14,7,21,0,0,0,0,0,0,2,10,12,0,0,0,5,6,11,17,19,36,80
20192020,071,LOGAN,523,Russellville Independent,025,R E Stevenson Elementary School,523025,071523025,210519001274,GRREC,902,All Students,230,241,49,43,92,1,0,1,1,2,3,32,42,74,0,0,0,34,30,64,124,113,237,471
20192020,071,LOGAN,523,Russellville Independent,025,R E Stevenson Elementary School,523025,071523025,210519001274,GRREC,902,03,39,31,9,8,17,0,0,0,0,0,0,4,6,10,0,0,0,3,6,9,15,19,34,70
20192020,071,LOGAN,523,Russellville Independent,030,Russellville High School,523030,071523030,210519001275,GRREC,902,11,31,24,9,5,14,0,0,0,0,0,0,4,3,7,0,0,0,2,4,6,9,19,28,55
20192020,071,LOGAN,523,Russellville Independent,030,Russellville High School,523030,071523030,210519001275,GRREC,902,14,1,2,0,0,0,0,0,0,0,0,0,0,0,0,0,0,0,0,0,0,2,1,3,3
20192020,071,LOGAN,523,Russellville Independent,030,Russellville High School,523030,071523030,210519001275,GRREC,902,All Students,149,144,29,31,60,0,0,0,3,3,6,14,10,24,0,0,0,15,19,34,83,86,169,293
20192020,071,LOGAN,523,Russellville Independent,030,Russellville High School,523030,071523030,210519001275,GRREC,902,09,55,46,9,12,21,0,0,0,0,0,0,2,3,5,0,0,0,8,10,18,27,30,57,101
20192020,071,LOGAN,523,Russellville Independent,030,Russellville High School,523030,071523030,210519001275,GRREC,902,10,35,45,7,11,18,0,0,0,0,2,2,6,2,8,0,0,0,3,2,5,29,18,47,80
20192020,071,LOGAN,523,Russellville Independent,030,Russellville High School,523030,071523030,210519001275,GRREC,902,12,27,27,4,3,7,0,0,0,3,1,4,2,2,4,0,0,0,2,3,5,16,18,34,54
20192020,071,LOGAN,523,Russellville Independent,050,Russellville Middle School,523050,071523050,210519001276,GRREC,902,06,42,37,7,6,13,0,0,0,0,0,0,7,6,13,0,0,0,5,9,14,18,21,39,79
20192020,071,LOGAN,523,Russellville Independent,050,Russellville Middle School,523050,071523050,210519001276,GRREC,902,08,36,42,12,8,20,0,0,0,2,0,2,7,5,12,0,0,0,2,7,9,19,16,35,78
20192020,071,LOGAN,523,Russellville Independent,050,Russellville Middle School,523050,071523050,210519001276,GRREC,902,All Students,115,125,25,20,45,0,0,0,2,1,3,23,17,40,0,0,0,14,20,34,61,57,118,240
20192020,071,LOGAN,523,Russellville Independent,050,Russellville Middle School,523050,071523050,210519001276,GRREC,902,04,0,1,0,0,0,0,0,0,0,0,0,0,0,0,0,0,0,0,0,0,1,0,1,1
20192020,071,LOGAN,523,Russellville Independent,050,Russellville Middle School,523050,071523050,210519001276,GRREC,902,05,0,4,0,0,0,0,0,0,0,0,0,0,0,0,0,0,0,2,0,2,2,0,2,4
20192020,071,LOGAN,523,Russellville Independent,050,Russellville Middle School,523050,071523050,210519001276,GRREC,902,07,37,41,6,6,12,0,0,0,0,1,1,9,6,15,0,0,0,5,4,9,21,20,41,78
20192020,100,PULASKI,524,Science Hill Independent,"",---District Total---,524,"","",SESC,907,06,28,27,0,0,0,0,0,0,0,0,0,1,1,2,0,0,0,0,0,0,26,27,53,55
20192020,100,PULASKI,524,Science Hill Independent,"",---District Total---,524,"","",SESC,907,All Students,199,205,0,0,0,0,0,0,2,2,4,9,11,20,0,0,0,2,5,7,192,181,373,404
20192020,100,PULASKI,524,Science Hill Independent,"",---District Total---,524,"","",SESC,907,PS,10,8,0,0,0,0,0,0,0,0,0,0,0,0,0,0,0,0,0,0,8,10,18,18
20192020,100,PULASKI,524,Science Hill Independent,"",---District Total---,524,"","",SESC,907,KG,28,28,0,0,0,0,0,0,1,0,1,2,3,5,0,0,0,0,1,1,25,24,49,56
20192020,100,PULASKI,524,Science Hill Independent,"",---District Total---,524,"","",SESC,907,01,22,18,0,0,0,0,0,0,0,0,0,0,1,1,0,0,0,0,0,0,18,21,39,40
20192020,100,PULASKI,524,Science Hill Independent,"",---District Total---,524,"","",SESC,907,02,23,19,0,0,0,0,0,0,0,1,1,0,0,0,0,0,0,1,3,4,18,19,37,42
20192020,100,PULASKI,524,Science Hill Independent,"",---District Total---,524,"","",SESC,907,03,22,22,0,0,0,0,0,0,0,1,1,2,2,4,0,0,0,0,0,0,20,19,39,44
20192020,100,PULASKI,524,Science Hill Independent,"",---District Total---,524,"","",SESC,907,04,18,24,0,0,0,0,0,0,0,0,0,2,2,4,0,0,0,0,0,0,22,16,38,42
20192020,100,PULASKI,524,Science Hill Independent,"",---District Total---,524,"","",SESC,907,05,25,23,0,0,0,0,0,0,0,0,0,0,0,0,0,0,0,1,1,2,22,24,46,48
20192020,100,PULASKI,524,Science Hill Independent,"",---District Total---,524,"","",SESC,907,07,12,21,0,0,0,0,0,0,0,0,0,1,1,2,0,0,0,0,0,0,20,11,31,33
20192020,100,PULASKI,524,Science Hill Independent,"",---District Total---,524,"","",SESC,907,08,21,23,0,0,0,0,0,0,1,0,1,1,1,2,0,0,0,0,0,0,21,20,41,44
20192020,100,PULASKI,524,Science Hill Independent,010,Science Hill Elementary School,524010,100524010,210522001277,SESC,907,KG,28,28,0,0,0,0,0,0,1,0,1,2,3,5,0,0,0,0,1,1,25,24,49,56
20192020,100,PULASKI,524,Science Hill Independent,010,Science Hill Elementary School,524010,100524010,210522001277,SESC,907,01,22,18,0,0,0,0,0,0,0,0,0,0,1,1,0,0,0,0,0,0,18,21,39,40
20192020,100,PULASKI,524,Science Hill Independent,010,Science Hill Elementary School,524010,100524010,210522001277,SESC,907,02,23,19,0,0,0,0,0,0,0,1,1,0,0,0,0,0,0,1,3,4,18,19,37,42
20192020,100,PULASKI,524,Science Hill Independent,010,Science Hill Elementary School,524010,100524010,210522001277,SESC,907,03,22,22,0,0,0,0,0,0,0,1,1,2,2,4,0,0,0,0,0,0,20,19,39,44
20192020,100,PULASKI,524,Science Hill Independent,010,Science Hill Elementary School,524010,100524010,210522001277,SESC,907,04,18,24,0,0,0,0,0,0,0,0,0,2,2,4,0,0,0,0,0,0,22,16,38,42
20192020,100,PULASKI,524,Science Hill Independent,010,Science Hill Elementary School,524010,100524010,210522001277,SESC,907,05,25,23,0,0,0,0,0,0,0,0,0,0,0,0,0,0,0,1,1,2,22,24,46,48
20192020,100,PULASKI,524,Science Hill Independent,010,Science Hill Elementary School,524010,100524010,210522001277,SESC,907,06,28,27,0,0,0,0,0,0,0,0,0,1,1,2,0,0,0,0,0,0,26,27,53,55
20192020,100,PULASKI,524,Science Hill Independent,010,Science Hill Elementary School,524010,100524010,210522001277,SESC,907,07,12,21,0,0,0,0,0,0,0,0,0,1,1,2,0,0,0,0,0,0,20,11,31,33
20192020,100,PULASKI,524,Science Hill Independent,010,Science Hill Elementary School,524010,100524010,210522001277,SESC,907,08,21,23,0,0,0,0,0,0,1,0,1,1,1,2,0,0,0,0,0,0,21,20,41,44
20192020,100,PULASKI,524,Science Hill Independent,010,Science Hill Elementary School,524010,100524010,210522001277,SESC,907,All Students,199,205,0,0,0,0,0,0,2,2,4,9,11,20,0,0,0,2,5,7,192,181,373,404
20192020,100,PULASKI,524,Science Hill Independent,010,Science Hill Elementary School,524010,100524010,210522001277,SESC,907,PS,10,8,0,0,0,0,0,0,0,0,0,0,0,0,0,0,0,0,0,0,8,10,18,18
20192020,105,SCOTT,525,Scott County,"",---District Total---,525,"","",CKEC,901,08,367,363,34,20,54,0,0,0,3,3,6,31,49,80,1,0,1,10,13,23,284,282,566,730
20192020,105,SCOTT,525,Scott County,"",---District Total---,525,"","",CKEC,901,09,391,425,34,28,62,2,2,4,0,6,6,45,34,79,1,0,1,18,27,45,325,294,619,816
20192020,105,SCOTT,525,Scott County,"",---District Total---,525,"","",CKEC,901,10,350,361,12,24,36,1,1,2,2,4,6,39,35,74,2,1,3,12,14,26,293,271,564,711
20192020,105,SCOTT,525,Scott County,"",---District Total---,525,"","",CKEC,901,11,309,307,17,22,39,0,0,0,2,3,5,19,30,49,0,0,0,14,11,25,255,243,498,616
20192020,105,SCOTT,525,Scott County,"",---District Total---,525,"","",CKEC,901,All Students,4619,4703,311,276,587,5,4,9,33,44,77,455,450,905,9,8,17,234,203,437,3656,3634,7290,9322
20192020,105,SCOTT,525,Scott County,"",---District Total---,525,"","",CKEC,901,PS,145,255,14,9,23,2,0,2,2,1,3,24,10,34,0,0,0,8,7,15,205,118,323,400
20192020,105,SCOTT,525,Scott County,"",---District Total---,525,"","",CKEC,901,KG,366,343,20,21,41,0,0,0,3,4,7,23,27,50,1,0,1,21,18,39,275,296,571,709
20192020,105,SCOTT,525,Scott County,"",---District Total---,525,"","",CKEC,901,01,358,434,25,18,43,1,0,1,2,3,5,55,27,82,2,1,3,25,14,39,324,295,619,792
20192020,105,SCOTT,525,Scott County,"",---District Total---,525,"","",CKEC,901,02,301,337,30,18,48,0,0,0,1,5,6,24,29,53,2,1,3,17,17,34,263,231,494,638
20192020,105,SCOTT,525,Scott County,"",---District Total---,525,"","",CKEC,901,03,333,339,18,20,38,0,0,0,4,3,7,44,28,72,0,2,2,18,15,33,255,265,520,672
20192020,105,SCOTT,525,Scott County,"",---District Total---,525,"","",CKEC,901,04,382,367,20,15,35,0,0,0,1,3,4,43,40,83,0,0,0,16,16,32,287,308,595,749
20192020,105,SCOTT,525,Scott County,"",---District Total---,525,"","",CKEC,901,05,387,396,28,22,50,0,0,0,6,2,8,39,36,75,0,0,0,25,17,42,298,310,608,783
20192020,105,SCOTT,525,Scott County,"",---District Total---,525,"","",CKEC,901,06,386,348,17,22,39,0,1,1,4,2,6,40,46,86,0,1,1,20,16,36,267,298,565,734
20192020,105,SCOTT,525,Scott County,"",---District Total---,525,"","",CKEC,901,07,359,411,33,21,54,1,0,1,3,4,7,33,41,74,0,2,2,25,16,41,316,275,591,770
20192020,105,SCOTT,525,Scott County,"",---District Total---,525,"","",CKEC,901,12,328,268,23,25,48,0,0,0,2,2,4,20,28,48,0,0,0,13,9,22,210,264,474,596
20192020,105,SCOTT,525,Scott County,"",---District Total---,525,"","",CKEC,901,14,2,4,0,0,0,0,0,0,0,0,0,0,0,0,0,0,0,0,0,0,4,2,6,6
20192020,105,SCOTT,525,Scott County,005,Phoenix Horizon Community,525005,105525005,210526002432,CKEC,901,12,29,14,2,1,3,0,0,0,0,0,0,3,3,6,0,0,0,1,0,1,8,25,33,43
20192020,105,SCOTT,525,Scott County,005,Phoenix Horizon Community,525005,105525005,210526002432,CKEC,901,All Students,64,55,8,2,10,1,0,1,0,0,0,9,9,18,0,0,0,3,4,7,34,49,83,119
20192020,105,SCOTT,525,Scott County,005,Phoenix Horizon Community,525005,105525005,210526002432,CKEC,901,07,2,2,0,0,0,0,0,0,0,0,0,0,1,1,0,0,0,1,0,1,1,1,2,4
20192020,105,SCOTT,525,Scott County,005,Phoenix Horizon Community,525005,105525005,210526002432,CKEC,901,08,5,7,3,0,3,0,0,0,0,0,0,1,1,2,0,0,0,0,0,0,3,4,7,12
20192020,105,SCOTT,525,Scott County,005,Phoenix Horizon Community,525005,105525005,210526002432,CKEC,901,09,5,12,2,0,2,1,0,1,0,0,0,2,1,3,0,0,0,0,0,0,7,4,11,17
20192020,105,SCOTT,525,Scott County,005,Phoenix Horizon Community,525005,105525005,210526002432,CKEC,901,10,8,7,1,1,2,0,0,0,0,0,0,0,2,2,0,0,0,0,1,1,6,4,10,15
20192020,105,SCOTT,525,Scott County,005,Phoenix Horizon Community,525005,105525005,210526002432,CKEC,901,11,15,13,0,0,0,0,0,0,0,0,0,3,1,4,0,0,0,1,3,4,9,11,20,28
20192020,105,SCOTT,525,Scott County,010,Eastern Elementary School,525010,105525010,210526001278,CKEC,901,03,35,36,1,1,2,0,0,0,2,1,3,1,3,4,0,0,0,0,0,0,32,30,62,71
20192020,105,SCOTT,525,Scott County,010,Eastern Elementary School,525010,105525010,210526001278,CKEC,901,All Students,229,198,9,6,15,0,0,0,6,2,8,10,10,20,0,0,0,10,4,14,163,207,370,427
20192020,105,SCOTT,525,Scott County,010,Eastern Elementary School,525010,105525010,210526001278,CKEC,901,KG,39,25,1,0,1,0,0,0,1,0,1,1,0,1,0,0,0,0,1,1,22,38,60,64
20192020,105,SCOTT,525,Scott County,010,Eastern Elementary School,525010,105525010,210526001278,CKEC,901,01,28,36,2,2,4,0,0,0,0,0,0,4,1,5,0,0,0,1,2,3,29,23,52,64
20192020,105,SCOTT,525,Scott County,010,Eastern Elementary School,525010,105525010,210526001278,CKEC,901,02,35,33,3,1,4,0,0,0,1,1,2,1,2,3,0,0,0,1,1,2,27,30,57,68
20192020,105,SCOTT,525,Scott County,010,Eastern Elementary School,525010,105525010,210526001278,CKEC,901,05,48,32,2,0,2,0,0,0,2,0,2,1,1,2,0,0,0,3,0,3,24,47,71,80
20192020,105,SCOTT,525,Scott County,010,Eastern Elementary School,525010,105525010,210526001278,CKEC,901,04,44,36,0,2,2,0,0,0,0,0,0,2,3,5,0,0,0,5,0,5,29,39,68,80
20192020,105,SCOTT,525,Scott County,012,Anne Mason Elementary School,525012,105525012,210526001942,CKEC,901,03,43,38,6,6,12,0,0,0,2,0,2,3,0,3,0,0,0,4,5,9,23,32,55,81
20192020,105,SCOTT,525,Scott County,012,Anne Mason Elementary School,525012,105525012,210526001942,CKEC,901,All Students,238,252,34,28,62,0,0,0,2,5,7,12,13,25,1,0,1,21,24,45,182,168,350,490
20192020,105,SCOTT,525,Scott County,012,Anne Mason Elementary School,525012,105525012,210526001942,CKEC,901,KG,45,35,4,6,10,0,0,0,0,2,2,1,2,3,0,0,0,5,2,7,25,33,58,80
20192020,105,SCOTT,525,Scott County,012,Anne Mason Elementary School,525012,105525012,210526001942,CKEC,901,01,36,51,6,5,11,0,0,0,0,2,2,3,2,5,0,0,0,5,2,7,37,25,62,87
20192020,105,SCOTT,525,Scott County,012,Anne Mason Elementary School,525012,105525012,210526001942,CKEC,901,02,28,31,5,3,8,0,0,0,0,0,0,2,3,5,1,0,1,2,3,5,21,19,40,59
20192020,105,SCOTT,525,Scott County,012,Anne Mason Elementary School,525012,105525012,210526001942,CKEC,901,04,45,49,7,3,10,0,0,0,0,1,1,1,4,5,0,0,0,2,8,10,39,29,68,94
20192020,105,SCOTT,525,Scott County,012,Anne Mason Elementary School,525012,105525012,210526001942,CKEC,901,05,41,48,6,5,11,0,0,0,0,0,0,2,2,4,0,0,0,3,4,7,37,30,67,89
20192020,105,SCOTT,525,Scott County,013,Royal Spring Middle School,525013,105525013,210526002017,CKEC,901,07,126,152,16,11,27,1,0,1,2,2,4,8,11,19,0,1,1,10,4,14,115,97,212,278
20192020,105,SCOTT,525,Scott County,013,Royal Spring Middle School,525013,105525013,210526002017,CKEC,901,08,150,125,7,13,20,0,0,0,2,2,4,9,17,26,1,0,1,3,3,6,103,115,218,275
20192020,105,SCOTT,525,Scott County,013,Royal Spring Middle School,525013,105525013,210526002017,CKEC,901,All Students,425,404,29,39,68,1,0,1,6,5,11,30,44,74,1,2,3,21,13,34,316,322,638,829
20192020,105,SCOTT,525,Scott County,013,Royal Spring Middle School,525013,105525013,210526002017,CKEC,901,06,149,127,6,15,21,0,0,0,2,1,3,13,16,29,0,1,1,8,6,14,98,110,208,276
20192020,105,SCOTT,525,Scott County,014,Lemons Mill Elementary School,525014,105525014,210526002349,CKEC,901,02,37,41,4,5,9,0,0,0,0,0,0,4,6,10,0,0,0,3,3,6,30,23,53,78
20192020,105,SCOTT,525,Scott County,014,Lemons Mill Elementary School,525014,105525014,210526002349,CKEC,901,03,40,36,2,3,5,0,0,0,0,0,0,8,4,12,0,0,0,1,1,2,25,32,57,76
20192020,105,SCOTT,525,Scott County,014,Lemons Mill Elementary School,525014,105525014,210526002349,CKEC,901,05,50,59,2,4,6,0,0,0,1,0,1,3,3,6,0,0,0,6,4,10,47,39,86,109
20192020,105,SCOTT,525,Scott County,014,Lemons Mill Elementary School,525014,105525014,210526002349,CKEC,901,04,25,41,2,1,3,0,0,0,0,0,0,7,4,11,0,0,0,1,1,2,31,19,50,66
20192020,105,SCOTT,525,Scott County,014,Lemons Mill Elementary School,525014,105525014,210526002349,CKEC,901,All Students,226,248,12,15,27,0,0,0,1,0,1,37,24,61,0,0,0,13,11,24,185,176,361,474
20192020,105,SCOTT,525,Scott County,014,Lemons Mill Elementary School,525014,105525014,210526002349,CKEC,901,KG,33,31,1,0,1,0,0,0,0,0,0,6,3,9,0,0,0,1,0,1,23,30,53,64
20192020,105,SCOTT,525,Scott County,014,Lemons Mill Elementary School,525014,105525014,210526002349,CKEC,901,01,41,40,1,2,3,0,0,0,0,0,0,9,4,13,0,0,0,1,2,3,29,33,62,81
20192020,105,SCOTT,525,Scott County,015,Garth Elementary School,525015,105525015,210526001279,CKEC,901,04,32,39,4,2,6,0,0,0,0,0,0,3,4,7,0,0,0,3,0,3,29,26,55,71
20192020,105,SCOTT,525,Scott County,015,Garth Elementary School,525015,105525015,210526001279,CKEC,901,All Students,171,203,24,10,34,1,0,1,1,0,1,17,12,29,0,0,0,13,10,23,147,139,286,374
20192020,105,SCOTT,525,Scott County,015,Garth Elementary School,525015,105525015,210526001279,CKEC,901,KG,34,34,3,4,7,0,0,0,0,0,0,1,0,1,0,0,0,2,3,5,28,27,55,68
20192020,105,SCOTT,525,Scott County,015,Garth Elementary School,525015,105525015,210526001279,CKEC,901,01,26,40,4,0,4,1,0,1,0,0,0,6,3,9,0,0,0,2,2,4,27,21,48,66
20192020,105,SCOTT,525,Scott County,015,Garth Elementary School,525015,105525015,210526001279,CKEC,901,02,19,31,4,0,4,0,0,0,0,0,0,0,1,1,0,0,0,3,2,5,24,16,40,50
20192020,105,SCOTT,525,Scott County,015,Garth Elementary School,525015,105525015,210526001279,CKEC,901,03,30,27,5,1,6,0,0,0,0,0,0,3,2,5,0,0,0,0,3,3,19,24,43,57
20192020,105,SCOTT,525,Scott County,015,Garth Elementary School,525015,105525015,210526001279,CKEC,901,05,30,32,4,3,7,0,0,0,1,0,1,4,2,6,0,0,0,3,0,3,20,25,45,62
20192020,105,SCOTT,525,Scott County,018,Georgetown Middle School,525018,105525018,210526001280,CKEC,901,08,74,106,23,4,27,0,0,0,0,0,0,10,18,28,0,0,0,5,6,11,68,46,114,180
20192020,105,SCOTT,525,Scott County,018,Georgetown Middle School,525018,105525018,210526001280,CKEC,901,All Students,266,290,48,19,67,0,1,1,0,1,1,28,51,79,0,1,1,25,23,48,189,170,359,556
20192020,105,SCOTT,525,Scott County,018,Georgetown Middle School,525018,105525018,210526001280,CKEC,901,06,95,78,11,6,17,0,1,1,0,0,0,11,19,30,0,0,0,7,6,13,49,63,112,173
20192020,105,SCOTT,525,Scott County,018,Georgetown Middle School,525018,105525018,210526001280,CKEC,901,07,97,106,14,9,23,0,0,0,0,1,1,7,14,21,0,1,1,13,11,24,72,61,133,203
20192020,105,SCOTT,525,Scott County,019,Scott County Preschool,525019,105525019,210526002204,CKEC,901,PS,145,255,14,9,23,2,0,2,2,1,3,24,10,34,0,0,0,8,7,15,205,118,323,400
20192020,105,SCOTT,525,Scott County,019,Scott County Preschool,525019,105525019,210526002204,CKEC,901,All Students,0,0,0,0,0,0,0,0,0,0,0,0,0,0,0,0,0,0,0,0,0,0,0,0
20192020,105,SCOTT,525,Scott County,025,Great Crossing High School,525025,105525025,210526002482,CKEC,901,09,114,166,14,13,27,1,2,3,0,0,0,27,16,43,0,0,0,13,11,24,111,72,183,280
20192020,105,SCOTT,525,Scott County,025,Great Crossing High School,525025,105525025,210526002482,CKEC,901,10,115,127,6,15,21,1,1,2,0,0,0,24,16,40,0,0,0,8,6,14,88,77,165,242
20192020,105,SCOTT,525,Scott County,025,Great Crossing High School,525025,105525025,210526002482,CKEC,901,11,124,112,9,11,20,0,0,0,0,2,2,8,21,29,0,0,0,7,2,9,88,88,176,236
20192020,105,SCOTT,525,Scott County,025,Great Crossing High School,525025,105525025,210526002482,CKEC,901,14,1,1,0,0,0,0,0,0,0,0,0,0,0,0,0,0,0,0,0,0,1,1,2,2
20192020,105,SCOTT,525,Scott County,025,Great Crossing High School,525025,105525025,210526002482,CKEC,901,12,74,86,12,14,26,0,0,0,0,0,0,6,7,13,0,0,0,4,3,7,64,50,114,160
20192020,105,SCOTT,525,Scott County,025,Great Crossing High School,525025,105525025,210526002482,CKEC,901,All Students,428,492,41,53,94,2,3,5,0,2,2,65,60,125,0,0,0,32,22,54,352,288,640,920
20192020,105,SCOTT,525,Scott County,029,Creekside Elementary,525029,105525029,210526002483,CKEC,901,04,36,39,0,2,2,0,0,0,0,2,2,8,5,13,0,0,0,0,1,1,31,26,57,75
20192020,105,SCOTT,525,Scott County,029,Creekside Elementary,525029,105525029,210526002483,CKEC,901,All Students,246,274,15,25,40,0,0,0,1,4,5,49,36,85,1,2,3,15,9,24,193,170,363,520
20192020,105,SCOTT,525,Scott County,029,Creekside Elementary,525029,105525029,210526002483,CKEC,901,KG,50,52,2,4,6,0,0,0,0,0,0,6,11,17,0,0,0,4,2,6,40,33,73,102
20192020,105,SCOTT,525,Scott County,029,Creekside Elementary,525029,105525029,210526002483,CKEC,901,01,47,64,4,6,10,0,0,0,1,0,1,14,3,17,1,0,1,4,1,5,40,37,77,111
20192020,105,SCOTT,525,Scott County,029,Creekside Elementary,525029,105525029,210526002483,CKEC,901,02,29,41,5,5,10,0,0,0,0,1,1,9,4,13,0,1,1,1,0,1,26,18,44,70
20192020,105,SCOTT,525,Scott County,029,Creekside Elementary,525029,105525029,210526002483,CKEC,901,03,45,34,0,4,4,0,0,0,0,0,0,6,4,10,0,1,1,4,2,6,24,34,58,79
20192020,105,SCOTT,525,Scott County,029,Creekside Elementary,525029,105525029,210526002483,CKEC,901,05,39,44,4,4,8,0,0,0,0,1,1,6,9,15,0,0,0,2,3,5,32,22,54,83
20192020,105,SCOTT,525,Scott County,035,Northern Elementary School,525035,105525035,210526001687,CKEC,901,05,39,46,2,0,2,0,0,0,0,0,0,1,1,2,0,0,0,0,1,1,43,37,80,85
20192020,105,SCOTT,525,Scott County,035,Northern Elementary School,525035,105525035,210526001687,CKEC,901,All Students,239,238,7,0,7,0,0,0,0,0,0,4,7,11,0,1,1,10,12,22,217,219,436,477
20192020,105,SCOTT,525,Scott County,035,Northern Elementary School,525035,105525035,210526001687,CKEC,901,KG,36,42,1,0,1,0,0,0,0,0,0,0,0,0,0,0,0,3,5,8,38,31,69,78
20192020,105,SCOTT,525,Scott County,035,Northern Elementary School,525035,105525035,210526001687,CKEC,901,01,44,46,2,0,2,0,0,0,0,0,0,1,1,2,0,1,1,5,0,5,38,42,80,90
20192020,105,SCOTT,525,Scott County,035,Northern Elementary School,525035,105525035,210526001687,CKEC,901,02,37,41,1,0,1,0,0,0,0,0,0,2,0,2,0,0,0,1,3,4,37,34,71,78
20192020,105,SCOTT,525,Scott County,035,Northern Elementary School,525035,105525035,210526001687,CKEC,901,04,54,32,1,0,1,0,0,0,0,0,0,0,2,2,0,0,0,1,2,3,30,50,80,86
20192020,105,SCOTT,525,Scott County,035,Northern Elementary School,525035,105525035,210526001687,CKEC,901,03,29,31,0,0,0,0,0,0,0,0,0,0,3,3,0,0,0,0,1,1,31,25,56,60
20192020,105,SCOTT,525,Scott County,040,Scott County High School,525040,105525040,210526001283,CKEC,901,All Students,413,472,33,29,62,0,0,0,5,6,11,34,39,73,2,0,2,15,17,32,383,322,705,885
20192020,105,SCOTT,525,Scott County,040,Scott County High School,525040,105525040,210526001283,CKEC,901,08,1,0,0,0,0,0,0,0,0,0,0,0,0,0,0,0,0,0,0,0,0,1,1,1
20192020,105,SCOTT,525,Scott County,040,Scott County High School,525040,105525040,210526001283,CKEC,901,09,78,104,12,9,21,0,0,0,0,2,2,13,7,20,1,0,1,4,7,11,74,53,127,182
20192020,105,SCOTT,525,Scott County,040,Scott County High School,525040,105525040,210526001283,CKEC,901,10,88,122,5,5,10,0,0,0,2,2,4,8,11,19,1,0,1,2,3,5,104,67,171,210
20192020,105,SCOTT,525,Scott County,040,Scott County High School,525040,105525040,210526001283,CKEC,901,11,94,114,8,6,14,0,0,0,2,0,2,5,7,12,0,0,0,3,4,7,96,77,173,208
20192020,105,SCOTT,525,Scott County,040,Scott County High School,525040,105525040,210526001283,CKEC,901,12,151,129,8,9,17,0,0,0,1,2,3,8,14,22,0,0,0,6,3,9,106,123,229,280
20192020,105,SCOTT,525,Scott County,040,Scott County High School,525040,105525040,210526001283,CKEC,901,14,1,3,0,0,0,0,0,0,0,0,0,0,0,0,0,0,0,0,0,0,3,1,4,4
20192020,105,SCOTT,525,Scott County,044,Elkhorn Crossing School,525044,105525044,210526002301,CKEC,901,11,76,68,0,5,5,0,0,0,0,1,1,3,1,4,0,0,0,3,2,5,62,67,129,144
20192020,105,SCOTT,525,Scott County,044,Elkhorn Crossing School,525044,105525044,210526002301,CKEC,901,All Students,483,355,7,15,22,0,0,0,1,7,8,16,21,37,1,1,2,8,18,26,322,421,743,838
20192020,105,SCOTT,525,Scott County,044,Elkhorn Crossing School,525044,105525044,210526002301,CKEC,901,12,74,39,1,1,2,0,0,0,1,0,1,3,4,7,0,0,0,2,3,5,32,66,98,113
20192020,105,SCOTT,525,Scott County,044,Elkhorn Crossing School,525044,105525044,210526002301,CKEC,901,09,194,143,6,6,12,0,0,0,0,4,4,3,10,13,0,0,0,1,9,10,133,165,298,337
20192020,105,SCOTT,525,Scott County,044,Elkhorn Crossing School,525044,105525044,210526002301,CKEC,901,10,139,105,0,3,3,0,0,0,0,2,2,7,6,13,1,1,2,2,4,6,95,123,218,244
20192020,105,SCOTT,525,Scott County,050,Stamping Ground Elementary School,525050,105525050,210526001284,CKEC,901,03,31,34,0,1,1,0,0,0,0,0,0,2,0,2,0,0,0,3,1,4,29,29,58,65
20192020,105,SCOTT,525,Scott County,050,Stamping Ground Elementary School,525050,105525050,210526001284,CKEC,901,05,43,28,0,1,1,0,0,0,0,0,0,0,5,5,0,0,0,0,1,1,28,36,64,71
20192020,105,SCOTT,525,Scott County,050,Stamping Ground Elementary School,525050,105525050,210526001284,CKEC,901,04,39,45,2,0,2,0,0,0,1,0,1,3,1,4,0,0,0,0,1,1,39,37,76,84
20192020,105,SCOTT,525,Scott County,050,Stamping Ground Elementary School,525050,105525050,210526001284,CKEC,901,All Students,199,207,2,2,4,0,0,0,1,0,1,9,11,20,0,0,0,7,7,14,188,179,367,406
20192020,105,SCOTT,525,Scott County,050,Stamping Ground Elementary School,525050,105525050,210526001284,CKEC,901,KG,33,31,0,0,0,0,0,0,0,0,0,0,0,0,0,0,0,2,2,4,29,31,60,64
20192020,105,SCOTT,525,Scott County,050,Stamping Ground Elementary School,525050,105525050,210526001284,CKEC,901,01,33,44,0,0,0,0,0,0,0,0,0,2,3,5,0,0,0,1,1,2,41,29,70,77
20192020,105,SCOTT,525,Scott County,050,Stamping Ground Elementary School,525050,105525050,210526001284,CKEC,901,02,20,25,0,0,0,0,0,0,0,0,0,2,2,4,0,0,0,1,1,2,22,17,39,45
20192020,105,SCOTT,525,Scott County,060,Scott County Middle School,525060,105525060,210526001285,CKEC,901,07,134,151,3,1,4,0,0,0,1,1,2,18,15,33,0,0,0,1,1,2,128,116,244,285
20192020,105,SCOTT,525,Scott County,060,Scott County Middle School,525060,105525060,210526001285,CKEC,901,All Students,413,419,4,5,9,0,0,0,4,3,7,45,39,84,0,0,0,8,9,17,358,357,715,832
20192020,105,SCOTT,525,Scott County,060,Scott County Middle School,525060,105525060,210526001285,CKEC,901,06,142,143,0,1,1,0,0,0,2,1,3,16,11,27,0,0,0,5,4,9,120,125,245,285
20192020,105,SCOTT,525,Scott County,060,Scott County Middle School,525060,105525060,210526001285,CKEC,901,08,137,125,1,3,4,0,0,0,1,1,2,11,13,24,0,0,0,2,4,6,110,116,226,262
20192020,105,SCOTT,525,Scott County,070,Southern Elementary School,525070,105525070,210526001286,CKEC,901,04,45,42,4,5,9,0,0,0,0,0,0,9,6,15,0,0,0,4,2,6,25,32,57,87
20192020,105,SCOTT,525,Scott County,070,Southern Elementary School,525070,105525070,210526001286,CKEC,901,All Students,264,278,32,23,55,0,0,0,2,3,5,33,32,65,1,1,2,28,14,42,182,191,373,542
20192020,105,SCOTT,525,Scott County,070,Southern Elementary School,525070,105525070,210526001286,CKEC,901,KG,50,44,7,5,12,0,0,0,1,1,2,2,6,8,1,0,1,4,3,7,29,35,64,94
20192020,105,SCOTT,525,Scott County,070,Southern Elementary School,525070,105525070,210526001286,CKEC,901,01,55,52,4,2,6,0,0,0,1,1,2,5,3,8,0,0,0,5,2,7,37,47,84,107
20192020,105,SCOTT,525,Scott County,070,Southern Elementary School,525070,105525070,210526001286,CKEC,901,02,38,45,7,3,10,0,0,0,0,1,1,2,5,7,0,0,0,4,3,7,32,26,58,83
20192020,105,SCOTT,525,Scott County,070,Southern Elementary School,525070,105525070,210526001286,CKEC,901,03,32,46,4,4,8,0,0,0,0,0,0,4,6,10,0,1,1,5,1,6,33,20,53,78
20192020,105,SCOTT,525,Scott County,070,Southern Elementary School,525070,105525070,210526001286,CKEC,901,05,44,49,6,4,10,0,0,0,0,0,0,11,6,17,0,0,0,6,3,9,26,31,57,93
20192020,105,SCOTT,525,Scott County,080,Western Elementary School,525080,105525080,210526000530,CKEC,901,04,62,44,0,0,0,0,0,0,0,0,0,10,11,21,0,0,0,0,1,1,34,50,84,106
20192020,105,SCOTT,525,Scott County,080,Western Elementary School,525080,105525080,210526000530,CKEC,901,All Students,315,318,6,5,11,0,0,0,3,6,9,57,42,99,2,0,2,5,6,11,245,256,501,633
20192020,105,SCOTT,525,Scott County,080,Western Elementary School,525080,105525080,210526000530,CKEC,901,KG,46,49,1,2,3,0,0,0,1,1,2,6,5,11,0,0,0,0,0,0,41,38,79,95
20192020,105,SCOTT,525,Scott County,080,Western Elementary School,525080,105525080,210526000530,CKEC,901,01,48,61,2,1,3,0,0,0,0,0,0,11,7,18,1,0,1,1,2,3,46,38,84,109
20192020,105,SCOTT,525,Scott County,080,Western Elementary School,525080,105525080,210526000530,CKEC,901,02,58,49,1,1,2,0,0,0,0,2,2,2,6,8,1,0,1,1,1,2,44,48,92,107
20192020,105,SCOTT,525,Scott County,080,Western Elementary School,525080,105525080,210526000530,CKEC,901,03,48,57,0,0,0,0,0,0,0,2,2,17,6,23,0,0,0,1,1,2,39,39,78,105
20192020,105,SCOTT,525,Scott County,080,Western Elementary School,525080,105525080,210526000530,CKEC,901,05,53,58,2,1,3,0,0,0,2,1,3,11,7,18,0,0,0,2,1,3,41,43,84,111
20192020,106,SHELBY,531,Shelby County,"",---District Total---,531,"","",OVEC,906,KG,246,273,11,11,22,0,0,0,0,0,0,63,47,110,0,0,0,23,17,40,176,171,347,519
20192020,106,SHELBY,531,Shelby County,"",---District Total---,531,"","",OVEC,906,14,1,5,0,0,0,0,0,0,0,0,0,1,0,1,0,0,0,1,0,1,3,1,4,6
20192020,106,SHELBY,531,Shelby County,"",---District Total---,531,"","",OVEC,906,All Students,3285,3645,244,192,436,7,5,12,23,25,48,822,719,1541,2,1,3,203,163,366,2344,2180,4524,6930
20192020,106,SHELBY,531,Shelby County,"",---District Total---,531,"","",OVEC,906,PS,132,133,15,12,27,0,0,0,0,0,0,36,42,78,0,0,0,6,9,15,76,69,145,265
20192020,106,SHELBY,531,Shelby County,"",---District Total---,531,"","",OVEC,906,01,245,283,19,12,31,0,0,0,3,0,3,61,65,126,0,0,0,14,14,28,186,154,340,528
20192020,106,SHELBY,531,Shelby County,"",---District Total---,531,"","",OVEC,906,02,232,276,12,9,21,0,0,0,0,2,2,52,47,99,0,0,0,21,18,39,191,156,347,508
20192020,106,SHELBY,531,Shelby County,"",---District Total---,531,"","",OVEC,906,03,225,256,20,10,30,0,1,1,0,0,0,65,53,118,0,0,0,12,8,20,159,153,312,481
20192020,106,SHELBY,531,Shelby County,"",---District Total---,531,"","",OVEC,906,04,240,296,24,17,41,0,0,0,3,2,5,66,53,119,0,0,0,18,8,26,185,160,345,536
20192020,106,SHELBY,531,Shelby County,"",---District Total---,531,"","",OVEC,906,05,269,268,16,16,32,0,0,0,3,2,5,59,58,117,0,0,0,13,15,28,177,178,355,537
20192020,106,SHELBY,531,Shelby County,"",---District Total---,531,"","",OVEC,906,06,252,269,14,17,31,0,1,1,0,2,2,59,69,128,0,0,0,20,10,30,176,153,329,521
20192020,106,SHELBY,531,Shelby County,"",---District Total---,531,"","",OVEC,906,07,283,291,25,16,41,2,0,2,1,1,2,72,64,136,1,0,1,19,12,31,171,190,361,574
20192020,106,SHELBY,531,Shelby County,"",---District Total---,531,"","",OVEC,906,08,245,294,22,9,31,2,0,2,3,5,8,69,55,124,0,0,0,16,12,28,182,164,346,539
20192020,106,SHELBY,531,Shelby County,"",---District Total---,531,"","",OVEC,906,09,280,305,16,28,44,0,0,0,2,5,7,79,61,140,1,0,1,13,19,32,194,167,361,585
20192020,106,SHELBY,531,Shelby County,"",---District Total---,531,"","",OVEC,906,10,275,270,17,21,38,1,1,2,2,3,5,70,59,129,0,1,1,10,9,19,170,181,351,545
20192020,106,SHELBY,531,Shelby County,"",---District Total---,531,"","",OVEC,906,11,252,298,19,12,31,0,1,1,5,2,7,49,41,90,0,0,0,6,7,13,219,189,408,550
20192020,106,SHELBY,531,Shelby County,"",---District Total---,531,"","",OVEC,906,12,240,261,29,14,43,2,1,3,1,1,2,57,47,104,0,0,0,17,14,31,155,163,318,501
20192020,106,SHELBY,531,Shelby County,014,Painted Stone Elementary,531014,106531014,210532001964,OVEC,906,All Students,244,268,23,16,39,0,0,0,1,0,1,83,78,161,0,0,0,24,17,41,137,133,270,512
20192020,106,SHELBY,531,Shelby County,014,Painted Stone Elementary,531014,106531014,210532001964,OVEC,906,KG,34,46,1,2,3,0,0,0,0,0,0,13,11,24,0,0,0,6,3,9,26,18,44,80
20192020,106,SHELBY,531,Shelby County,014,Painted Stone Elementary,531014,106531014,210532001964,OVEC,906,01,46,47,5,3,8,0,0,0,1,0,1,10,15,25,0,0,0,4,5,9,27,23,50,93
20192020,106,SHELBY,531,Shelby County,014,Painted Stone Elementary,531014,106531014,210532001964,OVEC,906,02,32,47,4,1,5,0,0,0,0,0,0,13,8,21,0,0,0,7,1,8,23,22,45,79
20192020,106,SHELBY,531,Shelby County,014,Painted Stone Elementary,531014,106531014,210532001964,OVEC,906,03,41,44,3,2,5,0,0,0,0,0,0,15,15,30,0,0,0,3,0,3,23,24,47,85
20192020,106,SHELBY,531,Shelby County,014,Painted Stone Elementary,531014,106531014,210532001964,OVEC,906,04,41,39,6,4,10,0,0,0,0,0,0,15,13,28,0,0,0,3,4,7,15,20,35,80
20192020,106,SHELBY,531,Shelby County,014,Painted Stone Elementary,531014,106531014,210532001964,OVEC,906,05,50,45,4,4,8,0,0,0,0,0,0,17,16,33,0,0,0,1,4,5,23,26,49,95
20192020,106,SHELBY,531,Shelby County,015,Southside Elementary,531015,106531015,210532002077,OVEC,906,All Students,191,228,11,11,22,0,1,1,0,2,2,77,57,134,0,0,0,15,14,29,125,106,231,419
20192020,106,SHELBY,531,Shelby County,015,Southside Elementary,531015,106531015,210532002077,OVEC,906,KG,31,31,1,1,2,0,0,0,0,0,0,15,6,21,0,0,0,3,2,5,12,22,34,62
20192020,106,SHELBY,531,Shelby County,015,Southside Elementary,531015,106531015,210532002077,OVEC,906,01,35,45,1,2,3,0,0,0,0,0,0,15,5,20,0,0,0,3,4,7,26,24,50,80
20192020,106,SHELBY,531,Shelby County,015,Southside Elementary,531015,106531015,210532002077,OVEC,906,02,27,37,0,0,0,0,0,0,0,0,0,9,14,23,0,0,0,3,3,6,25,10,35,64
20192020,106,SHELBY,531,Shelby County,015,Southside Elementary,531015,106531015,210532002077,OVEC,906,03,36,42,1,2,3,0,1,1,0,0,0,12,12,24,0,0,0,1,1,2,28,20,48,78
20192020,106,SHELBY,531,Shelby County,015,Southside Elementary,531015,106531015,210532002077,OVEC,906,04,29,39,5,3,8,0,0,0,0,0,0,14,10,24,0,0,0,2,2,4,18,14,32,68
20192020,106,SHELBY,531,Shelby County,015,Southside Elementary,531015,106531015,210532002077,OVEC,906,05,33,34,3,3,6,0,0,0,0,2,2,12,10,22,0,0,0,3,2,5,16,16,32,67
20192020,106,SHELBY,531,Shelby County,040,Martha Layne Collins High School,531040,106531040,210532002253,OVEC,906,All Students,571,649,49,30,79,1,1,2,7,7,14,156,123,279,1,1,2,29,27,56,406,382,788,1220
20192020,106,SHELBY,531,Shelby County,040,Martha Layne Collins High School,531040,106531040,210532002253,OVEC,906,09,140,176,9,8,17,0,0,0,2,4,6,49,32,81,1,0,1,6,11,17,109,85,194,316
20192020,106,SHELBY,531,Shelby County,040,Martha Layne Collins High School,531040,106531040,210532002253,OVEC,906,10,158,160,10,9,19,1,1,2,2,1,3,43,40,83,0,1,1,6,4,10,98,102,200,318
20192020,106,SHELBY,531,Shelby County,040,Martha Layne Collins High School,531040,106531040,210532002253,OVEC,906,11,166,163,12,6,18,0,0,0,2,1,3,30,30,60,0,0,0,5,7,12,114,122,236,329
20192020,106,SHELBY,531,Shelby County,040,Martha Layne Collins High School,531040,106531040,210532002253,OVEC,906,12,107,148,18,7,25,0,0,0,1,1,2,34,21,55,0,0,0,11,5,16,84,73,157,255
20192020,106,SHELBY,531,Shelby County,040,Martha Layne Collins High School,531040,106531040,210532002253,OVEC,906,14,0,2,0,0,0,0,0,0,0,0,0,0,0,0,0,0,0,1,0,1,1,0,1,2
20192020,106,SHELBY,531,Shelby County,054,Marnel C. Moorman School,531054,106531054,210532002491,OVEC,906,All Students,313,364,21,12,33,0,0,0,4,3,7,112,102,214,0,0,0,19,9,28,208,187,395,677
20192020,106,SHELBY,531,Shelby County,054,Marnel C. Moorman School,531054,106531054,210532002491,OVEC,906,KG,25,31,3,0,3,0,0,0,0,0,0,14,9,23,0,0,0,0,1,1,14,15,29,56
20192020,106,SHELBY,531,Shelby County,054,Marnel C. Moorman School,531054,106531054,210532002491,OVEC,906,01,21,37,4,2,6,0,0,0,1,0,1,10,9,19,0,0,0,3,0,3,19,10,29,58
20192020,106,SHELBY,531,Shelby County,054,Marnel C. Moorman School,531054,106531054,210532002491,OVEC,906,02,28,20,0,1,1,0,0,0,0,0,0,7,13,20,0,0,0,2,2,4,11,12,23,48
20192020,106,SHELBY,531,Shelby County,054,Marnel C. Moorman School,531054,106531054,210532002491,OVEC,906,03,26,27,2,1,3,0,0,0,0,0,0,11,11,22,0,0,0,2,1,3,12,13,25,53
20192020,106,SHELBY,531,Shelby County,054,Marnel C. Moorman School,531054,106531054,210532002491,OVEC,906,04,10,31,1,0,1,0,0,0,0,0,0,9,4,13,0,0,0,2,0,2,19,6,25,41
20192020,106,SHELBY,531,Shelby County,054,Marnel C. Moorman School,531054,106531054,210532002491,OVEC,906,05,19,33,2,0,2,0,0,0,1,0,1,10,9,19,0,0,0,1,0,1,19,10,29,52
20192020,106,SHELBY,531,Shelby County,054,Marnel C. Moorman School,531054,106531054,210532002491,OVEC,906,06,70,66,4,2,6,0,0,0,0,2,2,14,18,32,0,0,0,6,1,7,42,47,89,136
20192020,106,SHELBY,531,Shelby County,054,Marnel C. Moorman School,531054,106531054,210532002491,OVEC,906,07,51,67,2,3,5,0,0,0,1,1,2,25,13,38,0,0,0,1,2,3,38,32,70,118
20192020,106,SHELBY,531,Shelby County,054,Marnel C. Moorman School,531054,106531054,210532002491,OVEC,906,08,63,52,3,3,6,0,0,0,1,0,1,12,16,28,0,0,0,2,2,4,34,42,76,115
20192020,106,SHELBY,531,Shelby County,065,Heritage Elementary,531065,106531065,210532001688,OVEC,906,All Students,205,243,8,1,9,0,0,0,1,0,1,11,14,25,0,0,0,7,13,20,216,177,393,448
20192020,106,SHELBY,531,Shelby County,065,Heritage Elementary,531065,106531065,210532001688,OVEC,906,KG,30,42,2,0,2,0,0,0,0,0,0,2,1,3,0,0,0,1,3,4,37,26,63,72
20192020,106,SHELBY,531,Shelby County,065,Heritage Elementary,531065,106531065,210532001688,OVEC,906,01,36,41,0,0,0,0,0,0,0,0,0,1,5,6,0,0,0,1,0,1,39,31,70,77
20192020,106,SHELBY,531,Shelby County,065,Heritage Elementary,531065,106531065,210532001688,OVEC,906,02,40,44,1,0,1,0,0,0,0,0,0,2,1,3,0,0,0,1,5,6,40,34,74,84
20192020,106,SHELBY,531,Shelby County,065,Heritage Elementary,531065,106531065,210532001688,OVEC,906,03,20,29,2,0,2,0,0,0,0,0,0,4,1,5,0,0,0,2,0,2,21,19,40,49
20192020,106,SHELBY,531,Shelby County,065,Heritage Elementary,531065,106531065,210532001688,OVEC,906,04,37,46,3,0,3,0,0,0,1,0,1,1,4,5,0,0,0,0,1,1,41,32,73,83
20192020,106,SHELBY,531,Shelby County,065,Heritage Elementary,531065,106531065,210532001688,OVEC,906,05,42,41,0,1,1,0,0,0,0,0,0,1,2,3,0,0,0,2,4,6,38,35,73,83
20192020,106,SHELBY,531,Shelby County,080,Shelby County West Middle School,531080,106531080,210532001291,OVEC,906,All Students,317,356,40,23,63,2,0,2,1,3,4,99,96,195,0,0,0,28,20,48,186,175,361,673
20192020,106,SHELBY,531,Shelby County,080,Shelby County West Middle School,531080,106531080,210532001291,OVEC,906,06,101,105,9,11,20,0,0,0,0,0,0,27,32,59,0,0,0,7,5,12,62,53,115,206
20192020,106,SHELBY,531,Shelby County,080,Shelby County West Middle School,531080,106531080,210532001291,OVEC,906,07,118,123,15,8,23,1,0,1,0,0,0,32,33,65,0,0,0,15,8,23,60,69,129,241
20192020,106,SHELBY,531,Shelby County,080,Shelby County West Middle School,531080,106531080,210532001291,OVEC,906,08,98,128,16,4,20,1,0,1,1,3,4,40,31,71,0,0,0,6,7,13,64,53,117,226
20192020,106,SHELBY,531,Shelby County,090,Shelby County High School,531090,106531090,210532001292,OVEC,906,14,1,3,0,0,0,0,0,0,0,0,0,1,0,1,0,0,0,0,0,0,2,1,3,4
20192020,106,SHELBY,531,Shelby County,090,Shelby County High School,531090,106531090,210532001292,OVEC,906,All Students,467,483,30,42,72,2,2,4,3,4,7,99,84,183,0,0,0,17,22,39,332,313,645,950
20192020,106,SHELBY,531,Shelby County,090,Shelby County High School,531090,106531090,210532001292,OVEC,906,09,136,127,7,18,25,0,0,0,0,1,1,29,29,58,0,0,0,7,8,15,84,80,164,263
20192020,106,SHELBY,531,Shelby County,090,Shelby County High School,531090,106531090,210532001292,OVEC,906,10,114,108,6,11,17,0,0,0,0,2,2,27,18,45,0,0,0,4,5,9,71,78,149,222
20192020,106,SHELBY,531,Shelby County,090,Shelby County High School,531090,106531090,210532001292,OVEC,906,11,84,134,6,6,12,0,1,1,3,1,4,19,11,30,0,0,0,1,0,1,105,65,170,218
20192020,106,SHELBY,531,Shelby County,090,Shelby County High School,531090,106531090,210532001292,OVEC,906,12,132,111,11,7,18,2,1,3,0,0,0,23,26,49,0,0,0,5,9,14,70,89,159,243
20192020,106,SHELBY,531,Shelby County,100,Simpsonville Elementary,531100,106531100,210532001293,OVEC,906,All Students,229,269,20,12,32,0,0,0,1,1,2,33,25,58,0,0,0,10,10,20,205,181,386,498
20192020,106,SHELBY,531,Shelby County,100,Simpsonville Elementary,531100,106531100,210532001293,OVEC,906,KG,39,45,2,2,4,0,0,0,0,0,0,3,5,8,0,0,0,2,2,4,38,30,68,84
20192020,106,SHELBY,531,Shelby County,100,Simpsonville Elementary,531100,106531100,210532001293,OVEC,906,01,36,36,3,1,4,0,0,0,0,0,0,6,8,14,0,0,0,0,3,3,27,24,51,72
20192020,106,SHELBY,531,Shelby County,100,Simpsonville Elementary,531100,106531100,210532001293,OVEC,906,02,29,48,3,1,4,0,0,0,0,1,1,8,1,9,0,0,0,0,1,1,37,25,62,77
20192020,106,SHELBY,531,Shelby County,100,Simpsonville Elementary,531100,106531100,210532001293,OVEC,906,03,39,45,6,2,8,0,0,0,0,0,0,5,3,8,0,0,0,1,2,3,33,32,65,84
20192020,106,SHELBY,531,Shelby County,100,Simpsonville Elementary,531100,106531100,210532001293,OVEC,906,04,43,47,1,3,4,0,0,0,1,0,1,4,5,9,0,0,0,3,0,3,38,35,73,90
20192020,106,SHELBY,531,Shelby County,100,Simpsonville Elementary,531100,106531100,210532001293,OVEC,906,05,43,48,5,3,8,0,0,0,0,0,0,7,3,10,0,0,0,4,2,6,32,35,67,91
20192020,106,SHELBY,531,Shelby County,110,Shelby County East Middle School,531110,106531110,210532001294,OVEC,906,All Students,279,313,12,11,23,2,1,3,1,2,3,50,45,95,1,0,1,18,9,27,229,211,440,592
20192020,106,SHELBY,531,Shelby County,110,Shelby County East Middle School,531110,106531110,210532001294,OVEC,906,06,81,98,1,4,5,0,1,1,0,0,0,18,19,37,0,0,0,7,4,11,72,53,125,179
20192020,106,SHELBY,531,Shelby County,110,Shelby County East Middle School,531110,106531110,210532001294,OVEC,906,07,114,101,8,5,13,1,0,1,0,0,0,15,18,33,1,0,1,3,2,5,73,89,162,215
20192020,106,SHELBY,531,Shelby County,110,Shelby County East Middle School,531110,106531110,210532001294,OVEC,906,08,84,114,3,2,5,1,0,1,1,2,3,17,8,25,0,0,0,8,3,11,84,69,153,198
20192020,106,SHELBY,531,Shelby County,120,Clear Creek Elementary,531120,106531120,210532001295,OVEC,906,All Students,229,251,22,20,42,0,0,0,3,2,5,53,40,93,0,0,0,19,14,33,154,153,307,480
20192020,106,SHELBY,531,Shelby County,120,Clear Creek Elementary,531120,106531120,210532001295,OVEC,906,KG,42,39,1,3,4,0,0,0,0,0,0,7,6,13,0,0,0,8,3,11,23,30,53,81
20192020,106,SHELBY,531,Shelby County,120,Clear Creek Elementary,531120,106531120,210532001295,OVEC,906,01,37,39,5,3,8,0,0,0,1,0,1,8,11,19,0,0,0,2,2,4,23,21,44,76
20192020,106,SHELBY,531,Shelby County,120,Clear Creek Elementary,531120,106531120,210532001295,OVEC,906,02,41,46,4,5,9,0,0,0,0,1,1,7,6,13,0,0,0,5,4,9,30,25,55,87
20192020,106,SHELBY,531,Shelby County,120,Clear Creek Elementary,531120,106531120,210532001295,OVEC,906,03,35,39,6,2,8,0,0,0,0,0,0,9,6,15,0,0,0,1,4,5,23,23,46,74
20192020,106,SHELBY,531,Shelby County,120,Clear Creek Elementary,531120,106531120,210532001295,OVEC,906,04,41,54,6,4,10,0,0,0,0,1,1,15,5,20,0,0,0,2,0,2,31,31,62,95
20192020,106,SHELBY,531,Shelby County,120,Clear Creek Elementary,531120,106531120,210532001295,OVEC,906,05,33,34,0,3,3,0,0,0,2,0,2,7,6,13,0,0,0,1,1,2,24,23,47,67
20192020,106,SHELBY,531,Shelby County,130,Wright Elementary,531130,106531130,210532001434,OVEC,906,All Students,230,214,6,11,17,0,0,0,1,1,2,48,54,102,0,0,0,16,8,24,143,156,299,444
20192020,106,SHELBY,531,Shelby County,130,Wright Elementary,531130,106531130,210532001434,OVEC,906,KG,45,39,1,3,4,0,0,0,0,0,0,9,9,18,0,0,0,3,3,6,26,30,56,84
20192020,106,SHELBY,531,Shelby County,130,Wright Elementary,531130,106531130,210532001434,OVEC,906,01,34,38,1,1,2,0,0,0,0,0,0,11,12,23,0,0,0,1,0,1,25,21,46,72
20192020,106,SHELBY,531,Shelby County,130,Wright Elementary,531130,106531130,210532001434,OVEC,906,02,35,34,0,1,1,0,0,0,0,0,0,6,4,10,0,0,0,3,2,5,25,28,53,69
20192020,106,SHELBY,531,Shelby County,130,Wright Elementary,531130,106531130,210532001434,OVEC,906,03,28,30,0,1,1,0,0,0,0,0,0,9,5,14,0,0,0,2,0,2,19,22,41,58
20192020,106,SHELBY,531,Shelby County,130,Wright Elementary,531130,106531130,210532001434,OVEC,906,04,39,40,2,3,5,0,0,0,1,1,2,8,12,20,0,0,0,6,1,7,23,22,45,79
20192020,106,SHELBY,531,Shelby County,130,Wright Elementary,531130,106531130,210532001434,OVEC,906,05,49,33,2,2,4,0,0,0,0,0,0,5,12,17,0,0,0,1,2,3,25,33,58,82
20192020,106,SHELBY,531,Shelby County,160,Northside Early Childhood Center,531160,106531160,210532001689,OVEC,906,All Students,0,0,0,0,0,0,0,0,0,0,0,0,0,0,0,0,0,0,0,0,0,0,0,0
20192020,106,SHELBY,531,Shelby County,160,Northside Early Childhood Center,531160,106531160,210532001689,OVEC,906,PS,132,133,15,12,27,0,0,0,0,0,0,36,42,78,0,0,0,6,9,15,76,69,145,265
20192020,106,SHELBY,531,Shelby County,170,Ascension Academy,531170,106531170,210532001690,OVEC,906,All Students,10,7,2,3,5,0,0,0,0,0,0,1,1,2,0,0,0,1,0,1,3,6,9,17
20192020,106,SHELBY,531,Shelby County,170,Ascension Academy,531170,106531170,210532001690,OVEC,906,09,4,2,0,2,2,0,0,0,0,0,0,1,0,1,0,0,0,0,0,0,1,2,3,6
20192020,106,SHELBY,531,Shelby County,170,Ascension Academy,531170,106531170,210532001690,OVEC,906,10,3,2,1,1,2,0,0,0,0,0,0,0,1,1,0,0,0,0,0,0,1,1,2,5
20192020,106,SHELBY,531,Shelby County,170,Ascension Academy,531170,106531170,210532001690,OVEC,906,11,2,1,1,0,1,0,0,0,0,0,0,0,0,0,0,0,0,0,0,0,0,2,2,3
20192020,106,SHELBY,531,Shelby County,170,Ascension Academy,531170,106531170,210532001690,OVEC,906,12,1,2,0,0,0,0,0,0,0,0,0,0,0,0,0,0,0,1,0,1,1,1,2,3
20192020,107,SIMPSON,535,Simpson County,"",---District Total---,535,"","",GRREC,902,All Students,1443,1533,153,128,281,4,6,10,11,11,22,84,84,168,0,2,2,81,94,175,1200,1118,2318,2976
20192020,107,SIMPSON,535,Simpson County,"",---District Total---,535,"","",GRREC,902,PS,52,63,10,7,17,0,0,0,0,1,1,0,2,2,0,0,0,4,4,8,49,38,87,115
20192020,107,SIMPSON,535,Simpson County,"",---District Total---,535,"","",GRREC,902,KG,113,136,6,8,14,0,2,2,0,0,0,5,5,10,0,0,0,8,10,18,117,88,205,249
20192020,107,SIMPSON,535,Simpson County,"",---District Total---,535,"","",GRREC,902,01,131,124,6,8,14,0,1,1,0,0,0,6,11,17,0,0,0,6,13,19,106,98,204,255
20192020,107,SIMPSON,535,Simpson County,"",---District Total---,535,"","",GRREC,902,02,107,119,16,4,20,0,1,1,1,0,1,7,5,12,0,0,0,6,12,18,89,85,174,226
20192020,107,SIMPSON,535,Simpson County,"",---District Total---,535,"","",GRREC,902,03,99,119,17,7,24,0,0,0,3,1,4,7,7,14,0,0,0,10,9,19,82,75,157,218
20192020,107,SIMPSON,535,Simpson County,"",---District Total---,535,"","",GRREC,902,04,94,123,10,5,15,1,0,1,2,0,2,5,2,7,0,0,0,9,7,16,96,80,176,217
20192020,107,SIMPSON,535,Simpson County,"",---District Total---,535,"","",GRREC,902,05,117,123,18,15,33,0,0,0,0,1,1,6,2,8,0,0,0,6,6,12,93,93,186,240
20192020,107,SIMPSON,535,Simpson County,"",---District Total---,535,"","",GRREC,902,06,126,131,12,8,20,0,0,0,0,4,4,5,9,14,0,0,0,6,10,16,108,95,203,257
20192020,107,SIMPSON,535,Simpson County,"",---District Total---,535,"","",GRREC,902,07,107,127,13,19,32,0,0,0,2,0,2,10,9,19,0,0,0,5,4,9,97,75,172,234
20192020,107,SIMPSON,535,Simpson County,"",---District Total---,535,"","",GRREC,902,08,105,124,14,14,28,1,0,1,1,1,2,7,7,14,0,0,0,9,3,12,92,80,172,229
20192020,107,SIMPSON,535,Simpson County,"",---District Total---,535,"","",GRREC,902,09,99,109,8,6,14,0,0,0,2,1,3,10,7,17,0,0,0,10,7,17,79,78,157,208
20192020,107,SIMPSON,535,Simpson County,"",---District Total---,535,"","",GRREC,902,10,129,86,12,13,25,0,1,1,0,1,1,5,8,13,0,1,1,3,6,9,66,99,165,215
20192020,107,SIMPSON,535,Simpson County,"",---District Total---,535,"","",GRREC,902,11,107,107,12,11,23,2,1,3,0,0,0,4,4,8,0,1,1,0,4,4,89,86,175,214
20192020,107,SIMPSON,535,Simpson County,"",---District Total---,535,"","",GRREC,902,12,108,105,9,10,19,0,0,0,0,2,2,7,8,15,0,0,0,3,3,6,86,85,171,213
20192020,107,SIMPSON,535,Simpson County,"",---District Total---,535,"","",GRREC,902,14,1,0,0,0,0,0,0,0,0,0,0,0,0,0,0,0,0,0,0,0,0,1,1,1
20192020,107,SIMPSON,535,Simpson County,007,Franklin-Simpson High School West Campus,535007,107535007,210540001652,GRREC,902,All Students,43,40,3,4,7,0,0,0,0,0,0,1,2,3,0,1,1,3,3,6,33,33,66,83
20192020,107,SIMPSON,535,Simpson County,007,Franklin-Simpson High School West Campus,535007,107535007,210540001652,GRREC,902,06,1,0,0,0,0,0,0,0,0,0,0,0,0,0,0,0,0,0,0,0,0,1,1,1
20192020,107,SIMPSON,535,Simpson County,007,Franklin-Simpson High School West Campus,535007,107535007,210540001652,GRREC,902,07,0,1,1,0,1,0,0,0,0,0,0,0,0,0,0,0,0,0,0,0,0,0,0,1
20192020,107,SIMPSON,535,Simpson County,007,Franklin-Simpson High School West Campus,535007,107535007,210540001652,GRREC,902,08,1,1,0,0,0,0,0,0,0,0,0,0,1,1,0,0,0,0,0,0,1,0,1,2
20192020,107,SIMPSON,535,Simpson County,007,Franklin-Simpson High School West Campus,535007,107535007,210540001652,GRREC,902,09,3,7,1,0,1,0,0,0,0,0,0,0,0,0,0,0,0,2,0,2,4,3,7,10
20192020,107,SIMPSON,535,Simpson County,007,Franklin-Simpson High School West Campus,535007,107535007,210540001652,GRREC,902,10,6,5,0,0,0,0,0,0,0,0,0,1,0,1,0,0,0,0,0,0,4,6,10,11
20192020,107,SIMPSON,535,Simpson County,007,Franklin-Simpson High School West Campus,535007,107535007,210540001652,GRREC,902,11,14,12,0,1,1,0,0,0,0,0,0,0,0,0,0,1,1,0,2,2,12,10,22,26
20192020,107,SIMPSON,535,Simpson County,007,Franklin-Simpson High School West Campus,535007,107535007,210540001652,GRREC,902,12,18,14,1,3,4,0,0,0,0,0,0,0,1,1,0,0,0,1,1,2,12,13,25,32
20192020,107,SIMPSON,535,Simpson County,020,Franklin Elementary School,535020,107535020,210540001299,GRREC,902,All Students,113,136,6,8,14,0,2,2,0,0,0,5,5,10,0,0,0,8,10,18,117,88,205,249
20192020,107,SIMPSON,535,Simpson County,020,Franklin Elementary School,535020,107535020,210540001299,GRREC,902,PS,52,63,10,7,17,0,0,0,0,1,1,0,2,2,0,0,0,4,4,8,49,38,87,115
20192020,107,SIMPSON,535,Simpson County,020,Franklin Elementary School,535020,107535020,210540001299,GRREC,902,KG,113,136,6,8,14,0,2,2,0,0,0,5,5,10,0,0,0,8,10,18,117,88,205,249
20192020,107,SIMPSON,535,Simpson County,030,Franklin-Simpson Middle School,535030,107535030,210540001300,GRREC,902,All Students,336,380,38,41,79,1,0,1,3,5,8,22,24,46,0,0,0,20,17,37,296,249,545,716
20192020,107,SIMPSON,535,Simpson County,030,Franklin-Simpson Middle School,535030,107535030,210540001300,GRREC,902,06,125,131,12,8,20,0,0,0,0,4,4,5,9,14,0,0,0,6,10,16,108,94,202,256
20192020,107,SIMPSON,535,Simpson County,030,Franklin-Simpson Middle School,535030,107535030,210540001300,GRREC,902,07,107,126,12,19,31,0,0,0,2,0,2,10,9,19,0,0,0,5,4,9,97,75,172,233
20192020,107,SIMPSON,535,Simpson County,030,Franklin-Simpson Middle School,535030,107535030,210540001300,GRREC,902,08,104,123,14,14,28,1,0,1,1,1,2,7,6,13,0,0,0,9,3,12,91,80,171,227
20192020,107,SIMPSON,535,Simpson County,040,Franklin-Simpson High School,535040,107535040,210540001301,GRREC,902,All Students,403,369,39,36,75,2,2,4,2,4,6,25,26,51,0,1,1,13,17,30,288,317,605,772
20192020,107,SIMPSON,535,Simpson County,040,Franklin-Simpson High School,535040,107535040,210540001301,GRREC,902,09,96,102,7,6,13,0,0,0,2,1,3,10,7,17,0,0,0,8,7,15,75,75,150,198
20192020,107,SIMPSON,535,Simpson County,040,Franklin-Simpson High School,535040,107535040,210540001301,GRREC,902,10,123,81,12,13,25,0,1,1,0,1,1,4,8,12,0,1,1,3,6,9,62,93,155,204
20192020,107,SIMPSON,535,Simpson County,040,Franklin-Simpson High School,535040,107535040,210540001301,GRREC,902,11,93,95,12,10,22,2,1,3,0,0,0,4,4,8,0,0,0,0,2,2,77,76,153,188
20192020,107,SIMPSON,535,Simpson County,040,Franklin-Simpson High School,535040,107535040,210540001301,GRREC,902,12,90,91,8,7,15,0,0,0,0,2,2,7,7,14,0,0,0,2,2,4,74,72,146,181
20192020,107,SIMPSON,535,Simpson County,040,Franklin-Simpson High School,535040,107535040,210540001301,GRREC,902,14,1,0,0,0,0,0,0,0,0,0,0,0,0,0,0,0,0,0,0,0,0,1,1,1
20192020,107,SIMPSON,535,Simpson County,045,Lincoln Elementary School,535045,107535045,210540001302,GRREC,902,All Students,211,246,28,20,48,1,0,1,2,1,3,11,4,15,0,0,0,15,13,28,189,173,362,457
20192020,107,SIMPSON,535,Simpson County,045,Lincoln Elementary School,535045,107535045,210540001302,GRREC,902,04,94,123,10,5,15,1,0,1,2,0,2,5,2,7,0,0,0,9,7,16,96,80,176,217
20192020,107,SIMPSON,535,Simpson County,045,Lincoln Elementary School,535045,107535045,210540001302,GRREC,902,05,117,123,18,15,33,0,0,0,0,1,1,6,2,8,0,0,0,6,6,12,93,93,186,240
20192020,107,SIMPSON,535,Simpson County,100,Simpson Elementary School,535100,107535100,210540001435,GRREC,902,All Students,337,362,39,19,58,0,2,2,4,1,5,20,23,43,0,0,0,22,34,56,277,258,535,699
20192020,107,SIMPSON,535,Simpson County,100,Simpson Elementary School,535100,107535100,210540001435,GRREC,902,01,131,124,6,8,14,0,1,1,0,0,0,6,11,17,0,0,0,6,13,19,106,98,204,255
20192020,107,SIMPSON,535,Simpson County,100,Simpson Elementary School,535100,107535100,210540001435,GRREC,902,02,107,119,16,4,20,0,1,1,1,0,1,7,5,12,0,0,0,6,12,18,89,85,174,226
20192020,107,SIMPSON,535,Simpson County,100,Simpson Elementary School,535100,107535100,210540001435,GRREC,902,03,99,119,17,7,24,0,0,0,3,1,4,7,7,14,0,0,0,10,9,19,82,75,157,218
20192020,100,PULASKI,536,Somerset Independent,"",---District Total---,536,"","",SESC,907,All Students,739,852,29,30,59,0,0,0,21,12,33,80,64,144,1,0,1,41,28,69,680,605,1285,1591
20192020,100,PULASKI,536,Somerset Independent,"",---District Total---,536,"","",SESC,907,KG,55,55,2,1,3,0,0,0,1,1,2,2,3,5,0,0,0,7,4,11,43,46,89,110
20192020,100,PULASKI,536,Somerset Independent,"",---District Total---,536,"","",SESC,907,01,46,67,2,5,7,0,0,0,1,0,1,2,2,4,0,0,0,1,2,3,61,37,98,113
20192020,100,PULASKI,536,Somerset Independent,"",---District Total---,536,"","",SESC,907,02,52,75,3,1,4,0,0,0,3,0,3,11,4,15,0,0,0,4,4,8,54,43,97,127
20192020,100,PULASKI,536,Somerset Independent,"",---District Total---,536,"","",SESC,907,03,56,62,4,2,6,0,0,0,1,0,1,8,3,11,0,0,0,5,4,9,44,47,91,118
20192020,100,PULASKI,536,Somerset Independent,"",---District Total---,536,"","",SESC,907,04,44,54,2,1,3,0,0,0,1,1,2,4,3,7,0,0,0,1,2,3,46,37,83,98
20192020,100,PULASKI,536,Somerset Independent,"",---District Total---,536,"","",SESC,907,05,59,55,1,1,2,0,0,0,0,1,1,5,7,12,0,0,0,6,1,7,43,49,92,114
20192020,100,PULASKI,536,Somerset Independent,"",---District Total---,536,"","",SESC,907,06,67,62,2,3,5,0,0,0,1,2,3,8,10,18,0,0,0,3,2,5,48,50,98,129
20192020,100,PULASKI,536,Somerset Independent,"",---District Total---,536,"","",SESC,907,07,61,68,2,3,5,0,0,0,2,0,2,10,4,14,0,0,0,2,3,5,52,51,103,129
20192020,100,PULASKI,536,Somerset Independent,"",---District Total---,536,"","",SESC,907,14,1,2,0,0,0,0,0,0,0,0,0,0,0,0,0,0,0,0,0,0,2,1,3,3
20192020,100,PULASKI,536,Somerset Independent,"",---District Total---,536,"","",SESC,907,08,56,53,2,0,2,0,0,0,0,3,3,5,7,12,0,0,0,3,1,4,43,45,88,109
20192020,100,PULASKI,536,Somerset Independent,"",---District Total---,536,"","",SESC,907,09,60,77,1,4,5,0,0,0,3,1,4,9,7,16,0,0,0,3,1,4,61,47,108,137
20192020,100,PULASKI,536,Somerset Independent,"",---District Total---,536,"","",SESC,907,10,65,69,1,2,3,0,0,0,2,0,2,5,4,9,0,0,0,0,1,1,61,58,119,134
20192020,100,PULASKI,536,Somerset Independent,"",---District Total---,536,"","",SESC,907,11,59,82,2,3,5,0,0,0,2,1,3,3,5,8,0,0,0,3,3,6,72,47,119,141
20192020,100,PULASKI,536,Somerset Independent,"",---District Total---,536,"","",SESC,907,12,58,71,5,4,9,0,0,0,4,2,6,8,5,13,1,0,1,3,0,3,50,47,97,129
20192020,100,PULASKI,536,Somerset Independent,050,Hopkins Elementary School,536050,100536050,210543001307,SESC,907,All Students,253,313,13,10,23,0,0,0,7,2,9,27,15,42,0,0,0,18,16,34,248,210,458,566
20192020,100,PULASKI,536,Somerset Independent,050,Hopkins Elementary School,536050,100536050,210543001307,SESC,907,KG,55,55,2,1,3,0,0,0,1,1,2,2,3,5,0,0,0,7,4,11,43,46,89,110
20192020,100,PULASKI,536,Somerset Independent,050,Hopkins Elementary School,536050,100536050,210543001307,SESC,907,01,46,67,2,5,7,0,0,0,1,0,1,2,2,4,0,0,0,1,2,3,61,37,98,113
20192020,100,PULASKI,536,Somerset Independent,050,Hopkins Elementary School,536050,100536050,210543001307,SESC,907,02,52,75,3,1,4,0,0,0,3,0,3,11,4,15,0,0,0,4,4,8,54,43,97,127
20192020,100,PULASKI,536,Somerset Independent,050,Hopkins Elementary School,536050,100536050,210543001307,SESC,907,03,56,62,4,2,6,0,0,0,1,0,1,8,3,11,0,0,0,5,4,9,44,47,91,118
20192020,100,PULASKI,536,Somerset Independent,050,Hopkins Elementary School,536050,100536050,210543001307,SESC,907,04,44,54,2,1,3,0,0,0,1,1,2,4,3,7,0,0,0,1,2,3,46,37,83,98
20192020,100,PULASKI,536,Somerset Independent,070,Somerset High School,536070,100536070,210543001310,SESC,907,All Students,243,301,9,13,22,0,0,0,11,4,15,25,21,46,1,0,1,9,5,14,246,200,446,544
20192020,100,PULASKI,536,Somerset Independent,070,Somerset High School,536070,100536070,210543001310,SESC,907,09,60,77,1,4,5,0,0,0,3,1,4,9,7,16,0,0,0,3,1,4,61,47,108,137
20192020,100,PULASKI,536,Somerset Independent,070,Somerset High School,536070,100536070,210543001310,SESC,907,10,65,69,1,2,3,0,0,0,2,0,2,5,4,9,0,0,0,0,1,1,61,58,119,134
20192020,100,PULASKI,536,Somerset Independent,070,Somerset High School,536070,100536070,210543001310,SESC,907,11,59,82,2,3,5,0,0,0,2,1,3,3,5,8,0,0,0,3,3,6,72,47,119,141
20192020,100,PULASKI,536,Somerset Independent,070,Somerset High School,536070,100536070,210543001310,SESC,907,12,58,71,5,4,9,0,0,0,4,2,6,8,5,13,1,0,1,3,0,3,50,47,97,129
20192020,100,PULASKI,536,Somerset Independent,070,Somerset High School,536070,100536070,210543001310,SESC,907,14,1,2,0,0,0,0,0,0,0,0,0,0,0,0,0,0,0,0,0,0,2,1,3,3
20192020,100,PULASKI,536,Somerset Independent,090,Meece Middle School,536090,100536090,210543001311,SESC,907,All Students,243,238,7,7,14,0,0,0,3,6,9,28,28,56,0,0,0,14,7,21,186,195,381,481
20192020,100,PULASKI,536,Somerset Independent,090,Meece Middle School,536090,100536090,210543001311,SESC,907,05,59,55,1,1,2,0,0,0,0,1,1,5,7,12,0,0,0,6,1,7,43,49,92,114
20192020,100,PULASKI,536,Somerset Independent,090,Meece Middle School,536090,100536090,210543001311,SESC,907,06,67,62,2,3,5,0,0,0,1,2,3,8,10,18,0,0,0,3,2,5,48,50,98,129
20192020,100,PULASKI,536,Somerset Independent,090,Meece Middle School,536090,100536090,210543001311,SESC,907,07,61,68,2,3,5,0,0,0,2,0,2,10,4,14,0,0,0,2,3,5,52,51,103,129
20192020,100,PULASKI,536,Somerset Independent,090,Meece Middle School,536090,100536090,210543001311,SESC,907,08,56,53,2,0,2,0,0,0,0,3,3,5,7,12,0,0,0,3,1,4,43,45,88,109
20192020,019,CAMPBELL,537,Southgate Independent,"",---District Total---,537,"","",NKCES,905,All Students,93,87,16,24,40,0,0,0,0,1,1,6,3,9,0,0,0,6,8,14,59,57,116,180
20192020,019,CAMPBELL,537,Southgate Independent,"",---District Total---,537,"","",NKCES,905,PS,10,13,2,1,3,0,0,0,0,0,0,1,0,1,0,0,0,1,0,1,9,9,18,23
20192020,019,CAMPBELL,537,Southgate Independent,"",---District Total---,537,"","",NKCES,905,KG,12,12,1,1,2,0,0,0,0,0,0,1,1,2,0,0,0,0,1,1,10,9,19,24
20192020,019,CAMPBELL,537,Southgate Independent,"",---District Total---,537,"","",NKCES,905,01,12,9,2,5,7,0,0,0,0,0,0,0,0,0,0,0,0,0,2,2,7,5,12,21
20192020,019,CAMPBELL,537,Southgate Independent,"",---District Total---,537,"","",NKCES,905,02,6,14,3,0,3,0,0,0,0,0,0,0,0,0,0,0,0,0,1,1,11,5,16,20
20192020,019,CAMPBELL,537,Southgate Independent,"",---District Total---,537,"","",NKCES,905,03,9,8,2,2,4,0,0,0,0,0,0,1,0,1,0,0,0,1,0,1,4,7,11,17
20192020,019,CAMPBELL,537,Southgate Independent,"",---District Total---,537,"","",NKCES,905,04,12,3,1,2,3,0,0,0,0,1,1,1,0,1,0,0,0,1,1,2,0,8,8,15
20192020,019,CAMPBELL,537,Southgate Independent,"",---District Total---,537,"","",NKCES,905,05,16,12,3,6,9,0,0,0,0,0,0,2,1,3,0,0,0,1,0,1,6,9,15,28
20192020,019,CAMPBELL,537,Southgate Independent,"",---District Total---,537,"","",NKCES,905,06,10,7,0,2,2,0,0,0,0,0,0,0,0,0,0,0,0,2,0,2,5,8,13,17
20192020,019,CAMPBELL,537,Southgate Independent,"",---District Total---,537,"","",NKCES,905,07,8,11,2,3,5,0,0,0,0,0,0,0,1,1,0,0,0,1,2,3,8,2,10,19
20192020,019,CAMPBELL,537,Southgate Independent,"",---District Total---,537,"","",NKCES,905,08,8,11,2,3,5,0,0,0,0,0,0,1,0,1,0,0,0,0,1,1,8,4,12,19
20192020,019,CAMPBELL,537,Southgate Independent,010,Southgate Public School,537010,019537010,210546001313,NKCES,905,All Students,93,87,16,24,40,0,0,0,0,1,1,6,3,9,0,0,0,6,8,14,59,57,116,180
20192020,019,CAMPBELL,537,Southgate Independent,010,Southgate Public School,537010,019537010,210546001313,NKCES,905,PS,10,13,2,1,3,0,0,0,0,0,0,1,0,1,0,0,0,1,0,1,9,9,18,23
20192020,019,CAMPBELL,537,Southgate Independent,010,Southgate Public School,537010,019537010,210546001313,NKCES,905,KG,12,12,1,1,2,0,0,0,0,0,0,1,1,2,0,0,0,0,1,1,10,9,19,24
20192020,019,CAMPBELL,537,Southgate Independent,010,Southgate Public School,537010,019537010,210546001313,NKCES,905,01,12,9,2,5,7,0,0,0,0,0,0,0,0,0,0,0,0,0,2,2,7,5,12,21
20192020,019,CAMPBELL,537,Southgate Independent,010,Southgate Public School,537010,019537010,210546001313,NKCES,905,02,6,14,3,0,3,0,0,0,0,0,0,0,0,0,0,0,0,0,1,1,11,5,16,20
20192020,019,CAMPBELL,537,Southgate Independent,010,Southgate Public School,537010,019537010,210546001313,NKCES,905,03,9,8,2,2,4,0,0,0,0,0,0,1,0,1,0,0,0,1,0,1,4,7,11,17
20192020,019,CAMPBELL,537,Southgate Independent,010,Southgate Public School,537010,019537010,210546001313,NKCES,905,04,12,3,1,2,3,0,0,0,0,1,1,1,0,1,0,0,0,1,1,2,0,8,8,15
20192020,019,CAMPBELL,537,Southgate Independent,010,Southgate Public School,537010,019537010,210546001313,NKCES,905,05,16,12,3,6,9,0,0,0,0,0,0,2,1,3,0,0,0,1,0,1,6,9,15,28
20192020,019,CAMPBELL,537,Southgate Independent,010,Southgate Public School,537010,019537010,210546001313,NKCES,905,06,10,7,0,2,2,0,0,0,0,0,0,0,0,0,0,0,0,2,0,2,5,8,13,17
20192020,019,CAMPBELL,537,Southgate Independent,010,Southgate Public School,537010,019537010,210546001313,NKCES,905,07,8,11,2,3,5,0,0,0,0,0,0,0,1,1,0,0,0,1,2,3,8,2,10,19
20192020,019,CAMPBELL,537,Southgate Independent,010,Southgate Public School,537010,019537010,210546001313,NKCES,905,08,8,11,2,3,5,0,0,0,0,0,0,1,0,1,0,0,0,0,1,1,8,4,12,19
20192020,108,SPENCER,541,Spencer County,"",---District Total---,541,"","",OVEC,906,All Students,1406,1582,14,10,24,3,1,4,3,9,12,59,61,120,0,1,1,58,47,105,1445,1277,2722,2988
20192020,108,SPENCER,541,Spencer County,"",---District Total---,541,"","",OVEC,906,PS,67,70,1,1,2,0,0,0,1,1,2,0,4,4,0,0,0,0,4,4,68,57,125,137
20192020,108,SPENCER,541,Spencer County,"",---District Total---,541,"","",OVEC,906,KG,113,129,0,0,0,0,0,0,0,0,0,1,2,3,0,0,0,4,4,8,124,107,231,242
20192020,108,SPENCER,541,Spencer County,"",---District Total---,541,"","",OVEC,906,01,102,111,2,0,2,0,0,0,1,1,2,3,4,7,0,0,0,3,1,4,102,96,198,213
20192020,108,SPENCER,541,Spencer County,"",---District Total---,541,"","",OVEC,906,02,97,92,0,0,0,1,0,1,0,1,1,2,5,7,0,0,0,0,4,4,89,87,176,189
20192020,108,SPENCER,541,Spencer County,"",---District Total---,541,"","",OVEC,906,03,103,119,1,1,2,0,0,0,1,0,1,5,3,8,0,0,0,9,2,11,103,97,200,222
20192020,108,SPENCER,541,Spencer County,"",---District Total---,541,"","",OVEC,906,04,116,102,1,0,1,0,0,0,1,0,1,4,3,7,0,0,0,8,4,12,88,109,197,218
20192020,108,SPENCER,541,Spencer County,"",---District Total---,541,"","",OVEC,906,05,99,122,2,1,3,0,0,0,0,0,0,5,4,9,0,0,0,0,2,2,115,92,207,221
20192020,108,SPENCER,541,Spencer County,"",---District Total---,541,"","",OVEC,906,06,99,131,1,3,4,0,0,0,0,1,1,7,6,13,0,0,0,7,5,12,116,84,200,230
20192020,108,SPENCER,541,Spencer County,"",---District Total---,541,"","",OVEC,906,07,132,130,3,1,4,0,0,0,0,0,0,5,6,11,0,0,0,5,9,14,117,116,233,262
20192020,108,SPENCER,541,Spencer County,"",---District Total---,541,"","",OVEC,906,08,114,133,1,0,1,1,0,1,0,2,2,6,8,14,0,0,0,1,3,4,124,101,225,247
20192020,108,SPENCER,541,Spencer County,"",---District Total---,541,"","",OVEC,906,09,109,144,0,0,0,0,0,0,0,2,2,8,4,12,0,0,0,5,4,9,131,99,230,253
20192020,108,SPENCER,541,Spencer County,"",---District Total---,541,"","",OVEC,906,10,101,125,1,2,3,0,0,0,0,1,1,4,2,6,0,0,0,7,3,10,113,93,206,226
20192020,108,SPENCER,541,Spencer County,"",---District Total---,541,"","",OVEC,906,11,107,130,0,1,1,0,1,1,0,0,0,4,5,9,0,1,1,7,4,11,119,95,214,237
20192020,108,SPENCER,541,Spencer County,"",---District Total---,541,"","",OVEC,906,12,113,113,2,1,3,1,0,1,0,1,1,5,9,14,0,0,0,2,2,4,103,100,203,226
20192020,108,SPENCER,541,Spencer County,"",---District Total---,541,"","",OVEC,906,14,1,1,0,0,0,0,0,0,0,0,0,0,0,0,0,0,0,0,0,0,1,1,2,2
20192020,108,SPENCER,541,Spencer County,040,Spencer County Elementary School,541040,108541040,210549001314,OVEC,906,All Students,343,365,5,2,7,1,0,1,3,2,5,11,8,19,0,0,0,12,5,17,333,326,659,708
20192020,108,SPENCER,541,Spencer County,040,Spencer County Elementary School,541040,108541040,210549001314,OVEC,906,PS,39,37,1,0,1,0,0,0,1,1,2,0,1,1,0,0,0,0,3,3,35,34,69,76
20192020,108,SPENCER,541,Spencer County,040,Spencer County Elementary School,541040,108541040,210549001314,OVEC,906,KG,65,72,0,0,0,0,0,0,0,0,0,1,2,3,0,0,0,3,3,6,68,60,128,137
20192020,108,SPENCER,541,Spencer County,040,Spencer County Elementary School,541040,108541040,210549001314,OVEC,906,01,56,61,2,0,2,0,0,0,1,1,2,0,2,2,0,0,0,1,0,1,57,53,110,117
20192020,108,SPENCER,541,Spencer County,040,Spencer County Elementary School,541040,108541040,210549001314,OVEC,906,02,52,51,0,0,0,1,0,1,0,1,1,1,1,2,0,0,0,0,0,0,49,50,99,103
20192020,108,SPENCER,541,Spencer County,040,Spencer County Elementary School,541040,108541040,210549001314,OVEC,906,03,61,65,1,1,2,0,0,0,1,0,1,5,1,6,0,0,0,5,2,7,53,57,110,126
20192020,108,SPENCER,541,Spencer County,040,Spencer County Elementary School,541040,108541040,210549001314,OVEC,906,04,60,59,1,0,1,0,0,0,1,0,1,2,1,3,0,0,0,3,0,3,52,59,111,119
20192020,108,SPENCER,541,Spencer County,040,Spencer County Elementary School,541040,108541040,210549001314,OVEC,906,05,49,57,1,1,2,0,0,0,0,0,0,2,1,3,0,0,0,0,0,0,54,47,101,106
20192020,108,SPENCER,541,Spencer County,041,Spencer County Middle School,541041,108541041,210549001871,OVEC,906,All Students,345,388,4,4,8,1,0,1,0,3,3,17,20,37,0,0,0,13,17,30,353,301,654,733
20192020,108,SPENCER,541,Spencer County,041,Spencer County Middle School,541041,108541041,210549001871,OVEC,906,06,99,130,1,3,4,0,0,0,0,1,1,7,6,13,0,0,0,7,5,12,115,84,199,229
20192020,108,SPENCER,541,Spencer County,041,Spencer County Middle School,541041,108541041,210549001871,OVEC,906,07,132,128,2,1,3,0,0,0,0,0,0,5,6,11,0,0,0,5,9,14,116,116,232,260
20192020,108,SPENCER,541,Spencer County,041,Spencer County Middle School,541041,108541041,210549001871,OVEC,906,08,114,130,1,0,1,1,0,1,0,2,2,5,8,13,0,0,0,1,3,4,122,101,223,244
20192020,108,SPENCER,541,Spencer County,042,Hillview Academy,541042,108541042,210549002051,OVEC,906,All Students,16,34,2,0,2,0,0,0,0,0,0,1,0,1,0,0,0,1,0,1,30,16,46,50
20192020,108,SPENCER,541,Spencer County,042,Hillview Academy,541042,108541042,210549002051,OVEC,906,06,0,1,0,0,0,0,0,0,0,0,0,0,0,0,0,0,0,0,0,0,1,0,1,1
20192020,108,SPENCER,541,Spencer County,042,Hillview Academy,541042,108541042,210549002051,OVEC,906,07,0,2,1,0,1,0,0,0,0,0,0,0,0,0,0,0,0,0,0,0,1,0,1,2
20192020,108,SPENCER,541,Spencer County,042,Hillview Academy,541042,108541042,210549002051,OVEC,906,08,0,3,0,0,0,0,0,0,0,0,0,1,0,1,0,0,0,0,0,0,2,0,2,3
20192020,108,SPENCER,541,Spencer County,042,Hillview Academy,541042,108541042,210549002051,OVEC,906,09,2,7,0,0,0,0,0,0,0,0,0,0,0,0,0,0,0,0,0,0,7,2,9,9
20192020,108,SPENCER,541,Spencer County,042,Hillview Academy,541042,108541042,210549002051,OVEC,906,10,3,4,0,0,0,0,0,0,0,0,0,0,0,0,0,0,0,0,0,0,4,3,7,7
20192020,108,SPENCER,541,Spencer County,042,Hillview Academy,541042,108541042,210549002051,OVEC,906,11,5,8,0,0,0,0,0,0,0,0,0,0,0,0,0,0,0,1,0,1,7,5,12,13
20192020,108,SPENCER,541,Spencer County,042,Hillview Academy,541042,108541042,210549002051,OVEC,906,12,6,9,1,0,1,0,0,0,0,0,0,0,0,0,0,0,0,0,0,0,8,6,14,15
20192020,108,SPENCER,541,Spencer County,044,Taylorsville Elementary School,541044,108541044,210549002018,OVEC,906,All Students,287,310,1,0,1,0,0,0,0,0,0,9,13,22,0,0,0,12,12,24,288,262,550,597
20192020,108,SPENCER,541,Spencer County,044,Taylorsville Elementary School,541044,108541044,210549002018,OVEC,906,PS,28,33,0,1,1,0,0,0,0,0,0,0,3,3,0,0,0,0,1,1,33,23,56,61
20192020,108,SPENCER,541,Spencer County,044,Taylorsville Elementary School,541044,108541044,210549002018,OVEC,906,KG,48,57,0,0,0,0,0,0,0,0,0,0,0,0,0,0,0,1,1,2,56,47,103,105
20192020,108,SPENCER,541,Spencer County,044,Taylorsville Elementary School,541044,108541044,210549002018,OVEC,906,01,46,50,0,0,0,0,0,0,0,0,0,3,2,5,0,0,0,2,1,3,45,43,88,96
20192020,108,SPENCER,541,Spencer County,044,Taylorsville Elementary School,541044,108541044,210549002018,OVEC,906,02,45,41,0,0,0,0,0,0,0,0,0,1,4,5,0,0,0,0,4,4,40,37,77,86
20192020,108,SPENCER,541,Spencer County,044,Taylorsville Elementary School,541044,108541044,210549002018,OVEC,906,03,42,54,0,0,0,0,0,0,0,0,0,0,2,2,0,0,0,4,0,4,50,40,90,96
20192020,108,SPENCER,541,Spencer County,044,Taylorsville Elementary School,541044,108541044,210549002018,OVEC,906,04,56,43,0,0,0,0,0,0,0,0,0,2,2,4,0,0,0,5,4,9,36,50,86,99
20192020,108,SPENCER,541,Spencer County,044,Taylorsville Elementary School,541044,108541044,210549002018,OVEC,906,05,50,65,1,0,1,0,0,0,0,0,0,3,3,6,0,0,0,0,2,2,61,45,106,115
20192020,108,SPENCER,541,Spencer County,050,Spencer County High School,541050,108541050,210549001315,OVEC,906,All Students,415,485,2,4,6,1,1,2,0,4,4,21,20,41,0,1,1,20,13,33,441,372,813,900
20192020,108,SPENCER,541,Spencer County,050,Spencer County High School,541050,108541050,210549001315,OVEC,906,09,107,137,0,0,0,0,0,0,0,2,2,8,4,12,0,0,0,5,4,9,124,97,221,244
20192020,108,SPENCER,541,Spencer County,050,Spencer County High School,541050,108541050,210549001315,OVEC,906,10,98,121,1,2,3,0,0,0,0,1,1,4,2,6,0,0,0,7,3,10,109,90,199,219
20192020,108,SPENCER,541,Spencer County,050,Spencer County High School,541050,108541050,210549001315,OVEC,906,11,102,122,0,1,1,0,1,1,0,0,0,4,5,9,0,1,1,6,4,10,112,90,202,224
20192020,108,SPENCER,541,Spencer County,050,Spencer County High School,541050,108541050,210549001315,OVEC,906,12,107,104,1,1,2,1,0,1,0,1,1,5,9,14,0,0,0,2,2,4,95,94,189,211
20192020,108,SPENCER,541,Spencer County,050,Spencer County High School,541050,108541050,210549001315,OVEC,906,14,1,1,0,0,0,0,0,0,0,0,0,0,0,0,0,0,0,0,0,0,1,1,2,2
20192020,109,TAYLOR,545,Taylor County,"",---District Total---,545,"","",GRREC,902,All Students,1288,1342,24,18,42,0,4,4,8,13,21,47,54,101,1,1,2,57,61,118,1205,1137,2342,2630
20192020,109,TAYLOR,545,Taylor County,"",---District Total---,545,"","",GRREC,902,PS,54,60,1,1,2,1,0,1,1,0,1,3,5,8,0,0,0,2,3,5,52,45,97,114
20192020,109,TAYLOR,545,Taylor County,"",---District Total---,545,"","",GRREC,902,KG,95,76,1,0,1,0,0,0,0,1,1,2,1,3,0,0,0,6,6,12,67,87,154,171
20192020,109,TAYLOR,545,Taylor County,"",---District Total---,545,"","",GRREC,902,01,118,113,1,0,1,0,0,0,0,1,1,6,4,10,0,0,0,5,10,15,101,103,204,231
20192020,109,TAYLOR,545,Taylor County,"",---District Total---,545,"","",GRREC,902,02,77,88,0,1,1,0,1,1,1,1,2,6,2,8,0,0,0,5,4,9,76,68,144,165
20192020,109,TAYLOR,545,Taylor County,"",---District Total---,545,"","",GRREC,902,03,90,99,1,1,2,0,0,0,0,0,0,4,7,11,0,0,0,3,9,12,91,73,164,189
20192020,109,TAYLOR,545,Taylor County,"",---District Total---,545,"","",GRREC,902,04,95,104,0,1,1,0,0,0,0,1,1,3,4,7,0,0,0,9,4,13,92,85,177,199
20192020,109,TAYLOR,545,Taylor County,"",---District Total---,545,"","",GRREC,902,05,95,114,1,2,3,0,1,1,1,2,3,1,6,7,0,0,0,4,4,8,107,80,187,209
20192020,109,TAYLOR,545,Taylor County,"",---District Total---,545,"","",GRREC,902,06,92,102,0,2,2,0,0,0,1,1,2,6,3,9,0,0,0,1,4,5,94,82,176,194
20192020,109,TAYLOR,545,Taylor County,"",---District Total---,545,"","",GRREC,902,07,94,124,6,1,7,0,1,1,3,0,3,4,4,8,0,0,0,8,6,14,103,82,185,218
20192020,109,TAYLOR,545,Taylor County,"",---District Total---,545,"","",GRREC,902,08,106,95,1,1,2,0,0,0,0,0,0,5,5,10,0,0,0,6,3,9,83,97,180,201
20192020,109,TAYLOR,545,Taylor County,"",---District Total---,545,"","",GRREC,902,09,100,114,0,2,2,0,0,0,0,4,4,4,7,11,1,0,1,4,3,7,105,84,189,214
20192020,109,TAYLOR,545,Taylor County,"",---District Total---,545,"","",GRREC,902,10,112,108,3,3,6,0,1,1,0,0,0,1,4,5,0,0,0,2,3,5,102,101,203,220
20192020,109,TAYLOR,545,Taylor County,"",---District Total---,545,"","",GRREC,902,11,110,106,6,1,7,0,0,0,1,2,3,3,5,8,0,0,0,0,4,4,96,98,194,216
20192020,109,TAYLOR,545,Taylor County,"",---District Total---,545,"","",GRREC,902,12,104,99,4,3,7,0,0,0,1,0,1,2,2,4,0,1,1,4,1,5,88,97,185,203
20192020,109,TAYLOR,545,Taylor County,005,Taylor County Primary Center,545005,109545005,210552002431,GRREC,902,All Students,290,277,2,1,3,0,1,1,1,3,4,14,7,21,0,0,0,16,20,36,244,258,502,567
20192020,109,TAYLOR,545,Taylor County,005,Taylor County Primary Center,545005,109545005,210552002431,GRREC,902,PS,54,60,1,1,2,1,0,1,1,0,1,3,5,8,0,0,0,2,3,5,52,45,97,114
20192020,109,TAYLOR,545,Taylor County,005,Taylor County Primary Center,545005,109545005,210552002431,GRREC,902,KG,95,76,1,0,1,0,0,0,0,1,1,2,1,3,0,0,0,6,6,12,67,87,154,171
20192020,109,TAYLOR,545,Taylor County,005,Taylor County Primary Center,545005,109545005,210552002431,GRREC,902,01,118,113,1,0,1,0,0,0,0,1,1,6,4,10,0,0,0,5,10,15,101,103,204,231
20192020,109,TAYLOR,545,Taylor County,005,Taylor County Primary Center,545005,109545005,210552002431,GRREC,902,02,77,88,0,1,1,0,1,1,1,1,2,6,2,8,0,0,0,5,4,9,76,68,144,165
20192020,109,TAYLOR,545,Taylor County,020,Taylor County Elementary School,545020,109545020,210552001317,GRREC,902,All Students,280,317,2,4,6,0,1,1,1,3,4,8,17,25,0,0,0,16,17,33,290,238,528,597
20192020,109,TAYLOR,545,Taylor County,020,Taylor County Elementary School,545020,109545020,210552001317,GRREC,902,03,90,99,1,1,2,0,0,0,0,0,0,4,7,11,0,0,0,3,9,12,91,73,164,189
20192020,109,TAYLOR,545,Taylor County,020,Taylor County Elementary School,545020,109545020,210552001317,GRREC,902,04,95,104,0,1,1,0,0,0,0,1,1,3,4,7,0,0,0,9,4,13,92,85,177,199
20192020,109,TAYLOR,545,Taylor County,020,Taylor County Elementary School,545020,109545020,210552001317,GRREC,902,05,95,114,1,2,3,0,1,1,1,2,3,1,6,7,0,0,0,4,4,8,107,80,187,209
20192020,109,TAYLOR,545,Taylor County,030,Taylor County High School,545030,109545030,210552001318,GRREC,902,All Students,408,398,12,9,21,0,1,1,1,6,7,9,17,26,1,1,2,8,11,19,367,363,730,806
20192020,109,TAYLOR,545,Taylor County,030,Taylor County High School,545030,109545030,210552001318,GRREC,902,09,98,110,0,2,2,0,0,0,0,4,4,3,7,10,1,0,1,4,3,7,102,82,184,208
20192020,109,TAYLOR,545,Taylor County,030,Taylor County High School,545030,109545030,210552001318,GRREC,902,10,110,96,3,3,6,0,1,1,0,0,0,1,4,5,0,0,0,2,3,5,90,99,189,206
20192020,109,TAYLOR,545,Taylor County,030,Taylor County High School,545030,109545030,210552001318,GRREC,902,11,104,100,5,1,6,0,0,0,1,2,3,3,4,7,0,0,0,0,4,4,91,93,184,204
20192020,109,TAYLOR,545,Taylor County,030,Taylor County High School,545030,109545030,210552001318,GRREC,902,12,96,92,4,3,7,0,0,0,0,0,0,2,2,4,0,1,1,2,1,3,84,89,173,188
20192020,109,TAYLOR,545,Taylor County,040,Taylor County Middle School,545040,109545040,210552001319,GRREC,902,All Students,290,315,7,4,11,0,1,1,4,1,5,14,12,26,0,0,0,15,13,28,275,259,534,605
20192020,109,TAYLOR,545,Taylor County,040,Taylor County Middle School,545040,109545040,210552001319,GRREC,902,06,92,101,0,2,2,0,0,0,1,1,2,6,3,9,0,0,0,1,4,5,93,82,175,193
20192020,109,TAYLOR,545,Taylor County,040,Taylor County Middle School,545040,109545040,210552001319,GRREC,902,07,94,121,6,1,7,0,1,1,3,0,3,4,4,8,0,0,0,8,6,14,100,82,182,215
20192020,109,TAYLOR,545,Taylor County,040,Taylor County Middle School,545040,109545040,210552001319,GRREC,902,08,104,93,1,1,2,0,0,0,0,0,0,4,5,9,0,0,0,6,3,9,82,95,177,197
20192020,109,TAYLOR,545,Taylor County,075,Lakeview Academy,545075,109545075,210552002495,GRREC,902,All Students,20,35,1,0,1,0,0,0,1,0,1,2,1,3,0,0,0,2,0,2,29,19,48,55
20192020,109,TAYLOR,545,Taylor County,075,Lakeview Academy,545075,109545075,210552002495,GRREC,902,06,0,1,0,0,0,0,0,0,0,0,0,0,0,0,0,0,0,0,0,0,1,0,1,1
20192020,109,TAYLOR,545,Taylor County,075,Lakeview Academy,545075,109545075,210552002495,GRREC,902,07,0,3,0,0,0,0,0,0,0,0,0,0,0,0,0,0,0,0,0,0,3,0,3,3
20192020,109,TAYLOR,545,Taylor County,075,Lakeview Academy,545075,109545075,210552002495,GRREC,902,08,2,2,0,0,0,0,0,0,0,0,0,1,0,1,0,0,0,0,0,0,1,2,3,4
20192020,109,TAYLOR,545,Taylor County,075,Lakeview Academy,545075,109545075,210552002495,GRREC,902,09,2,4,0,0,0,0,0,0,0,0,0,1,0,1,0,0,0,0,0,0,3,2,5,6
20192020,109,TAYLOR,545,Taylor County,075,Lakeview Academy,545075,109545075,210552002495,GRREC,902,10,2,12,0,0,0,0,0,0,0,0,0,0,0,0,0,0,0,0,0,0,12,2,14,14
20192020,109,TAYLOR,545,Taylor County,075,Lakeview Academy,545075,109545075,210552002495,GRREC,902,11,6,6,1,0,1,0,0,0,0,0,0,0,1,1,0,0,0,0,0,0,5,5,10,12
20192020,109,TAYLOR,545,Taylor County,075,Lakeview Academy,545075,109545075,210552002495,GRREC,902,12,8,7,0,0,0,0,0,0,1,0,1,0,0,0,0,0,0,2,0,2,4,8,12,15
20192020,110,TODD,551,Todd County,"",---District Total---,551,"","",GRREC,902,All Students,891,928,83,87,170,2,1,3,2,0,2,92,84,176,1,2,3,27,36,63,721,681,1402,1819
20192020,110,TODD,551,Todd County,"",---District Total---,551,"","",GRREC,902,PS,108,82,8,8,16,0,0,0,0,0,0,7,8,15,0,0,0,2,5,7,65,87,152,190
20192020,110,TODD,551,Todd County,"",---District Total---,551,"","",GRREC,902,KG,63,68,4,9,13,0,0,0,0,0,0,9,5,14,1,0,1,0,3,3,54,46,100,131
20192020,110,TODD,551,Todd County,"",---District Total---,551,"","",GRREC,902,01,62,78,7,7,14,0,0,0,0,0,0,8,9,17,0,0,0,0,2,2,63,44,107,140
20192020,110,TODD,551,Todd County,"",---District Total---,551,"","",GRREC,902,02,60,64,7,7,14,1,0,1,1,0,1,6,6,12,0,0,0,2,0,2,47,47,94,124
20192020,110,TODD,551,Todd County,"",---District Total---,551,"","",GRREC,902,03,74,55,1,3,4,0,0,0,1,0,1,8,4,12,0,0,0,2,0,2,43,67,110,129
20192020,110,TODD,551,Todd County,"",---District Total---,551,"","",GRREC,902,04,61,69,4,6,10,0,1,1,0,0,0,7,6,13,0,1,1,3,3,6,55,44,99,130
20192020,110,TODD,551,Todd County,"",---District Total---,551,"","",GRREC,902,05,74,75,7,7,14,0,0,0,0,0,0,9,5,14,0,0,0,1,6,7,58,56,114,149
20192020,110,TODD,551,Todd County,"",---District Total---,551,"","",GRREC,902,06,59,71,9,6,15,0,0,0,0,0,0,8,5,13,0,0,0,2,4,6,52,44,96,130
20192020,110,TODD,551,Todd County,"",---District Total---,551,"","",GRREC,902,07,83,74,6,8,14,0,0,0,0,0,0,10,4,14,0,0,0,7,8,15,51,63,114,157
20192020,110,TODD,551,Todd County,"",---District Total---,551,"","",GRREC,902,08,74,84,9,7,16,0,0,0,0,0,0,11,13,24,0,0,0,4,1,5,60,53,113,158
20192020,110,TODD,551,Todd County,"",---District Total---,551,"","",GRREC,902,09,84,87,7,6,13,0,0,0,0,0,0,6,6,12,0,1,1,4,3,7,70,68,138,171
20192020,110,TODD,551,Todd County,"",---District Total---,551,"","",GRREC,902,10,73,76,10,8,18,1,0,1,0,0,0,6,12,18,0,0,0,1,3,4,58,50,108,149
20192020,110,TODD,551,Todd County,"",---District Total---,551,"","",GRREC,902,11,66,65,4,5,9,0,0,0,0,0,0,2,5,7,0,0,0,0,0,0,59,56,115,131
20192020,110,TODD,551,Todd County,"",---District Total---,551,"","",GRREC,902,12,57,59,8,7,15,0,0,0,0,0,0,2,4,6,0,0,0,1,3,4,48,43,91,116
20192020,110,TODD,551,Todd County,"",---District Total---,551,"","",GRREC,902,14,1,3,0,1,1,0,0,0,0,0,0,0,0,0,0,0,0,0,0,0,3,0,3,4
20192020,110,TODD,551,Todd County,005,North Todd Elementary School,551005,110551005,210555001600,GRREC,902,All Students,168,193,2,3,5,0,0,0,0,0,0,8,8,16,0,1,1,3,6,9,180,150,330,361
20192020,110,TODD,551,Todd County,005,North Todd Elementary School,551005,110551005,210555001600,GRREC,902,PS,50,38,0,1,1,0,0,0,0,0,0,1,2,3,0,0,0,1,1,2,36,46,82,88
20192020,110,TODD,551,Todd County,005,North Todd Elementary School,551005,110551005,210555001600,GRREC,902,KG,25,32,0,2,2,0,0,0,0,0,0,1,0,1,0,0,0,0,2,2,31,21,52,57
20192020,110,TODD,551,Todd County,005,North Todd Elementary School,551005,110551005,210555001600,GRREC,902,01,26,36,0,0,0,0,0,0,0,0,0,1,5,6,0,0,0,0,2,2,35,19,54,62
20192020,110,TODD,551,Todd County,005,North Todd Elementary School,551005,110551005,210555001600,GRREC,902,02,20,36,2,0,2,0,0,0,0,0,0,1,0,1,0,0,0,1,0,1,32,20,52,56
20192020,110,TODD,551,Todd County,005,North Todd Elementary School,551005,110551005,210555001600,GRREC,902,03,42,24,0,0,0,0,0,0,0,0,0,2,0,2,0,0,0,0,0,0,22,42,64,66
20192020,110,TODD,551,Todd County,005,North Todd Elementary School,551005,110551005,210555001600,GRREC,902,04,25,28,0,0,0,0,0,0,0,0,0,1,2,3,0,1,1,2,0,2,25,22,47,53
20192020,110,TODD,551,Todd County,005,North Todd Elementary School,551005,110551005,210555001600,GRREC,902,05,30,37,0,1,1,0,0,0,0,0,0,2,1,3,0,0,0,0,2,2,35,26,61,67
20192020,110,TODD,551,Todd County,015,South Todd Elementary School,551015,110551015,210555001601,GRREC,902,All Students,226,216,28,36,64,1,1,2,2,0,2,39,27,66,1,0,1,5,8,13,140,154,294,442
20192020,110,TODD,551,Todd County,015,South Todd Elementary School,551015,110551015,210555001601,GRREC,902,PS,58,44,8,7,15,0,0,0,0,0,0,6,6,12,0,0,0,1,4,5,29,41,70,102
20192020,110,TODD,551,Todd County,015,South Todd Elementary School,551015,110551015,210555001601,GRREC,902,KG,38,36,4,7,11,0,0,0,0,0,0,8,5,13,1,0,1,0,1,1,23,25,48,74
20192020,110,TODD,551,Todd County,015,South Todd Elementary School,551015,110551015,210555001601,GRREC,902,01,36,42,7,7,14,0,0,0,0,0,0,7,4,11,0,0,0,0,0,0,28,25,53,78
20192020,110,TODD,551,Todd County,015,South Todd Elementary School,551015,110551015,210555001601,GRREC,902,02,40,28,5,7,12,1,0,1,1,0,1,5,6,11,0,0,0,1,0,1,15,27,42,68
20192020,110,TODD,551,Todd County,015,South Todd Elementary School,551015,110551015,210555001601,GRREC,902,03,32,31,1,3,4,0,0,0,1,0,1,6,4,10,0,0,0,2,0,2,21,25,46,63
20192020,110,TODD,551,Todd County,015,South Todd Elementary School,551015,110551015,210555001601,GRREC,902,04,36,41,4,6,10,0,1,1,0,0,0,6,4,10,0,0,0,1,3,4,30,22,52,77
20192020,110,TODD,551,Todd County,015,South Todd Elementary School,551015,110551015,210555001601,GRREC,902,05,44,38,7,6,13,0,0,0,0,0,0,7,4,11,0,0,0,1,4,5,23,30,53,82
20192020,110,TODD,551,Todd County,017,Horizons High School,551017,110551017,210555002034,GRREC,902,All Students,4,15,1,0,1,0,0,0,0,0,0,0,0,0,0,0,0,1,0,1,13,4,17,19
20192020,110,TODD,551,Todd County,017,Horizons High School,551017,110551017,210555002034,GRREC,902,07,0,1,0,0,0,0,0,0,0,0,0,0,0,0,0,0,0,1,0,1,0,0,0,1
20192020,110,TODD,551,Todd County,017,Horizons High School,551017,110551017,210555002034,GRREC,902,08,0,1,0,0,0,0,0,0,0,0,0,0,0,0,0,0,0,0,0,0,1,0,1,1
20192020,110,TODD,551,Todd County,017,Horizons High School,551017,110551017,210555002034,GRREC,902,09,0,5,0,0,0,0,0,0,0,0,0,0,0,0,0,0,0,0,0,0,5,0,5,5
20192020,110,TODD,551,Todd County,017,Horizons High School,551017,110551017,210555002034,GRREC,902,10,0,2,0,0,0,0,0,0,0,0,0,0,0,0,0,0,0,0,0,0,2,0,2,2
20192020,110,TODD,551,Todd County,017,Horizons High School,551017,110551017,210555002034,GRREC,902,12,4,6,1,0,1,0,0,0,0,0,0,0,0,0,0,0,0,0,0,0,5,4,9,10
20192020,110,TODD,551,Todd County,080,Todd County Middle School,551080,110551080,210555001324,GRREC,902,All Students,216,227,24,21,45,0,0,0,0,0,0,29,22,51,0,0,0,12,13,25,162,160,322,443
20192020,110,TODD,551,Todd County,080,Todd County Middle School,551080,110551080,210555001324,GRREC,902,06,59,71,9,6,15,0,0,0,0,0,0,8,5,13,0,0,0,2,4,6,52,44,96,130
20192020,110,TODD,551,Todd County,080,Todd County Middle School,551080,110551080,210555001324,GRREC,902,07,83,73,6,8,14,0,0,0,0,0,0,10,4,14,0,0,0,6,8,14,51,63,114,156
20192020,110,TODD,551,Todd County,080,Todd County Middle School,551080,110551080,210555001324,GRREC,902,08,74,83,9,7,16,0,0,0,0,0,0,11,13,24,0,0,0,4,1,5,59,53,112,157
20192020,110,TODD,551,Todd County,095,Todd County Central High School,551095,110551095,210555001325,GRREC,902,All Students,277,277,28,27,55,1,0,1,0,0,0,16,27,43,0,1,1,6,9,15,226,213,439,554
20192020,110,TODD,551,Todd County,095,Todd County Central High School,551095,110551095,210555001325,GRREC,902,09,84,82,7,6,13,0,0,0,0,0,0,6,6,12,0,1,1,4,3,7,65,68,133,166
20192020,110,TODD,551,Todd County,095,Todd County Central High School,551095,110551095,210555001325,GRREC,902,10,73,74,10,8,18,1,0,1,0,0,0,6,12,18,0,0,0,1,3,4,56,50,106,147
20192020,110,TODD,551,Todd County,095,Todd County Central High School,551095,110551095,210555001325,GRREC,902,11,66,65,4,5,9,0,0,0,0,0,0,2,5,7,0,0,0,0,0,0,59,56,115,131
20192020,110,TODD,551,Todd County,095,Todd County Central High School,551095,110551095,210555001325,GRREC,902,12,53,53,7,7,14,0,0,0,0,0,0,2,4,6,0,0,0,1,3,4,43,39,82,106
20192020,110,TODD,551,Todd County,095,Todd County Central High School,551095,110551095,210555001325,GRREC,902,14,1,3,0,1,1,0,0,0,0,0,0,0,0,0,0,0,0,0,0,0,3,0,3,4
20192020,111,TRIGG,555,Trigg County,"",---District Total---,555,"","",WKEC,908,All Students,922,996,69,62,131,1,4,5,7,4,11,37,28,65,0,0,0,70,80,150,812,744,1556,1918
20192020,111,TRIGG,555,Trigg County,"",---District Total---,555,"","",WKEC,908,PS,46,45,4,4,8,0,0,0,0,1,1,0,0,0,0,0,0,4,5,9,37,36,73,91
20192020,111,TRIGG,555,Trigg County,"",---District Total---,555,"","",WKEC,908,KG,54,89,3,2,5,0,0,0,0,0,0,4,1,5,0,0,0,7,14,21,75,37,112,143
20192020,111,TRIGG,555,Trigg County,"",---District Total---,555,"","",WKEC,908,01,66,71,3,6,9,0,0,0,1,0,1,5,3,8,0,0,0,11,6,17,51,51,102,137
20192020,111,TRIGG,555,Trigg County,"",---District Total---,555,"","",WKEC,908,02,59,76,6,3,9,0,0,0,0,0,0,2,0,2,0,0,0,7,4,11,61,52,113,135
20192020,111,TRIGG,555,Trigg County,"",---District Total---,555,"","",WKEC,908,03,64,76,3,4,7,0,0,0,0,0,0,4,0,4,0,0,0,6,4,10,63,56,119,140
20192020,111,TRIGG,555,Trigg County,"",---District Total---,555,"","",WKEC,908,04,72,69,7,8,15,0,0,0,0,1,1,3,5,8,0,0,0,3,8,11,56,50,106,141
20192020,111,TRIGG,555,Trigg County,"",---District Total---,555,"","",WKEC,908,05,76,68,6,3,9,0,0,0,1,0,1,3,3,6,0,0,0,5,7,12,53,63,116,144
20192020,111,TRIGG,555,Trigg County,"",---District Total---,555,"","",WKEC,908,06,94,58,6,4,10,1,2,3,1,1,2,1,0,1,0,0,0,4,5,9,45,82,127,152
20192020,111,TRIGG,555,Trigg County,"",---District Total---,555,"","",WKEC,908,07,73,81,6,4,10,0,0,0,1,0,1,2,2,4,0,0,0,6,4,10,66,63,129,154
20192020,111,TRIGG,555,Trigg County,"",---District Total---,555,"","",WKEC,908,08,83,77,4,6,10,0,0,0,0,0,0,2,2,4,0,0,0,4,8,12,67,67,134,160
20192020,111,TRIGG,555,Trigg County,"",---District Total---,555,"","",WKEC,908,09,83,83,4,8,12,0,0,0,1,1,2,3,3,6,0,0,0,5,8,13,70,63,133,166
20192020,111,TRIGG,555,Trigg County,"",---District Total---,555,"","",WKEC,908,10,65,80,4,4,8,0,0,0,0,1,1,2,2,4,0,0,0,3,7,10,71,51,122,145
20192020,111,TRIGG,555,Trigg County,"",---District Total---,555,"","",WKEC,908,11,68,83,10,8,18,0,1,1,1,0,1,1,4,5,0,0,0,4,3,7,67,52,119,151
20192020,111,TRIGG,555,Trigg County,"",---District Total---,555,"","",WKEC,908,12,64,85,7,2,9,0,1,1,1,0,1,5,3,8,0,0,0,5,2,7,67,56,123,149
20192020,111,TRIGG,555,Trigg County,"",---District Total---,555,"","",WKEC,908,14,1,0,0,0,0,0,0,0,0,0,0,0,0,0,0,0,0,0,0,0,0,1,1,1
20192020,111,TRIGG,555,Trigg County,013,Trigg County Primary School,555013,111555013,210558002093,WKEC,908,All Students,179,236,12,11,23,0,0,0,1,0,1,11,4,15,0,0,0,25,24,49,187,140,327,415
20192020,111,TRIGG,555,Trigg County,013,Trigg County Primary School,555013,111555013,210558002093,WKEC,908,PS,46,45,4,4,8,0,0,0,0,1,1,0,0,0,0,0,0,4,5,9,37,36,73,91
20192020,111,TRIGG,555,Trigg County,013,Trigg County Primary School,555013,111555013,210558002093,WKEC,908,KG,54,89,3,2,5,0,0,0,0,0,0,4,1,5,0,0,0,7,14,21,75,37,112,143
20192020,111,TRIGG,555,Trigg County,013,Trigg County Primary School,555013,111555013,210558002093,WKEC,908,01,66,71,3,6,9,0,0,0,1,0,1,5,3,8,0,0,0,11,6,17,51,51,102,137
20192020,111,TRIGG,555,Trigg County,013,Trigg County Primary School,555013,111555013,210558002093,WKEC,908,02,59,76,6,3,9,0,0,0,0,0,0,2,0,2,0,0,0,7,4,11,61,52,113,135
20192020,111,TRIGG,555,Trigg County,014,Trigg County Intermediate School,555014,111555014,210558002167,WKEC,908,All Students,212,213,16,15,31,0,0,0,1,1,2,10,8,18,0,0,0,14,19,33,172,169,341,425
20192020,111,TRIGG,555,Trigg County,014,Trigg County Intermediate School,555014,111555014,210558002167,WKEC,908,03,64,76,3,4,7,0,0,0,0,0,0,4,0,4,0,0,0,6,4,10,63,56,119,140
20192020,111,TRIGG,555,Trigg County,014,Trigg County Intermediate School,555014,111555014,210558002167,WKEC,908,04,72,69,7,8,15,0,0,0,0,1,1,3,5,8,0,0,0,3,8,11,56,50,106,141
20192020,111,TRIGG,555,Trigg County,014,Trigg County Intermediate School,555014,111555014,210558002167,WKEC,908,05,76,68,6,3,9,0,0,0,1,0,1,3,3,6,0,0,0,5,7,12,53,63,116,144
20192020,111,TRIGG,555,Trigg County,050,Trigg County Middle School,555050,111555050,210558001328,WKEC,908,All Students,250,216,16,14,30,1,2,3,2,1,3,5,4,9,0,0,0,14,17,31,178,212,390,466
20192020,111,TRIGG,555,Trigg County,050,Trigg County Middle School,555050,111555050,210558001328,WKEC,908,06,94,58,6,4,10,1,2,3,1,1,2,1,0,1,0,0,0,4,5,9,45,82,127,152
20192020,111,TRIGG,555,Trigg County,050,Trigg County Middle School,555050,111555050,210558001328,WKEC,908,07,73,81,6,4,10,0,0,0,1,0,1,2,2,4,0,0,0,6,4,10,66,63,129,154
20192020,111,TRIGG,555,Trigg County,050,Trigg County Middle School,555050,111555050,210558001328,WKEC,908,08,83,77,4,6,10,0,0,0,0,0,0,2,2,4,0,0,0,4,8,12,67,67,134,160
20192020,111,TRIGG,555,Trigg County,070,Trigg County High School,555070,111555070,210558001329,WKEC,908,All Students,281,331,25,22,47,0,2,2,3,2,5,11,12,23,0,0,0,17,20,37,275,223,498,612
20192020,111,TRIGG,555,Trigg County,070,Trigg County High School,555070,111555070,210558001329,WKEC,908,09,83,83,4,8,12,0,0,0,1,1,2,3,3,6,0,0,0,5,8,13,70,63,133,166
20192020,111,TRIGG,555,Trigg County,070,Trigg County High School,555070,111555070,210558001329,WKEC,908,10,65,80,4,4,8,0,0,0,0,1,1,2,2,4,0,0,0,3,7,10,71,51,122,145
20192020,111,TRIGG,555,Trigg County,070,Trigg County High School,555070,111555070,210558001329,WKEC,908,11,68,83,10,8,18,0,1,1,1,0,1,1,4,5,0,0,0,4,3,7,67,52,119,151
20192020,111,TRIGG,555,Trigg County,070,Trigg County High School,555070,111555070,210558001329,WKEC,908,12,64,85,7,2,9,0,1,1,1,0,1,5,3,8,0,0,0,5,2,7,67,56,123,149
20192020,111,TRIGG,555,Trigg County,070,Trigg County High School,555070,111555070,210558001329,WKEC,908,14,1,0,0,0,0,0,0,0,0,0,0,0,0,0,0,0,0,0,0,0,0,1,1,1
20192020,112,TRIMBLE,561,Trimble County,"",---District Total---,561,"","",OVEC,906,All Students,542,573,4,3,7,0,0,0,1,0,1,24,18,42,2,3,5,7,8,15,535,510,1045,1115
20192020,112,TRIMBLE,561,Trimble County,"",---District Total---,561,"","",OVEC,906,PS,37,32,0,0,0,0,0,0,0,0,0,1,2,3,0,0,0,1,1,2,30,34,64,69
20192020,112,TRIMBLE,561,Trimble County,"",---District Total---,561,"","",OVEC,906,KG,43,47,0,0,0,0,0,0,1,0,1,5,3,8,0,0,0,1,0,1,40,40,80,90
20192020,112,TRIMBLE,561,Trimble County,"",---District Total---,561,"","",OVEC,906,01,37,41,0,0,0,0,0,0,0,0,0,3,2,5,0,1,1,2,0,2,36,34,70,78
20192020,112,TRIMBLE,561,Trimble County,"",---District Total---,561,"","",OVEC,906,02,22,42,0,0,0,0,0,0,0,0,0,1,0,1,0,0,0,0,0,0,41,22,63,64
20192020,112,TRIMBLE,561,Trimble County,"",---District Total---,561,"","",OVEC,906,03,43,45,0,2,2,0,0,0,0,0,0,0,2,2,1,0,1,0,1,1,44,38,82,88
20192020,112,TRIMBLE,561,Trimble County,"",---District Total---,561,"","",OVEC,906,04,33,45,0,0,0,0,0,0,0,0,0,2,1,3,0,0,0,0,0,0,43,32,75,78
20192020,112,TRIMBLE,561,Trimble County,"",---District Total---,561,"","",OVEC,906,05,49,44,0,0,0,0,0,0,0,0,0,4,2,6,0,0,0,1,2,3,39,45,84,93
20192020,112,TRIMBLE,561,Trimble County,"",---District Total---,561,"","",OVEC,906,06,58,34,1,0,1,0,0,0,0,0,0,1,1,2,0,0,0,0,1,1,32,56,88,92
20192020,112,TRIMBLE,561,Trimble County,"",---District Total---,561,"","",OVEC,906,07,47,50,1,0,1,0,0,0,0,0,0,2,1,3,1,0,1,0,1,1,46,45,91,97
20192020,112,TRIMBLE,561,Trimble County,"",---District Total---,561,"","",OVEC,906,08,46,49,1,0,1,0,0,0,0,0,0,1,1,2,0,0,0,0,0,0,47,45,92,95
20192020,112,TRIMBLE,561,Trimble County,"",---District Total---,561,"","",OVEC,906,09,59,56,1,0,1,0,0,0,0,0,0,4,1,5,0,0,0,0,1,1,51,57,108,115
20192020,112,TRIMBLE,561,Trimble County,"",---District Total---,561,"","",OVEC,906,10,36,42,0,1,1,0,0,0,0,0,0,0,0,0,0,1,1,2,0,2,40,34,74,78
20192020,112,TRIMBLE,561,Trimble County,"",---District Total---,561,"","",OVEC,906,11,36,37,0,0,0,0,0,0,0,0,0,1,1,2,0,1,1,0,1,1,36,33,69,73
20192020,112,TRIMBLE,561,Trimble County,"",---District Total---,561,"","",OVEC,906,12,33,41,0,0,0,0,0,0,0,0,0,0,3,3,0,0,0,1,1,2,40,29,69,74
20192020,112,TRIMBLE,561,Trimble County,010,Bedford Elementary School,561010,112561010,210561001330,OVEC,906,All Students,175,184,0,2,2,0,0,0,1,0,1,10,6,16,1,1,2,2,2,4,170,164,334,359
20192020,112,TRIMBLE,561,Trimble County,010,Bedford Elementary School,561010,112561010,210561001330,OVEC,906,PS,37,32,0,0,0,0,0,0,0,0,0,1,2,3,0,0,0,1,1,2,30,34,64,69
20192020,112,TRIMBLE,561,Trimble County,010,Bedford Elementary School,561010,112561010,210561001330,OVEC,906,KG,28,28,0,0,0,0,0,0,1,0,1,4,2,6,0,0,0,1,0,1,22,26,48,56
20192020,112,TRIMBLE,561,Trimble County,010,Bedford Elementary School,561010,112561010,210561001330,OVEC,906,01,20,24,0,0,0,0,0,0,0,0,0,2,1,3,0,1,1,1,0,1,21,18,39,44
20192020,112,TRIMBLE,561,Trimble County,010,Bedford Elementary School,561010,112561010,210561001330,OVEC,906,02,13,27,0,0,0,0,0,0,0,0,0,1,0,1,0,0,0,0,0,0,26,13,39,40
20192020,112,TRIMBLE,561,Trimble County,010,Bedford Elementary School,561010,112561010,210561001330,OVEC,906,03,30,28,0,2,2,0,0,0,0,0,0,0,1,1,1,0,1,0,0,0,27,27,54,58
20192020,112,TRIMBLE,561,Trimble County,010,Bedford Elementary School,561010,112561010,210561001330,OVEC,906,04,16,35,0,0,0,0,0,0,0,0,0,2,1,3,0,0,0,0,0,0,33,15,48,51
20192020,112,TRIMBLE,561,Trimble County,010,Bedford Elementary School,561010,112561010,210561001330,OVEC,906,05,35,26,0,0,0,0,0,0,0,0,0,1,1,2,0,0,0,0,2,2,25,32,57,61
20192020,112,TRIMBLE,561,Trimble County,010,Bedford Elementary School,561010,112561010,210561001330,OVEC,906,06,33,16,0,0,0,0,0,0,0,0,0,0,0,0,0,0,0,0,0,0,16,33,49,49
20192020,112,TRIMBLE,561,Trimble County,020,Milton Elementary School,561020,112561020,210561001332,OVEC,906,All Students,110,114,1,0,1,0,0,0,0,0,0,6,5,11,0,0,0,2,2,4,105,103,208,224
20192020,112,TRIMBLE,561,Trimble County,020,Milton Elementary School,561020,112561020,210561001332,OVEC,906,KG,15,19,0,0,0,0,0,0,0,0,0,1,1,2,0,0,0,0,0,0,18,14,32,34
20192020,112,TRIMBLE,561,Trimble County,020,Milton Elementary School,561020,112561020,210561001332,OVEC,906,01,17,17,0,0,0,0,0,0,0,0,0,1,1,2,0,0,0,1,0,1,15,16,31,34
20192020,112,TRIMBLE,561,Trimble County,020,Milton Elementary School,561020,112561020,210561001332,OVEC,906,02,9,15,0,0,0,0,0,0,0,0,0,0,0,0,0,0,0,0,0,0,15,9,24,24
20192020,112,TRIMBLE,561,Trimble County,020,Milton Elementary School,561020,112561020,210561001332,OVEC,906,03,13,17,0,0,0,0,0,0,0,0,0,0,1,1,0,0,0,0,1,1,17,11,28,30
20192020,112,TRIMBLE,561,Trimble County,020,Milton Elementary School,561020,112561020,210561001332,OVEC,906,04,17,10,0,0,0,0,0,0,0,0,0,0,0,0,0,0,0,0,0,0,10,17,27,27
20192020,112,TRIMBLE,561,Trimble County,020,Milton Elementary School,561020,112561020,210561001332,OVEC,906,05,14,18,0,0,0,0,0,0,0,0,0,3,1,4,0,0,0,1,0,1,14,13,27,32
20192020,112,TRIMBLE,561,Trimble County,020,Milton Elementary School,561020,112561020,210561001332,OVEC,906,06,25,18,1,0,1,0,0,0,0,0,0,1,1,2,0,0,0,0,1,1,16,23,39,43
20192020,112,TRIMBLE,561,Trimble County,025,Trimble County JR/SR High School,561025,112561025,210561002475,OVEC,906,All Students,257,275,3,1,4,0,0,0,0,0,0,8,7,15,1,2,3,3,4,7,260,243,503,532
20192020,112,TRIMBLE,561,Trimble County,025,Trimble County JR/SR High School,561025,112561025,210561002475,OVEC,906,07,47,50,1,0,1,0,0,0,0,0,0,2,1,3,1,0,1,0,1,1,46,45,91,97
20192020,112,TRIMBLE,561,Trimble County,025,Trimble County JR/SR High School,561025,112561025,210561002475,OVEC,906,08,46,49,1,0,1,0,0,0,0,0,0,1,1,2,0,0,0,0,0,0,47,45,92,95
20192020,112,TRIMBLE,561,Trimble County,025,Trimble County JR/SR High School,561025,112561025,210561002475,OVEC,906,09,59,56,1,0,1,0,0,0,0,0,0,4,1,5,0,0,0,0,1,1,51,57,108,115
20192020,112,TRIMBLE,561,Trimble County,025,Trimble County JR/SR High School,561025,112561025,210561002475,OVEC,906,10,36,42,0,1,1,0,0,0,0,0,0,0,0,0,0,1,1,2,0,2,40,34,74,78
20192020,112,TRIMBLE,561,Trimble County,025,Trimble County JR/SR High School,561025,112561025,210561002475,OVEC,906,11,36,37,0,0,0,0,0,0,0,0,0,1,1,2,0,1,1,0,1,1,36,33,69,73
20192020,112,TRIMBLE,561,Trimble County,025,Trimble County JR/SR High School,561025,112561025,210561002475,OVEC,906,12,33,41,0,0,0,0,0,0,0,0,0,0,3,3,0,0,0,1,1,2,40,29,69,74
20192020,112,TRIMBLE,561,Trimble County,035,Trimble County Alternative Program,561035,112561035,210561002464,OVEC,906,All Students,0,0,0,0,0,0,0,0,0,0,0,0,0,0,0,0,0,0,0,0,0,0,0,0
20192020,112,TRIMBLE,561,Trimble County,035,Trimble County Alternative Program,561035,112561035,210561002464,OVEC,906,07,0,0,0,0,0,0,0,0,0,0,0,0,0,0,0,0,0,0,0,0,0,0,0,0
20192020,112,TRIMBLE,561,Trimble County,035,Trimble County Alternative Program,561035,112561035,210561002464,OVEC,906,08,0,0,0,0,0,0,0,0,0,0,0,0,0,0,0,0,0,0,0,0,0,0,0,0
20192020,112,TRIMBLE,561,Trimble County,035,Trimble County Alternative Program,561035,112561035,210561002464,OVEC,906,09,0,0,0,0,0,0,0,0,0,0,0,0,0,0,0,0,0,0,0,0,0,0,0,0
20192020,112,TRIMBLE,561,Trimble County,035,Trimble County Alternative Program,561035,112561035,210561002464,OVEC,906,10,0,0,0,0,0,0,0,0,0,0,0,0,0,0,0,0,0,0,0,0,0,0,0,0
20192020,112,TRIMBLE,561,Trimble County,035,Trimble County Alternative Program,561035,112561035,210561002464,OVEC,906,11,0,0,0,0,0,0,0,0,0,0,0,0,0,0,0,0,0,0,0,0,0,0,0,0
20192020,112,TRIMBLE,561,Trimble County,035,Trimble County Alternative Program,561035,112561035,210561002464,OVEC,906,12,0,0,0,0,0,0,0,0,0,0,0,0,0,0,0,0,0,0,0,0,0,0,0,0
20192020,113,UNION,565,Union County,"",---District Total---,565,"","",WKEC,908,All Students,964,1040,67,59,126,0,2,2,4,2,6,20,9,29,0,0,0,50,56,106,899,836,1735,2004
20192020,113,UNION,565,Union County,"",---District Total---,565,"","",WKEC,908,PS,55,63,5,6,11,0,0,0,0,0,0,5,0,5,0,0,0,10,6,16,43,43,86,118
20192020,113,UNION,565,Union County,"",---District Total---,565,"","",WKEC,908,KG,74,88,9,3,12,0,0,0,0,0,0,3,0,3,0,0,0,6,6,12,70,65,135,162
20192020,113,UNION,565,Union County,"",---District Total---,565,"","",WKEC,908,01,79,98,2,4,6,0,0,0,0,0,0,1,0,1,0,0,0,4,3,7,91,72,163,177
20192020,113,UNION,565,Union County,"",---District Total---,565,"","",WKEC,908,02,61,70,8,2,10,0,0,0,0,0,0,2,0,2,0,0,0,4,5,9,56,54,110,131
20192020,113,UNION,565,Union County,"",---District Total---,565,"","",WKEC,908,03,63,79,5,6,11,0,0,0,0,0,0,3,0,3,0,0,0,6,2,8,65,55,120,142
20192020,113,UNION,565,Union County,"",---District Total---,565,"","",WKEC,908,04,58,91,9,1,10,0,0,0,1,0,1,0,3,3,0,0,0,6,2,8,75,52,127,149
20192020,113,UNION,565,Union County,"",---District Total---,565,"","",WKEC,908,05,74,78,1,3,4,0,1,1,0,0,0,1,1,2,0,0,0,4,7,11,72,62,134,152
20192020,113,UNION,565,Union County,"",---District Total---,565,"","",WKEC,908,06,73,77,6,7,13,0,0,0,0,0,0,1,0,1,0,0,0,3,7,10,67,59,126,150
20192020,113,UNION,565,Union County,"",---District Total---,565,"","",WKEC,908,07,73,97,2,2,4,0,0,0,0,0,0,2,0,2,0,0,0,7,4,11,86,67,153,170
20192020,113,UNION,565,Union County,"",---District Total---,565,"","",WKEC,908,08,94,70,2,5,7,0,0,0,0,0,0,1,0,1,0,0,0,3,5,8,64,84,148,164
20192020,113,UNION,565,Union County,"",---District Total---,565,"","",WKEC,908,09,58,80,5,4,9,0,0,0,0,1,1,2,0,2,0,0,0,2,3,5,71,50,121,138
20192020,113,UNION,565,Union County,"",---District Total---,565,"","",WKEC,908,10,87,66,4,8,12,0,0,0,2,0,2,0,5,5,0,0,0,1,4,5,59,70,129,153
20192020,113,UNION,565,Union County,"",---District Total---,565,"","",WKEC,908,11,77,68,7,3,10,0,0,0,0,1,1,4,0,4,0,0,0,1,3,4,56,70,126,145
20192020,113,UNION,565,Union County,"",---District Total---,565,"","",WKEC,908,12,92,76,6,11,17,0,1,1,1,0,1,0,0,0,0,0,0,3,5,8,66,75,141,168
20192020,113,UNION,565,Union County,"",---District Total---,565,"","",WKEC,908,14,1,2,1,0,1,0,0,0,0,0,0,0,0,0,0,0,0,0,0,0,1,1,2,3
20192020,113,UNION,565,Union County,015,Union County Preschool and Headstart,565015,113565015,210564002447,WKEC,908,All Students,0,0,0,0,0,0,0,0,0,0,0,0,0,0,0,0,0,0,0,0,0,0,0,0
20192020,113,UNION,565,Union County,015,Union County Preschool and Headstart,565015,113565015,210564002447,WKEC,908,PS,55,63,5,6,11,0,0,0,0,0,0,5,0,5,0,0,0,10,6,16,43,43,86,118
20192020,113,UNION,565,Union County,020,Morganfield Elementary School,565020,113565020,210564001334,WKEC,908,All Students,163,203,25,14,39,0,0,0,0,0,0,6,3,9,0,0,0,19,16,35,153,130,283,366
20192020,113,UNION,565,Union County,020,Morganfield Elementary School,565020,113565020,210564001334,WKEC,908,KG,31,37,6,2,8,0,0,0,0,0,0,2,0,2,0,0,0,4,4,8,25,25,50,68
20192020,113,UNION,565,Union County,020,Morganfield Elementary School,565020,113565020,210564001334,WKEC,908,01,27,37,2,2,4,0,0,0,0,0,0,0,0,0,0,0,0,3,0,3,32,25,57,64
20192020,113,UNION,565,Union County,020,Morganfield Elementary School,565020,113565020,210564001334,WKEC,908,02,18,30,5,1,6,0,0,0,0,0,0,1,0,1,0,0,0,3,3,6,21,14,35,48
20192020,113,UNION,565,Union County,020,Morganfield Elementary School,565020,113565020,210564001334,WKEC,908,03,26,26,3,5,8,0,0,0,0,0,0,3,0,3,0,0,0,2,2,4,18,19,37,52
20192020,113,UNION,565,Union County,020,Morganfield Elementary School,565020,113565020,210564001334,WKEC,908,04,24,45,8,1,9,0,0,0,0,0,0,0,2,2,0,0,0,6,1,7,31,20,51,69
20192020,113,UNION,565,Union County,020,Morganfield Elementary School,565020,113565020,210564001334,WKEC,908,05,37,28,1,3,4,0,0,0,0,0,0,0,1,1,0,0,0,1,6,7,26,27,53,65
20192020,113,UNION,565,Union County,021,Union County Learning Academy,565021,113565021,210564001872,WKEC,908,All Students,8,19,1,1,2,0,0,0,0,0,0,1,0,1,0,0,0,1,2,3,16,5,21,27
20192020,113,UNION,565,Union County,021,Union County Learning Academy,565021,113565021,210564001872,WKEC,908,08,2,4,0,0,0,0,0,0,0,0,0,0,0,0,0,0,0,0,0,0,4,2,6,6
20192020,113,UNION,565,Union County,021,Union County Learning Academy,565021,113565021,210564001872,WKEC,908,09,1,3,0,0,0,0,0,0,0,0,0,1,0,1,0,0,0,0,0,0,2,1,3,4
20192020,113,UNION,565,Union County,021,Union County Learning Academy,565021,113565021,210564001872,WKEC,908,10,1,3,0,0,0,0,0,0,0,0,0,0,0,0,0,0,0,0,0,0,3,1,4,4
20192020,113,UNION,565,Union County,021,Union County Learning Academy,565021,113565021,210564001872,WKEC,908,11,0,1,1,0,1,0,0,0,0,0,0,0,0,0,0,0,0,0,0,0,0,0,0,1
20192020,113,UNION,565,Union County,021,Union County Learning Academy,565021,113565021,210564001872,WKEC,908,12,4,8,0,1,1,0,0,0,0,0,0,0,0,0,0,0,0,1,2,3,7,1,8,12
20192020,113,UNION,565,Union County,050,Sturgis Elementary School,565050,113565050,210564001336,WKEC,908,All Students,167,190,3,4,7,0,0,0,0,0,0,1,0,1,0,0,0,4,5,9,182,158,340,357
20192020,113,UNION,565,Union County,050,Sturgis Elementary School,565050,113565050,210564001336,WKEC,908,KG,29,30,1,0,1,0,0,0,0,0,0,0,0,0,0,0,0,1,0,1,28,29,57,59
20192020,113,UNION,565,Union County,050,Sturgis Elementary School,565050,113565050,210564001336,WKEC,908,01,38,39,0,2,2,0,0,0,0,0,0,1,0,1,0,0,0,0,1,1,38,35,73,77
20192020,113,UNION,565,Union County,050,Sturgis Elementary School,565050,113565050,210564001336,WKEC,908,02,30,22,1,1,2,0,0,0,0,0,0,0,0,0,0,0,0,0,2,2,21,27,48,52
20192020,113,UNION,565,Union County,050,Sturgis Elementary School,565050,113565050,210564001336,WKEC,908,03,27,40,1,1,2,0,0,0,0,0,0,0,0,0,0,0,0,1,0,1,38,26,64,67
20192020,113,UNION,565,Union County,050,Sturgis Elementary School,565050,113565050,210564001336,WKEC,908,04,23,28,0,0,0,0,0,0,0,0,0,0,0,0,0,0,0,0,1,1,28,22,50,51
20192020,113,UNION,565,Union County,050,Sturgis Elementary School,565050,113565050,210564001336,WKEC,908,05,20,31,0,0,0,0,0,0,0,0,0,0,0,0,0,0,0,2,1,3,29,19,48,51
20192020,113,UNION,565,Union County,055,Union County Middle School,565055,113565055,210564001602,WKEC,908,All Students,228,234,10,14,24,0,0,0,0,0,0,4,0,4,0,0,0,13,14,27,207,200,407,462
20192020,113,UNION,565,Union County,055,Union County Middle School,565055,113565055,210564001602,WKEC,908,06,73,77,6,7,13,0,0,0,0,0,0,1,0,1,0,0,0,3,7,10,67,59,126,150
20192020,113,UNION,565,Union County,055,Union County Middle School,565055,113565055,210564001602,WKEC,908,07,73,97,2,2,4,0,0,0,0,0,0,2,0,2,0,0,0,7,4,11,86,67,153,170
20192020,113,UNION,565,Union County,055,Union County Middle School,565055,113565055,210564001602,WKEC,908,08,82,60,2,5,7,0,0,0,0,0,0,1,0,1,0,0,0,3,3,6,54,74,128,142
20192020,113,UNION,565,Union County,065,Union County High School,565065,113565065,210564001338,WKEC,908,All Students,319,283,22,25,47,0,1,1,3,2,5,5,5,10,0,0,0,6,15,21,247,271,518,602
20192020,113,UNION,565,Union County,065,Union County High School,565065,113565065,210564001338,WKEC,908,08,10,6,0,0,0,0,0,0,0,0,0,0,0,0,0,0,0,0,2,2,6,8,14,16
20192020,113,UNION,565,Union County,065,Union County High School,565065,113565065,210564001338,WKEC,908,09,57,77,5,4,9,0,0,0,0,1,1,1,0,1,0,0,0,2,3,5,69,49,118,134
20192020,113,UNION,565,Union County,065,Union County High School,565065,113565065,210564001338,WKEC,908,10,86,63,4,8,12,0,0,0,2,0,2,0,5,5,0,0,0,1,4,5,56,69,125,149
20192020,113,UNION,565,Union County,065,Union County High School,565065,113565065,210564001338,WKEC,908,11,77,67,6,3,9,0,0,0,0,1,1,4,0,4,0,0,0,1,3,4,56,70,126,144
20192020,113,UNION,565,Union County,065,Union County High School,565065,113565065,210564001338,WKEC,908,12,88,68,6,10,16,0,1,1,1,0,1,0,0,0,0,0,0,2,3,5,59,74,133,156
20192020,113,UNION,565,Union County,065,Union County High School,565065,113565065,210564001338,WKEC,908,14,1,2,1,0,1,0,0,0,0,0,0,0,0,0,0,0,0,0,0,0,1,1,2,3
20192020,113,UNION,565,Union County,070,Uniontown Elementary School,565070,113565070,210564001339,WKEC,908,All Students,79,111,6,1,7,0,1,1,1,0,1,3,1,4,0,0,0,7,4,11,94,72,166,190
20192020,113,UNION,565,Union County,070,Uniontown Elementary School,565070,113565070,210564001339,WKEC,908,KG,14,21,2,1,3,0,0,0,0,0,0,1,0,1,0,0,0,1,2,3,17,11,28,35
20192020,113,UNION,565,Union County,070,Uniontown Elementary School,565070,113565070,210564001339,WKEC,908,01,14,22,0,0,0,0,0,0,0,0,0,0,0,0,0,0,0,1,2,3,21,12,33,36
20192020,113,UNION,565,Union County,070,Uniontown Elementary School,565070,113565070,210564001339,WKEC,908,02,13,18,2,0,2,0,0,0,0,0,0,1,0,1,0,0,0,1,0,1,14,13,27,31
20192020,113,UNION,565,Union County,070,Uniontown Elementary School,565070,113565070,210564001339,WKEC,908,03,10,13,1,0,1,0,0,0,0,0,0,0,0,0,0,0,0,3,0,3,9,10,19,23
20192020,113,UNION,565,Union County,070,Uniontown Elementary School,565070,113565070,210564001339,WKEC,908,04,11,18,1,0,1,0,0,0,1,0,1,0,1,1,0,0,0,0,0,0,16,10,26,29
20192020,113,UNION,565,Union County,070,Uniontown Elementary School,565070,113565070,210564001339,WKEC,908,05,17,19,0,0,0,0,1,1,0,0,0,1,0,1,0,0,0,1,0,1,17,16,33,36
20192020,113,UNION,565,Union County,902,Union County Area Vocational Ed Center,565902,113565902,210564002175,WKEC,908,All Students,0,0,0,0,0,0,0,0,0,0,0,0,0,0,0,0,0,0,0,0,0,0,0,0
20192020,113,UNION,565,Union County,902,Union County Area Vocational Ed Center,565902,113565902,210564002175,WKEC,908,09,0,0,0,0,0,0,0,0,0,0,0,0,0,0,0,0,0,0,0,0,0,0,0,0
20192020,113,UNION,565,Union County,902,Union County Area Vocational Ed Center,565902,113565902,210564002175,WKEC,908,10,0,0,0,0,0,0,0,0,0,0,0,0,0,0,0,0,0,0,0,0,0,0,0,0
20192020,113,UNION,565,Union County,902,Union County Area Vocational Ed Center,565902,113565902,210564002175,WKEC,908,11,0,0,0,0,0,0,0,0,0,0,0,0,0,0,0,0,0,0,0,0,0,0,0,0
20192020,113,UNION,565,Union County,902,Union County Area Vocational Ed Center,565902,113565902,210564002175,WKEC,908,12,0,0,0,0,0,0,0,0,0,0,0,0,0,0,0,0,0,0,0,0,0,0,0,0
20192020,008,BOONE,567,Walton-Verona Independent,"",---District Total---,567,"","",NKCES,905,All Students,888,866,12,6,18,0,0,0,10,17,27,19,24,43,3,0,3,23,21,44,799,820,1619,1754
20192020,008,BOONE,567,Walton-Verona Independent,"",---District Total---,567,"","",NKCES,905,PS,60,55,0,1,1,0,0,0,1,1,2,1,3,4,0,0,0,2,2,4,51,53,104,115
20192020,008,BOONE,567,Walton-Verona Independent,"",---District Total---,567,"","",NKCES,905,KG,71,66,4,1,5,0,0,0,0,1,1,1,3,4,0,0,0,2,1,3,59,65,124,137
20192020,008,BOONE,567,Walton-Verona Independent,"",---District Total---,567,"","",NKCES,905,01,69,72,0,0,0,0,0,0,2,0,2,2,2,4,1,0,1,5,3,8,62,64,126,141
20192020,008,BOONE,567,Walton-Verona Independent,"",---District Total---,567,"","",NKCES,905,02,63,63,0,1,1,0,0,0,0,2,2,5,3,8,0,0,0,2,1,3,56,56,112,126
20192020,008,BOONE,567,Walton-Verona Independent,"",---District Total---,567,"","",NKCES,905,03,57,60,1,0,1,0,0,0,1,0,1,1,2,3,0,0,0,0,1,1,57,54,111,117
20192020,008,BOONE,567,Walton-Verona Independent,"",---District Total---,567,"","",NKCES,905,04,70,69,0,1,1,0,0,0,0,1,1,0,3,3,0,0,0,0,4,4,69,61,130,139
20192020,008,BOONE,567,Walton-Verona Independent,"",---District Total---,567,"","",NKCES,905,05,81,52,1,1,2,0,0,0,0,1,1,3,2,5,0,0,0,2,2,4,46,75,121,133
20192020,008,BOONE,567,Walton-Verona Independent,"",---District Total---,567,"","",NKCES,905,06,69,52,0,0,0,0,0,0,1,0,1,2,2,4,0,0,0,0,4,4,49,63,112,121
20192020,008,BOONE,567,Walton-Verona Independent,"",---District Total---,567,"","",NKCES,905,07,67,70,1,0,1,0,0,0,1,2,3,2,2,4,1,0,1,1,1,2,64,62,126,137
20192020,008,BOONE,567,Walton-Verona Independent,"",---District Total---,567,"","",NKCES,905,08,68,88,3,1,4,0,0,0,0,1,1,2,2,4,1,0,1,3,2,5,79,62,141,156
20192020,008,BOONE,567,Walton-Verona Independent,"",---District Total---,567,"","",NKCES,905,09,50,75,0,0,0,0,0,0,1,2,3,1,1,2,0,0,0,1,1,2,72,46,118,125
20192020,008,BOONE,567,Walton-Verona Independent,"",---District Total---,567,"","",NKCES,905,10,80,68,1,1,2,0,0,0,2,2,4,0,1,1,0,0,0,3,1,4,62,75,137,148
20192020,008,BOONE,567,Walton-Verona Independent,"",---District Total---,567,"","",NKCES,905,11,68,66,0,0,0,0,0,0,1,2,3,0,1,1,0,0,0,3,0,3,62,65,127,134
20192020,008,BOONE,567,Walton-Verona Independent,"",---District Total---,567,"","",NKCES,905,12,73,65,1,0,1,0,0,0,1,3,4,0,0,0,0,0,0,1,0,1,62,70,132,138
20192020,008,BOONE,567,Walton-Verona Independent,"",---District Total---,567,"","",NKCES,905,14,2,0,0,0,0,0,0,0,0,0,0,0,0,0,0,0,0,0,0,0,0,2,2,2
20192020,008,BOONE,567,Walton-Verona Independent,010,Walton-Verona Elementary School,567010,008567010,210570001341,NKCES,905,All Students,330,330,5,3,8,0,0,0,3,4,7,9,13,22,1,0,1,9,10,19,303,300,603,660
20192020,008,BOONE,567,Walton-Verona Independent,010,Walton-Verona Elementary School,567010,008567010,210570001341,NKCES,905,KG,71,66,4,1,5,0,0,0,0,1,1,1,3,4,0,0,0,2,1,3,59,65,124,137
20192020,008,BOONE,567,Walton-Verona Independent,010,Walton-Verona Elementary School,567010,008567010,210570001341,NKCES,905,01,69,72,0,0,0,0,0,0,2,0,2,2,2,4,1,0,1,5,3,8,62,64,126,141
20192020,008,BOONE,567,Walton-Verona Independent,010,Walton-Verona Elementary School,567010,008567010,210570001341,NKCES,905,02,63,63,0,1,1,0,0,0,0,2,2,5,3,8,0,0,0,2,1,3,56,56,112,126
20192020,008,BOONE,567,Walton-Verona Independent,010,Walton-Verona Elementary School,567010,008567010,210570001341,NKCES,905,03,57,60,1,0,1,0,0,0,1,0,1,1,2,3,0,0,0,0,1,1,57,54,111,117
20192020,008,BOONE,567,Walton-Verona Independent,010,Walton-Verona Elementary School,567010,008567010,210570001341,NKCES,905,04,70,69,0,1,1,0,0,0,0,1,1,0,3,3,0,0,0,0,4,4,69,61,130,139
20192020,008,BOONE,567,Walton-Verona Independent,015,Walton-Verona Middle School,567015,008567015,210570002191,NKCES,905,All Students,285,262,5,2,7,0,0,0,2,4,6,9,8,17,2,0,2,6,9,15,238,262,500,547
20192020,008,BOONE,567,Walton-Verona Independent,015,Walton-Verona Middle School,567015,008567015,210570002191,NKCES,905,05,81,52,1,1,2,0,0,0,0,1,1,3,2,5,0,0,0,2,2,4,46,75,121,133
20192020,008,BOONE,567,Walton-Verona Independent,015,Walton-Verona Middle School,567015,008567015,210570002191,NKCES,905,06,69,52,0,0,0,0,0,0,1,0,1,2,2,4,0,0,0,0,4,4,49,63,112,121
20192020,008,BOONE,567,Walton-Verona Independent,015,Walton-Verona Middle School,567015,008567015,210570002191,NKCES,905,07,67,70,1,0,1,0,0,0,1,2,3,2,2,4,1,0,1,1,1,2,64,62,126,137
20192020,008,BOONE,567,Walton-Verona Independent,015,Walton-Verona Middle School,567015,008567015,210570002191,NKCES,905,08,68,88,3,1,4,0,0,0,0,1,1,2,2,4,1,0,1,3,2,5,79,62,141,156
20192020,008,BOONE,567,Walton-Verona Independent,020,Walton-Verona High School,567020,008567020,210570001342,NKCES,905,All Students,273,274,2,1,3,0,0,0,5,9,14,1,3,4,0,0,0,8,2,10,258,258,516,547
20192020,008,BOONE,567,Walton-Verona Independent,020,Walton-Verona High School,567020,008567020,210570001342,NKCES,905,09,50,75,0,0,0,0,0,0,1,2,3,1,1,2,0,0,0,1,1,2,72,46,118,125
20192020,008,BOONE,567,Walton-Verona Independent,020,Walton-Verona High School,567020,008567020,210570001342,NKCES,905,10,80,68,1,1,2,0,0,0,2,2,4,0,1,1,0,0,0,3,1,4,62,75,137,148
20192020,008,BOONE,567,Walton-Verona Independent,020,Walton-Verona High School,567020,008567020,210570001342,NKCES,905,11,68,66,0,0,0,0,0,0,1,2,3,0,1,1,0,0,0,3,0,3,62,65,127,134
20192020,008,BOONE,567,Walton-Verona Independent,020,Walton-Verona High School,567020,008567020,210570001342,NKCES,905,12,73,65,1,0,1,0,0,0,1,3,4,0,0,0,0,0,0,1,0,1,62,70,132,138
20192020,008,BOONE,567,Walton-Verona Independent,020,Walton-Verona High School,567020,008567020,210570001342,NKCES,905,14,2,0,0,0,0,0,0,0,0,0,0,0,0,0,0,0,0,0,0,0,0,2,2,2
20192020,008,BOONE,567,Walton-Verona Independent,025,Walton - Verona Early Childhood Center,567025,008567025,210570002488,NKCES,905,All Students,0,0,0,0,0,0,0,0,0,0,0,0,0,0,0,0,0,0,0,0,0,0,0,0
20192020,008,BOONE,567,Walton-Verona Independent,025,Walton - Verona Early Childhood Center,567025,008567025,210570002488,NKCES,905,PS,60,55,0,1,1,0,0,0,1,1,2,1,3,4,0,0,0,2,2,4,51,53,104,115
20192020,114,WARREN,571,Warren County,"",---District Total---,571,"","",GRREC,902,All Students,8018,8377,861,826,1687,9,8,17,771,735,1506,873,790,1663,70,61,131,393,396,789,5400,5202,10602,16395
20192020,114,WARREN,571,Warren County,"",---District Total---,571,"","",GRREC,902,PS,393,439,51,36,87,0,0,0,48,70,118,60,62,122,1,1,2,23,17,40,256,207,463,832
20192020,114,WARREN,571,Warren County,"",---District Total---,571,"","",GRREC,902,KG,655,660,64,56,120,0,0,0,69,68,137,73,90,163,11,7,18,39,39,78,404,395,799,1315
20192020,114,WARREN,571,Warren County,"",---District Total---,571,"","",GRREC,902,01,631,671,61,59,120,2,0,2,61,71,132,62,64,126,6,7,13,32,33,65,447,397,844,1302
20192020,114,WARREN,571,Warren County,"",---District Total---,571,"","",GRREC,902,02,550,605,67,56,123,1,0,1,79,61,140,59,65,124,9,3,12,24,24,48,366,341,707,1155
20192020,114,WARREN,571,Warren County,"",---District Total---,571,"","",GRREC,902,03,637,652,74,49,123,0,2,2,66,58,124,61,56,117,6,6,12,31,37,68,414,429,843,1289
20192020,114,WARREN,571,Warren County,"",---District Total---,571,"","",GRREC,902,04,622,628,74,65,139,0,0,0,64,57,121,61,48,109,3,8,11,27,32,59,399,412,811,1250
20192020,114,WARREN,571,Warren County,"",---District Total---,571,"","",GRREC,902,05,607,613,64,68,132,1,0,1,44,44,88,64,74,138,4,4,8,39,39,78,397,378,775,1220
20192020,114,WARREN,571,Warren County,"",---District Total---,571,"","",GRREC,902,06,641,643,63,84,147,1,1,2,57,57,114,78,75,153,7,5,12,36,26,62,401,393,794,1284
20192020,114,WARREN,571,Warren County,"",---District Total---,571,"","",GRREC,902,07,615,647,58,58,116,0,1,1,38,55,93,65,47,112,5,3,8,29,34,63,452,417,869,1262
20192020,114,WARREN,571,Warren County,"",---District Total---,571,"","",GRREC,902,08,636,683,67,65,132,1,2,3,60,52,112,69,59,128,1,5,6,34,36,70,451,417,868,1319
20192020,114,WARREN,571,Warren County,"",---District Total---,571,"","",GRREC,902,09,672,729,83,81,164,3,1,4,65,61,126,90,67,157,9,4,13,26,24,50,453,434,887,1401
20192020,114,WARREN,571,Warren County,"",---District Total---,571,"","",GRREC,902,10,594,677,61,71,132,0,0,0,69,40,109,73,48,121,3,4,7,25,25,50,446,406,852,1271
20192020,114,WARREN,571,Warren County,"",---District Total---,571,"","",GRREC,902,11,543,538,53,64,117,0,0,0,42,56,98,64,47,111,5,0,5,21,20,41,353,356,709,1081
20192020,114,WARREN,571,Warren County,"",---District Total---,571,"","",GRREC,902,12,614,629,72,50,122,0,1,1,56,55,111,54,50,104,1,5,6,30,27,57,416,426,842,1243
20192020,114,WARREN,571,Warren County,"",---District Total---,571,"","",GRREC,902,14,1,2,0,0,0,0,0,0,1,0,1,0,0,0,0,0,0,0,0,0,1,1,2,3
20192020,114,WARREN,571,Warren County,001,Carol Martin Gatton Academy of Math & Science,571001,114571001,"",GRREC,902,All Students,0,0,0,0,0,0,0,0,0,0,0,0,0,0,0,0,0,0,0,0,0,0,0,0
20192020,114,WARREN,571,Warren County,001,Carol Martin Gatton Academy of Math & Science,571001,114571001,"",GRREC,902,09,0,0,0,0,0,0,0,0,0,0,0,0,0,0,0,0,0,0,0,0,0,0,0,0
20192020,114,WARREN,571,Warren County,001,Carol Martin Gatton Academy of Math & Science,571001,114571001,"",GRREC,902,10,0,0,0,0,0,0,0,0,0,0,0,0,0,0,0,0,0,0,0,0,0,0,0,0
20192020,114,WARREN,571,Warren County,001,Carol Martin Gatton Academy of Math & Science,571001,114571001,"",GRREC,902,11,0,0,0,0,0,0,0,0,0,0,0,0,0,0,0,0,0,0,0,0,0,0,0,0
20192020,114,WARREN,571,Warren County,001,Carol Martin Gatton Academy of Math & Science,571001,114571001,"",GRREC,902,12,0,0,0,0,0,0,0,0,0,0,0,0,0,0,0,0,0,0,0,0,0,0,0,0
20192020,114,WARREN,571,Warren County,002,South Warren Middle School,571002,114571002,210573002298,GRREC,902,All Students,368,370,16,11,27,1,1,2,18,25,43,22,19,41,0,0,0,11,18,29,302,294,596,738
20192020,114,WARREN,571,Warren County,002,South Warren Middle School,571002,114571002,210573002298,GRREC,902,07,181,175,6,5,11,0,0,0,2,13,15,10,10,20,0,0,0,4,10,14,153,143,296,356
20192020,114,WARREN,571,Warren County,002,South Warren Middle School,571002,114571002,210573002298,GRREC,902,08,187,195,10,6,16,1,1,2,16,12,28,12,9,21,0,0,0,7,8,15,149,151,300,382
20192020,114,WARREN,571,Warren County,003,South Warren High School,571003,114571003,210573002277,GRREC,902,All Students,664,710,32,27,59,0,0,0,51,42,93,38,39,77,1,0,1,23,19,42,565,537,1102,1374
20192020,114,WARREN,571,Warren County,003,South Warren High School,571003,114571003,210573002277,GRREC,902,08,1,2,0,0,0,0,0,0,0,0,0,0,0,0,0,0,0,0,0,0,2,1,3,3
20192020,114,WARREN,571,Warren County,003,South Warren High School,571003,114571003,210573002277,GRREC,902,09,197,194,5,11,16,0,0,0,15,14,29,7,13,20,1,0,1,5,4,9,161,155,316,391
20192020,114,WARREN,571,Warren County,003,South Warren High School,571003,114571003,210573002277,GRREC,902,10,154,203,8,6,14,0,0,0,16,5,21,10,7,17,0,0,0,8,2,10,161,134,295,357
20192020,114,WARREN,571,Warren County,003,South Warren High School,571003,114571003,210573002277,GRREC,902,11,157,167,8,7,15,0,0,0,12,14,26,14,10,24,0,0,0,7,7,14,126,119,245,324
20192020,114,WARREN,571,Warren County,003,South Warren High School,571003,114571003,210573002277,GRREC,902,12,154,144,11,3,14,0,0,0,8,9,17,7,9,16,0,0,0,3,6,9,115,127,242,298
20192020,114,WARREN,571,Warren County,003,South Warren High School,571003,114571003,210573002277,GRREC,902,14,1,0,0,0,0,0,0,0,0,0,0,0,0,0,0,0,0,0,0,0,0,1,1,1
20192020,114,WARREN,571,Warren County,005,Jackson Academy Elementary,571005,114571005,210573002469,GRREC,902,05,0,1,0,0,0,0,0,0,0,0,0,0,0,0,0,0,0,0,0,0,1,0,1,1
20192020,114,WARREN,571,Warren County,005,Jackson Academy Elementary,571005,114571005,210573002469,GRREC,902,All Students,0,1,0,0,0,0,0,0,0,0,0,0,0,0,0,0,0,0,0,0,1,0,1,1
20192020,114,WARREN,571,Warren County,010,Alvaton Elementary,571010,114571010,210573001343,GRREC,902,KG,55,47,3,3,6,0,0,0,7,9,16,3,6,9,1,2,3,2,2,4,31,33,64,102
20192020,114,WARREN,571,Warren County,010,Alvaton Elementary,571010,114571010,210573001343,GRREC,902,01,53,57,3,5,8,0,0,0,3,5,8,3,2,5,2,1,3,3,1,4,43,39,82,110
20192020,114,WARREN,571,Warren County,010,Alvaton Elementary,571010,114571010,210573001343,GRREC,902,02,48,43,0,2,2,1,0,1,8,6,14,2,2,4,2,0,2,1,2,3,29,36,65,91
20192020,114,WARREN,571,Warren County,010,Alvaton Elementary,571010,114571010,210573001343,GRREC,902,03,49,56,2,2,4,0,0,0,8,5,13,1,2,3,0,0,0,3,5,8,42,35,77,105
20192020,114,WARREN,571,Warren County,010,Alvaton Elementary,571010,114571010,210573001343,GRREC,902,04,45,57,4,3,7,0,0,0,8,2,10,1,3,4,1,0,1,2,1,3,41,36,77,102
20192020,114,WARREN,571,Warren County,010,Alvaton Elementary,571010,114571010,210573001343,GRREC,902,05,44,44,4,1,5,0,0,0,4,4,8,1,3,4,0,0,0,1,7,8,34,29,63,88
20192020,114,WARREN,571,Warren County,010,Alvaton Elementary,571010,114571010,210573001343,GRREC,902,06,48,52,5,4,9,0,0,0,7,6,13,3,4,7,2,1,3,5,2,7,30,31,61,100
20192020,114,WARREN,571,Warren County,010,Alvaton Elementary,571010,114571010,210573001343,GRREC,902,PS,32,36,3,0,3,0,0,0,4,6,10,4,5,9,0,0,0,1,0,1,24,21,45,68
20192020,114,WARREN,571,Warren County,010,Alvaton Elementary,571010,114571010,210573001343,GRREC,902,All Students,342,356,21,20,41,1,0,1,45,37,82,14,22,36,8,4,12,17,20,37,250,239,489,698
20192020,114,WARREN,571,Warren County,012,Jackson Academy Middle School,571012,114571012,210573001831,GRREC,902,All Students,0,5,0,0,0,0,0,0,0,0,0,1,0,1,0,0,0,1,0,1,3,0,3,5
20192020,114,WARREN,571,Warren County,012,Jackson Academy Middle School,571012,114571012,210573001831,GRREC,902,06,0,2,0,0,0,0,0,0,0,0,0,1,0,1,0,0,0,0,0,0,1,0,1,2
20192020,114,WARREN,571,Warren County,012,Jackson Academy Middle School,571012,114571012,210573001831,GRREC,902,07,0,1,0,0,0,0,0,0,0,0,0,0,0,0,0,0,0,1,0,1,0,0,0,1
20192020,114,WARREN,571,Warren County,012,Jackson Academy Middle School,571012,114571012,210573001831,GRREC,902,08,0,2,0,0,0,0,0,0,0,0,0,0,0,0,0,0,0,0,0,0,2,0,2,2
20192020,114,WARREN,571,Warren County,015,Briarwood Elementary School,571015,114571015,210573001909,GRREC,902,KG,51,52,6,5,11,0,0,0,9,12,21,7,3,10,3,0,3,2,4,6,25,27,52,103
20192020,114,WARREN,571,Warren County,015,Briarwood Elementary School,571015,114571015,210573001909,GRREC,902,All Students,333,366,37,29,66,0,0,0,74,65,139,25,26,51,7,3,10,9,15,24,214,195,409,699
20192020,114,WARREN,571,Warren County,015,Briarwood Elementary School,571015,114571015,210573001909,GRREC,902,PS,33,36,3,6,9,0,0,0,8,4,12,6,6,12,0,0,0,1,0,1,18,17,35,69
20192020,114,WARREN,571,Warren County,015,Briarwood Elementary School,571015,114571015,210573001909,GRREC,902,01,51,51,4,3,7,0,0,0,11,15,26,5,2,7,1,1,2,0,1,1,30,29,59,102
20192020,114,WARREN,571,Warren County,015,Briarwood Elementary School,571015,114571015,210573001909,GRREC,902,02,49,53,6,7,13,0,0,0,9,10,19,3,4,7,1,0,1,2,1,3,32,27,59,102
20192020,114,WARREN,571,Warren County,015,Briarwood Elementary School,571015,114571015,210573001909,GRREC,902,03,39,61,9,2,11,0,0,0,18,8,26,3,2,5,1,0,1,3,2,5,27,25,52,100
20192020,114,WARREN,571,Warren County,015,Briarwood Elementary School,571015,114571015,210573001909,GRREC,902,04,43,48,3,4,7,0,0,0,8,6,14,4,4,8,1,1,2,0,2,2,32,26,58,91
20192020,114,WARREN,571,Warren County,015,Briarwood Elementary School,571015,114571015,210573001909,GRREC,902,05,46,42,5,3,8,0,0,0,12,5,17,0,5,5,0,1,1,2,4,6,23,28,51,88
20192020,114,WARREN,571,Warren County,015,Briarwood Elementary School,571015,114571015,210573001909,GRREC,902,06,54,59,4,5,9,0,0,0,7,9,16,3,6,9,0,0,0,0,1,1,45,33,78,113
20192020,114,WARREN,571,Warren County,016,Lighthouse Academy,571016,114571016,210573001926,GRREC,902,All Students,69,94,10,10,20,0,0,0,2,0,2,11,5,16,0,0,0,7,6,13,64,48,112,163
20192020,114,WARREN,571,Warren County,016,Lighthouse Academy,571016,114571016,210573001926,GRREC,902,10,3,2,0,1,1,0,0,0,0,0,0,2,0,2,0,0,0,0,1,1,0,1,1,5
20192020,114,WARREN,571,Warren County,016,Lighthouse Academy,571016,114571016,210573001926,GRREC,902,11,1,1,0,1,1,0,0,0,0,0,0,0,0,0,0,0,0,0,0,0,1,0,1,2
20192020,114,WARREN,571,Warren County,016,Lighthouse Academy,571016,114571016,210573001926,GRREC,902,12,65,91,10,8,18,0,0,0,2,0,2,9,5,14,0,0,0,7,5,12,63,47,110,156
20192020,114,WARREN,571,Warren County,018,Plano Elementary,571018,114571018,210573002035,GRREC,902,All Students,270,319,6,7,13,0,0,0,5,10,15,16,13,29,4,3,7,14,11,25,274,226,500,589
20192020,114,WARREN,571,Warren County,018,Plano Elementary,571018,114571018,210573002035,GRREC,902,PS,12,22,1,0,1,0,0,0,1,2,3,1,2,3,0,0,0,2,0,2,17,8,25,34
20192020,114,WARREN,571,Warren County,018,Plano Elementary,571018,114571018,210573002035,GRREC,902,KG,43,50,0,1,1,0,0,0,1,3,4,3,2,5,1,1,2,4,3,7,41,33,74,93
20192020,114,WARREN,571,Warren County,018,Plano Elementary,571018,114571018,210573002035,GRREC,902,01,37,39,1,0,1,0,0,0,0,0,0,2,1,3,0,1,1,1,2,3,35,33,68,76
20192020,114,WARREN,571,Warren County,018,Plano Elementary,571018,114571018,210573002035,GRREC,902,02,29,41,2,1,3,0,0,0,0,2,2,1,1,2,0,1,1,1,0,1,37,24,61,70
20192020,114,WARREN,571,Warren County,018,Plano Elementary,571018,114571018,210573002035,GRREC,902,03,53,46,0,2,2,0,0,0,0,1,1,2,3,5,1,0,1,2,1,3,41,46,87,99
20192020,114,WARREN,571,Warren County,018,Plano Elementary,571018,114571018,210573002035,GRREC,902,04,49,49,0,0,0,0,0,0,1,3,4,2,2,4,0,0,0,0,2,2,46,42,88,98
20192020,114,WARREN,571,Warren County,018,Plano Elementary,571018,114571018,210573002035,GRREC,902,05,30,42,3,2,5,0,0,0,1,1,2,3,2,5,1,0,1,4,2,6,30,23,53,72
20192020,114,WARREN,571,Warren County,018,Plano Elementary,571018,114571018,210573002035,GRREC,902,06,29,52,0,1,1,0,0,0,2,0,2,3,2,5,1,0,1,2,1,3,44,25,69,81
20192020,114,WARREN,571,Warren County,020,Beacon Academy,571020,114571020,210573002410,GRREC,902,All Students,81,38,4,3,7,0,0,0,0,1,1,0,5,5,0,0,0,1,2,3,33,70,103,119
20192020,114,WARREN,571,Warren County,020,Beacon Academy,571020,114571020,210573002410,GRREC,902,07,4,2,1,0,1,0,0,0,0,0,0,0,0,0,0,0,0,0,0,0,1,4,5,6
20192020,114,WARREN,571,Warren County,020,Beacon Academy,571020,114571020,210573002410,GRREC,902,08,4,4,0,1,1,0,0,0,0,0,0,0,0,0,0,0,0,0,0,0,4,3,7,8
20192020,114,WARREN,571,Warren County,020,Beacon Academy,571020,114571020,210573002410,GRREC,902,09,7,6,0,0,0,0,0,0,0,0,0,0,1,1,0,0,0,0,0,0,6,6,12,13
20192020,114,WARREN,571,Warren County,020,Beacon Academy,571020,114571020,210573002410,GRREC,902,10,20,2,0,0,0,0,0,0,0,0,0,0,1,1,0,0,0,1,0,1,1,19,20,22
20192020,114,WARREN,571,Warren County,020,Beacon Academy,571020,114571020,210573002410,GRREC,902,11,8,5,0,1,1,0,0,0,0,0,0,0,0,0,0,0,0,0,0,0,5,7,12,13
20192020,114,WARREN,571,Warren County,020,Beacon Academy,571020,114571020,210573002410,GRREC,902,12,38,19,3,1,4,0,0,0,0,1,1,0,3,3,0,0,0,0,2,2,16,31,47,57
20192020,114,WARREN,571,Warren County,025,Jennings Creek Elementary,571025,114571025,210573002465,GRREC,902,KG,57,48,8,10,18,0,0,0,13,7,20,9,15,24,2,1,3,2,3,5,14,21,35,105
20192020,114,WARREN,571,Warren County,025,Jennings Creek Elementary,571025,114571025,210573002465,GRREC,902,All Students,355,340,72,67,139,1,0,1,62,57,119,52,64,116,5,7,12,14,18,32,134,142,276,695
20192020,114,WARREN,571,Warren County,025,Jennings Creek Elementary,571025,114571025,210573002465,GRREC,902,PS,52,52,7,4,11,0,0,0,15,15,30,10,8,18,0,0,0,2,2,4,18,23,41,104
20192020,114,WARREN,571,Warren County,025,Jennings Creek Elementary,571025,114571025,210573002465,GRREC,902,01,56,59,10,11,21,0,0,0,7,9,16,14,7,21,0,2,2,3,4,7,25,23,48,115
20192020,114,WARREN,571,Warren County,025,Jennings Creek Elementary,571025,114571025,210573002465,GRREC,902,02,52,53,14,8,22,0,0,0,8,9,17,7,12,19,1,0,1,1,1,2,22,22,44,105
20192020,114,WARREN,571,Warren County,025,Jennings Creek Elementary,571025,114571025,210573002465,GRREC,902,03,48,53,10,6,16,0,0,0,9,8,17,5,6,11,1,1,2,1,1,2,27,26,53,101
20192020,114,WARREN,571,Warren County,025,Jennings Creek Elementary,571025,114571025,210573002465,GRREC,902,04,55,46,10,10,20,0,0,0,13,11,24,4,8,12,1,1,2,1,3,4,17,22,39,101
20192020,114,WARREN,571,Warren County,025,Jennings Creek Elementary,571025,114571025,210573002465,GRREC,902,05,37,38,8,10,18,0,0,0,5,7,12,6,5,11,0,0,0,3,3,6,16,12,28,75
20192020,114,WARREN,571,Warren County,025,Jennings Creek Elementary,571025,114571025,210573002465,GRREC,902,06,50,43,12,12,24,1,0,1,7,6,13,7,11,18,0,2,2,3,3,6,13,16,29,93
20192020,114,WARREN,571,Warren County,030,Jody Richards Elementary,571030,114571030,210573002327,GRREC,902,All Students,384,388,17,12,29,0,0,0,42,51,93,36,26,62,2,1,3,20,12,32,271,282,553,772
20192020,114,WARREN,571,Warren County,030,Jody Richards Elementary,571030,114571030,210573002327,GRREC,902,PS,29,33,1,3,4,0,0,0,5,2,7,2,5,7,0,0,0,1,1,2,24,18,42,62
20192020,114,WARREN,571,Warren County,030,Jody Richards Elementary,571030,114571030,210573002327,GRREC,902,KG,60,51,1,2,3,0,0,0,4,6,10,5,5,10,0,1,1,5,1,6,36,45,81,111
20192020,114,WARREN,571,Warren County,030,Jody Richards Elementary,571030,114571030,210573002327,GRREC,902,01,49,50,0,0,0,0,0,0,6,7,13,5,4,9,0,0,0,3,2,5,36,36,72,99
20192020,114,WARREN,571,Warren County,030,Jody Richards Elementary,571030,114571030,210573002327,GRREC,902,02,48,62,3,2,5,0,0,0,7,8,15,5,2,7,0,0,0,1,1,2,46,35,81,110
20192020,114,WARREN,571,Warren County,030,Jody Richards Elementary,571030,114571030,210573002327,GRREC,902,03,55,59,2,0,2,0,0,0,8,8,16,3,3,6,1,0,1,3,2,5,42,42,84,114
20192020,114,WARREN,571,Warren County,030,Jody Richards Elementary,571030,114571030,210573002327,GRREC,902,04,44,50,5,0,5,0,0,0,7,5,12,1,2,3,0,0,0,3,2,5,34,35,69,94
20192020,114,WARREN,571,Warren County,030,Jody Richards Elementary,571030,114571030,210573002327,GRREC,902,05,69,66,4,4,8,0,0,0,3,6,9,11,6,17,1,0,1,3,4,7,44,49,93,135
20192020,114,WARREN,571,Warren County,030,Jody Richards Elementary,571030,114571030,210573002327,GRREC,902,06,59,50,2,4,6,0,0,0,7,11,18,6,4,10,0,0,0,2,0,2,33,40,73,109
20192020,114,WARREN,571,Warren County,040,Bristow Elementary,571040,114571040,210573001344,GRREC,902,All Students,264,286,33,33,66,0,1,1,2,3,5,40,35,75,1,0,1,33,31,64,177,161,338,550
20192020,114,WARREN,571,Warren County,040,Bristow Elementary,571040,114571040,210573001344,GRREC,902,PS,30,18,1,1,2,0,0,0,0,0,0,4,8,12,0,0,0,2,2,4,11,19,30,48
20192020,114,WARREN,571,Warren County,040,Bristow Elementary,571040,114571040,210573001344,GRREC,902,KG,37,46,4,3,7,0,0,0,0,0,0,3,6,9,1,0,1,5,3,8,33,25,58,83
20192020,114,WARREN,571,Warren County,040,Bristow Elementary,571040,114571040,210573001344,GRREC,902,01,39,35,4,3,7,0,0,0,0,1,1,5,8,13,0,0,0,2,8,10,24,19,43,74
20192020,114,WARREN,571,Warren County,040,Bristow Elementary,571040,114571040,210573001344,GRREC,902,02,22,33,5,5,10,0,0,0,1,0,1,5,3,8,0,0,0,8,3,11,14,11,25,55
20192020,114,WARREN,571,Warren County,040,Bristow Elementary,571040,114571040,210573001344,GRREC,902,03,46,38,4,6,10,0,1,1,0,0,0,5,4,9,0,0,0,1,2,3,28,33,61,84
20192020,114,WARREN,571,Warren County,040,Bristow Elementary,571040,114571040,210573001344,GRREC,902,04,41,39,6,8,14,0,0,0,0,0,0,8,2,10,0,0,0,2,6,8,23,25,48,80
20192020,114,WARREN,571,Warren County,040,Bristow Elementary,571040,114571040,210573001344,GRREC,902,05,39,53,2,4,6,0,0,0,1,1,2,6,3,9,0,0,0,8,3,11,36,28,64,92
20192020,114,WARREN,571,Warren County,040,Bristow Elementary,571040,114571040,210573001344,GRREC,902,06,40,42,8,4,12,0,0,0,0,1,1,8,9,17,0,0,0,7,6,13,19,20,39,82
20192020,114,WARREN,571,Warren County,070,Cumberland Trace Elementary,571070,114571070,210573001346,GRREC,902,All Students,268,260,14,21,35,0,0,0,17,23,40,23,31,54,5,10,15,17,14,31,184,169,353,528
20192020,114,WARREN,571,Warren County,070,Cumberland Trace Elementary,571070,114571070,210573001346,GRREC,902,PS,11,26,3,1,4,0,0,0,2,1,3,5,0,5,0,0,0,0,1,1,16,8,24,37
20192020,114,WARREN,571,Warren County,070,Cumberland Trace Elementary,571070,114571070,210573001346,GRREC,902,KG,33,30,2,3,5,0,0,0,0,0,0,2,8,10,0,1,1,2,1,3,24,20,44,63
20192020,114,WARREN,571,Warren County,070,Cumberland Trace Elementary,571070,114571070,210573001346,GRREC,902,01,31,40,2,2,4,0,0,0,3,3,6,2,3,5,0,2,2,4,4,8,29,17,46,71
20192020,114,WARREN,571,Warren County,070,Cumberland Trace Elementary,571070,114571070,210573001346,GRREC,902,02,32,41,2,1,3,0,0,0,4,3,7,6,6,12,2,1,3,2,1,3,25,20,45,73
20192020,114,WARREN,571,Warren County,070,Cumberland Trace Elementary,571070,114571070,210573001346,GRREC,902,03,33,35,3,3,6,0,0,0,4,4,8,3,3,6,0,2,2,1,1,2,24,20,44,68
20192020,114,WARREN,571,Warren County,070,Cumberland Trace Elementary,571070,114571070,210573001346,GRREC,902,04,41,40,3,3,6,0,0,0,2,6,8,3,2,5,0,2,2,5,1,6,27,27,54,81
20192020,114,WARREN,571,Warren County,070,Cumberland Trace Elementary,571070,114571070,210573001346,GRREC,902,05,45,40,2,4,6,0,0,0,1,3,4,5,6,11,1,1,2,2,3,5,29,28,57,85
20192020,114,WARREN,571,Warren County,070,Cumberland Trace Elementary,571070,114571070,210573001346,GRREC,902,06,53,34,0,5,5,0,0,0,3,4,7,2,3,5,2,1,3,1,3,4,26,37,63,87
20192020,114,WARREN,571,Warren County,075,Drakes Creek Middle School,571075,114571075,210573001603,GRREC,902,All Students,340,361,15,24,39,0,0,0,43,57,100,42,27,69,2,4,6,12,13,25,247,215,462,701
20192020,114,WARREN,571,Warren County,075,Drakes Creek Middle School,571075,114571075,210573001603,GRREC,902,07,165,183,8,17,25,0,0,0,23,26,49,16,10,26,1,1,2,6,7,13,129,104,233,348
20192020,114,WARREN,571,Warren County,075,Drakes Creek Middle School,571075,114571075,210573001603,GRREC,902,08,175,178,7,7,14,0,0,0,20,31,51,26,17,43,1,3,4,6,6,12,118,111,229,353
20192020,114,WARREN,571,Warren County,080,Lost River Elementary,571080,114571080,210573001164,GRREC,902,All Students,285,311,51,47,98,0,0,0,28,30,58,59,68,127,6,5,11,22,19,41,145,116,261,596
20192020,114,WARREN,571,Warren County,080,Lost River Elementary,571080,114571080,210573001164,GRREC,902,PS,32,25,9,1,10,0,0,0,2,9,11,4,8,12,0,0,0,1,2,3,9,12,21,57
20192020,114,WARREN,571,Warren County,080,Lost River Elementary,571080,114571080,210573001164,GRREC,902,KG,47,55,9,6,15,0,0,0,2,6,8,11,11,22,0,0,0,5,2,7,28,22,50,102
20192020,114,WARREN,571,Warren County,080,Lost River Elementary,571080,114571080,210573001164,GRREC,902,01,47,51,7,8,15,0,0,0,6,8,14,7,16,23,2,0,2,2,0,2,27,15,42,98
20192020,114,WARREN,571,Warren County,080,Lost River Elementary,571080,114571080,210573001164,GRREC,902,02,23,35,9,5,14,0,0,0,4,3,7,5,3,8,1,0,1,1,2,3,15,10,25,58
20192020,114,WARREN,571,Warren County,080,Lost River Elementary,571080,114571080,210573001164,GRREC,902,03,42,44,5,5,10,0,0,0,3,3,6,10,9,19,1,2,3,4,5,9,21,18,39,86
20192020,114,WARREN,571,Warren County,080,Lost River Elementary,571080,114571080,210573001164,GRREC,902,04,50,42,10,6,16,0,0,0,7,3,10,9,7,16,0,2,2,2,4,6,14,28,42,92
20192020,114,WARREN,571,Warren County,080,Lost River Elementary,571080,114571080,210573001164,GRREC,902,05,36,39,6,6,12,0,0,0,1,2,3,8,15,23,0,0,0,5,2,7,19,11,30,75
20192020,114,WARREN,571,Warren County,080,Lost River Elementary,571080,114571080,210573001164,GRREC,902,06,40,45,5,11,16,0,0,0,5,5,10,9,7,16,2,1,3,3,4,7,21,12,33,85
20192020,114,WARREN,571,Warren County,100,William H. Natcher Elementary,571100,114571100,210573001691,GRREC,902,All Students,365,337,30,38,68,0,0,0,90,80,170,38,29,67,2,1,3,17,20,37,160,197,357,702
20192020,114,WARREN,571,Warren County,100,William H. Natcher Elementary,571100,114571100,210573001691,GRREC,902,PS,23,19,4,1,5,0,0,0,4,16,20,1,0,1,0,0,0,1,0,1,9,6,15,42
20192020,114,WARREN,571,Warren County,100,William H. Natcher Elementary,571100,114571100,210573001691,GRREC,902,KG,67,71,4,9,13,0,0,0,20,11,31,6,5,11,1,1,2,5,5,10,35,36,71,138
20192020,114,WARREN,571,Warren County,100,William H. Natcher Elementary,571100,114571100,210573001691,GRREC,902,01,48,41,4,3,7,0,0,0,12,11,23,2,5,7,0,0,0,2,0,2,21,29,50,89
20192020,114,WARREN,571,Warren County,100,William H. Natcher Elementary,571100,114571100,210573001691,GRREC,902,02,41,63,3,4,7,0,0,0,20,9,29,7,3,10,1,0,1,3,1,4,29,24,53,104
20192020,114,WARREN,571,Warren County,100,William H. Natcher Elementary,571100,114571100,210573001691,GRREC,902,03,55,36,6,2,8,0,0,0,8,15,23,4,3,7,0,0,0,2,6,8,16,29,45,91
20192020,114,WARREN,571,Warren County,100,William H. Natcher Elementary,571100,114571100,210573001691,GRREC,902,04,56,40,3,5,8,0,0,0,12,15,27,4,7,11,0,0,0,0,5,5,21,24,45,96
20192020,114,WARREN,571,Warren County,100,William H. Natcher Elementary,571100,114571100,210573001691,GRREC,902,05,44,47,7,4,11,0,0,0,9,10,19,5,3,8,0,0,0,3,2,5,23,25,48,91
20192020,114,WARREN,571,Warren County,100,William H. Natcher Elementary,571100,114571100,210573001691,GRREC,902,06,54,39,3,11,14,0,0,0,9,9,18,10,3,13,0,0,0,2,1,3,15,30,45,93
20192020,114,WARREN,571,Warren County,110,North Warren Elementary,571110,114571110,210573001347,GRREC,902,All Students,195,194,15,9,24,0,0,0,2,0,2,7,16,23,0,0,0,9,7,16,161,163,324,389
20192020,114,WARREN,571,Warren County,110,North Warren Elementary,571110,114571110,210573001347,GRREC,902,PS,19,19,1,0,1,0,0,0,0,0,0,2,2,4,0,0,0,4,2,6,12,15,27,38
20192020,114,WARREN,571,Warren County,110,North Warren Elementary,571110,114571110,210573001347,GRREC,902,KG,27,21,1,0,1,0,0,0,0,0,0,2,4,6,0,0,0,1,0,1,17,23,40,48
20192020,114,WARREN,571,Warren County,110,North Warren Elementary,571110,114571110,210573001347,GRREC,902,01,22,35,2,2,4,0,0,0,0,0,0,0,2,2,0,0,0,2,1,3,31,17,48,57
20192020,114,WARREN,571,Warren County,110,North Warren Elementary,571110,114571110,210573001347,GRREC,902,02,29,23,2,1,3,0,0,0,0,0,0,0,5,5,0,0,0,0,1,1,21,22,43,52
20192020,114,WARREN,571,Warren County,110,North Warren Elementary,571110,114571110,210573001347,GRREC,902,03,27,24,5,1,6,0,0,0,0,0,0,0,1,1,0,0,0,1,1,2,18,24,42,51
20192020,114,WARREN,571,Warren County,110,North Warren Elementary,571110,114571110,210573001347,GRREC,902,04,28,28,2,0,2,0,0,0,0,0,0,1,2,3,0,0,0,1,1,2,24,25,49,56
20192020,114,WARREN,571,Warren County,110,North Warren Elementary,571110,114571110,210573001347,GRREC,902,05,33,24,1,3,4,0,0,0,1,0,1,2,1,3,0,0,0,1,3,4,19,26,45,57
20192020,114,WARREN,571,Warren County,110,North Warren Elementary,571110,114571110,210573001347,GRREC,902,06,29,39,2,2,4,0,0,0,1,0,1,2,1,3,0,0,0,3,0,3,31,26,57,68
20192020,114,WARREN,571,Warren County,130,Oakland Elementary,571130,114571130,210573001348,GRREC,902,All Students,138,162,33,29,62,0,0,0,1,0,1,32,22,54,0,1,1,11,14,25,85,72,157,300
20192020,114,WARREN,571,Warren County,130,Oakland Elementary,571130,114571130,210573001348,GRREC,902,PS,16,18,1,3,4,0,0,0,0,0,0,3,2,5,0,0,0,2,3,5,12,8,20,34
20192020,114,WARREN,571,Warren County,130,Oakland Elementary,571130,114571130,210573001348,GRREC,902,KG,20,28,5,4,9,0,0,0,0,0,0,4,3,7,0,0,0,0,2,2,19,11,30,48
20192020,114,WARREN,571,Warren County,130,Oakland Elementary,571130,114571130,210573001348,GRREC,902,01,23,28,3,5,8,0,0,0,0,0,0,3,1,4,0,0,0,2,3,5,20,14,34,51
20192020,114,WARREN,571,Warren County,130,Oakland Elementary,571130,114571130,210573001348,GRREC,902,02,14,12,4,2,6,0,0,0,1,0,1,2,2,4,0,0,0,0,1,1,5,9,14,26
20192020,114,WARREN,571,Warren County,130,Oakland Elementary,571130,114571130,210573001348,GRREC,902,03,19,28,7,2,9,0,0,0,0,0,0,6,4,10,0,1,1,5,2,7,10,10,20,47
20192020,114,WARREN,571,Warren County,130,Oakland Elementary,571130,114571130,210573001348,GRREC,902,04,15,24,7,4,11,0,0,0,0,0,0,4,3,7,0,0,0,1,1,2,12,7,19,39
20192020,114,WARREN,571,Warren County,130,Oakland Elementary,571130,114571130,210573001348,GRREC,902,05,24,15,2,5,7,0,0,0,0,0,0,4,5,9,0,0,0,0,2,2,9,12,21,39
20192020,114,WARREN,571,Warren County,130,Oakland Elementary,571130,114571130,210573001348,GRREC,902,06,23,27,5,7,12,0,0,0,0,0,0,9,4,13,0,0,0,3,3,6,10,9,19,50
20192020,114,WARREN,571,Warren County,140,Rich Pond Elementary,571140,114571140,210573001349,GRREC,902,All Students,356,343,7,12,19,0,0,0,22,14,36,11,21,32,1,1,2,11,8,19,291,300,591,699
20192020,114,WARREN,571,Warren County,140,Rich Pond Elementary,571140,114571140,210573001349,GRREC,902,PS,15,25,1,1,2,0,0,0,1,2,3,0,5,5,0,0,0,1,1,2,22,6,28,40
20192020,114,WARREN,571,Warren County,140,Rich Pond Elementary,571140,114571140,210573001349,GRREC,902,KG,46,46,3,1,4,0,0,0,3,2,5,3,4,7,0,0,0,0,2,2,37,37,74,92
20192020,114,WARREN,571,Warren County,140,Rich Pond Elementary,571140,114571140,210573001349,GRREC,902,01,57,59,1,0,1,0,0,0,5,1,6,0,4,4,0,0,0,0,1,1,53,51,104,116
20192020,114,WARREN,571,Warren County,140,Rich Pond Elementary,571140,114571140,210573001349,GRREC,902,02,52,47,1,1,2,0,0,0,3,4,7,3,2,5,0,0,0,1,2,3,39,43,82,99
20192020,114,WARREN,571,Warren County,140,Rich Pond Elementary,571140,114571140,210573001349,GRREC,902,03,57,50,0,1,1,0,0,0,1,2,3,0,3,3,1,0,1,1,0,1,47,51,98,107
20192020,114,WARREN,571,Warren County,140,Rich Pond Elementary,571140,114571140,210573001349,GRREC,902,04,54,50,1,3,4,0,0,0,2,4,6,3,0,3,0,0,0,4,3,7,40,44,84,104
20192020,114,WARREN,571,Warren County,140,Rich Pond Elementary,571140,114571140,210573001349,GRREC,902,05,49,56,1,4,5,0,0,0,3,1,4,1,5,6,0,1,1,2,0,2,49,38,87,105
20192020,114,WARREN,571,Warren County,140,Rich Pond Elementary,571140,114571140,210573001349,GRREC,902,06,41,35,0,2,2,0,0,0,5,0,5,1,3,4,0,0,0,3,0,3,26,36,62,76
20192020,114,WARREN,571,Warren County,150,Richardsville Elementary,571150,114571150,210573001350,GRREC,902,All Students,191,217,3,3,6,0,0,0,0,0,0,8,10,18,0,0,0,5,6,11,201,172,373,408
20192020,114,WARREN,571,Warren County,150,Richardsville Elementary,571150,114571150,210573001350,GRREC,902,PS,17,30,0,0,0,0,0,0,0,0,0,6,1,7,0,0,0,1,0,1,23,16,39,47
20192020,114,WARREN,571,Warren County,150,Richardsville Elementary,571150,114571150,210573001350,GRREC,902,KG,33,28,0,0,0,0,0,0,0,0,0,0,1,1,0,0,0,0,3,3,28,29,57,61
20192020,114,WARREN,571,Warren County,150,Richardsville Elementary,571150,114571150,210573001350,GRREC,902,01,33,34,1,0,1,0,0,0,0,0,0,2,1,3,0,0,0,1,2,3,30,30,60,67
20192020,114,WARREN,571,Warren County,150,Richardsville Elementary,571150,114571150,210573001350,GRREC,902,02,29,26,0,1,1,0,0,0,0,0,0,0,2,2,0,0,0,1,0,1,25,26,51,55
20192020,114,WARREN,571,Warren County,150,Richardsville Elementary,571150,114571150,210573001350,GRREC,902,03,25,30,0,1,1,0,0,0,0,0,0,0,2,2,0,0,0,0,0,0,30,22,52,55
20192020,114,WARREN,571,Warren County,150,Richardsville Elementary,571150,114571150,210573001350,GRREC,902,04,21,28,0,0,0,0,0,0,0,0,0,2,0,2,0,0,0,2,0,2,24,21,45,49
20192020,114,WARREN,571,Warren County,150,Richardsville Elementary,571150,114571150,210573001350,GRREC,902,05,20,31,1,1,2,0,0,0,0,0,0,1,2,3,0,0,0,0,0,0,29,17,46,51
20192020,114,WARREN,571,Warren County,150,Richardsville Elementary,571150,114571150,210573001350,GRREC,902,06,30,40,1,0,1,0,0,0,0,0,0,3,2,5,0,0,0,1,1,2,35,27,62,70
20192020,114,WARREN,571,Warren County,170,Rockfield Elementary,571170,114571170,210573001351,GRREC,902,All Students,290,287,11,7,18,0,1,1,16,11,27,11,13,24,4,2,6,18,16,34,227,240,467,577
20192020,114,WARREN,571,Warren County,170,Rockfield Elementary,571170,114571170,210573001351,GRREC,902,PS,29,40,0,0,0,0,0,0,2,5,7,2,0,2,1,1,2,2,1,3,33,22,55,69
20192020,114,WARREN,571,Warren County,170,Rockfield Elementary,571170,114571170,210573001351,GRREC,902,KG,28,36,1,0,1,0,0,0,1,1,2,0,1,1,1,0,1,3,3,6,30,23,53,64
20192020,114,WARREN,571,Warren County,170,Rockfield Elementary,571170,114571170,210573001351,GRREC,902,01,42,46,1,1,2,0,0,0,2,2,4,1,1,2,1,0,1,4,3,7,37,35,72,88
20192020,114,WARREN,571,Warren County,170,Rockfield Elementary,571170,114571170,210573001351,GRREC,902,02,33,32,3,0,3,0,0,0,4,3,7,1,2,3,1,0,1,1,3,4,22,25,47,65
20192020,114,WARREN,571,Warren County,170,Rockfield Elementary,571170,114571170,210573001351,GRREC,902,03,50,42,3,1,4,0,0,0,2,3,5,3,1,4,0,0,0,3,4,7,31,41,72,92
20192020,114,WARREN,571,Warren County,170,Rockfield Elementary,571170,114571170,210573001351,GRREC,902,04,45,42,2,3,5,0,0,0,3,0,3,2,1,3,0,1,1,2,1,3,33,39,72,87
20192020,114,WARREN,571,Warren County,170,Rockfield Elementary,571170,114571170,210573001351,GRREC,902,05,48,38,0,2,2,0,0,0,1,1,2,2,4,6,1,1,2,4,2,6,30,38,68,86
20192020,114,WARREN,571,Warren County,170,Rockfield Elementary,571170,114571170,210573001351,GRREC,902,06,44,51,1,0,1,0,1,1,3,1,4,2,3,5,0,0,0,1,0,1,44,39,83,95
20192020,114,WARREN,571,Warren County,175,Henry F. Moss Middle School,571175,114571175,210573001604,GRREC,902,All Students,269,306,73,60,133,0,1,1,32,23,55,50,40,90,4,4,8,20,22,42,127,119,246,575
20192020,114,WARREN,571,Warren County,175,Henry F. Moss Middle School,571175,114571175,210573001604,GRREC,902,07,125,147,35,24,59,0,0,0,12,15,27,29,19,48,4,2,6,10,9,19,57,56,113,272
20192020,114,WARREN,571,Warren County,175,Henry F. Moss Middle School,571175,114571175,210573001604,GRREC,902,08,144,159,38,36,74,0,1,1,20,8,28,21,21,42,0,2,2,10,13,23,70,63,133,303
20192020,114,WARREN,571,Warren County,200,Warren Elementary,571200,114571200,210573001352,GRREC,902,All Students,307,303,117,103,220,3,1,4,34,35,69,85,76,161,1,2,3,11,19,30,52,71,123,610
20192020,114,WARREN,571,Warren County,200,Warren Elementary,571200,114571200,210573001352,GRREC,902,PS,43,40,16,15,31,0,0,0,4,8,12,10,10,20,0,0,0,2,2,4,8,8,16,83
20192020,114,WARREN,571,Warren County,200,Warren Elementary,571200,114571200,210573001352,GRREC,902,KG,51,51,17,9,26,0,0,0,9,11,20,15,16,31,1,0,1,3,5,8,6,10,16,102
20192020,114,WARREN,571,Warren County,200,Warren Elementary,571200,114571200,210573001352,GRREC,902,01,43,46,18,16,34,2,0,2,6,9,15,11,7,18,0,0,0,3,1,4,6,10,16,89
20192020,114,WARREN,571,Warren County,200,Warren Elementary,571200,114571200,210573001352,GRREC,902,02,49,41,13,16,29,0,0,0,10,4,14,12,16,28,0,1,1,1,5,6,5,7,12,90
20192020,114,WARREN,571,Warren County,200,Warren Elementary,571200,114571200,210573001352,GRREC,902,03,39,50,18,15,33,0,1,1,5,1,6,16,10,26,0,0,0,1,5,6,10,7,17,89
20192020,114,WARREN,571,Warren County,200,Warren Elementary,571200,114571200,210573001352,GRREC,902,04,35,45,18,16,34,0,0,0,1,2,3,13,5,18,0,1,1,2,0,2,11,11,22,80
20192020,114,WARREN,571,Warren County,200,Warren Elementary,571200,114571200,210573001352,GRREC,902,05,43,37,18,15,33,1,0,1,2,3,5,9,9,18,0,0,0,1,2,3,6,14,20,80
20192020,114,WARREN,571,Warren County,200,Warren Elementary,571200,114571200,210573001352,GRREC,902,06,47,33,15,16,31,0,0,0,1,5,6,9,13,22,0,0,0,0,1,1,8,12,20,80
20192020,114,WARREN,571,Warren County,205,Warren East Middle School,571205,114571205,210573001605,GRREC,902,All Students,262,273,20,26,46,0,1,1,4,2,6,20,20,40,0,0,0,19,17,36,210,196,406,535
20192020,114,WARREN,571,Warren County,205,Warren East Middle School,571205,114571205,210573001605,GRREC,902,07,140,139,8,12,20,0,1,1,1,1,2,10,8,18,0,0,0,8,8,16,112,110,222,279
20192020,114,WARREN,571,Warren County,205,Warren East Middle School,571205,114571205,210573001605,GRREC,902,08,122,134,12,14,26,0,0,0,3,1,4,10,12,22,0,0,0,11,9,20,98,86,184,256
20192020,114,WARREN,571,Warren County,210,Warren Central High School,571210,114571210,210573001353,GRREC,902,All Students,448,527,100,116,216,0,0,0,62,48,110,112,70,182,7,7,14,22,25,47,224,182,406,975
20192020,114,WARREN,571,Warren County,210,Warren Central High School,571210,114571210,210573001353,GRREC,902,08,1,2,0,1,1,0,0,0,1,0,1,0,0,0,0,0,0,0,0,0,1,0,1,3
20192020,114,WARREN,571,Warren County,210,Warren Central High School,571210,114571210,210573001353,GRREC,902,09,128,160,38,31,69,0,0,0,15,15,30,40,20,60,5,2,7,3,8,11,59,52,111,288
20192020,114,WARREN,571,Warren County,210,Warren Central High School,571210,114571210,210573001353,GRREC,902,10,117,151,22,30,52,0,0,0,26,13,39,33,16,49,2,2,4,5,6,11,63,50,113,268
20192020,114,WARREN,571,Warren County,210,Warren Central High School,571210,114571210,210573001353,GRREC,902,11,109,108,16,31,47,0,0,0,11,13,24,22,18,40,0,0,0,5,5,10,54,42,96,217
20192020,114,WARREN,571,Warren County,210,Warren Central High School,571210,114571210,210573001353,GRREC,902,12,93,105,24,23,47,0,0,0,8,7,15,17,16,33,0,3,3,9,6,15,47,38,85,198
20192020,114,WARREN,571,Warren County,210,Warren Central High School,571210,114571210,210573001353,GRREC,902,14,0,1,0,0,0,0,0,0,1,0,1,0,0,0,0,0,0,0,0,0,0,0,0,1
20192020,114,WARREN,571,Warren County,220,Warren East High School,571220,114571220,210573001354,GRREC,902,All Students,438,440,45,35,80,2,1,3,6,5,11,43,29,72,1,1,2,22,25,47,321,342,663,878
20192020,114,WARREN,571,Warren County,220,Warren East High School,571220,114571220,210573001354,GRREC,902,08,0,1,0,0,0,0,0,0,0,0,0,0,0,0,0,0,0,0,0,0,1,0,1,1
20192020,114,WARREN,571,Warren County,220,Warren East High School,571220,114571220,210573001354,GRREC,902,09,128,136,15,9,24,2,0,2,1,0,1,14,11,25,0,1,1,8,9,17,96,98,194,264
20192020,114,WARREN,571,Warren County,220,Warren East High School,571220,114571220,210573001354,GRREC,902,10,121,124,8,11,19,0,0,0,3,0,3,14,10,24,0,0,0,5,7,12,94,93,187,245
20192020,114,WARREN,571,Warren County,220,Warren East High School,571220,114571220,210573001354,GRREC,902,11,108,95,13,12,25,0,0,0,0,4,4,11,5,16,0,0,0,3,4,7,68,83,151,203
20192020,114,WARREN,571,Warren County,220,Warren East High School,571220,114571220,210573001354,GRREC,902,12,81,84,9,3,12,0,1,1,2,1,3,4,3,7,1,0,1,6,5,11,62,68,130,165
20192020,114,WARREN,571,Warren County,230,Greenwood High School,571230,114571230,210573001692,GRREC,902,All Students,634,645,35,35,70,1,1,2,92,86,178,48,46,94,9,5,14,25,19,44,435,442,877,1279
20192020,114,WARREN,571,Warren County,230,Greenwood High School,571230,114571230,210573001692,GRREC,902,09,179,181,11,16,27,1,1,2,28,24,52,14,16,30,3,1,4,8,3,11,116,118,234,360
20192020,114,WARREN,571,Warren County,230,Greenwood High School,571230,114571230,210573001692,GRREC,902,10,159,160,8,11,19,0,0,0,19,18,37,10,12,22,1,2,3,6,9,15,116,107,223,319
20192020,114,WARREN,571,Warren County,230,Greenwood High School,571230,114571230,210573001692,GRREC,902,11,144,146,10,6,16,0,0,0,16,20,36,14,11,25,5,0,5,6,4,10,95,103,198,290
20192020,114,WARREN,571,Warren County,230,Greenwood High School,571230,114571230,210573001692,GRREC,902,12,152,157,6,2,8,0,0,0,29,24,53,10,7,17,0,2,2,5,3,8,107,114,221,309
20192020,114,WARREN,571,Warren County,230,Greenwood High School,571230,114571230,210573001692,GRREC,902,14,0,1,0,0,0,0,0,0,0,0,0,0,0,0,0,0,0,0,0,0,1,0,1,1
20192020,114,WARREN,571,Warren County,245,GEO International High School,571245,114571245,210573002427,GRREC,902,All Students,87,89,41,39,80,0,0,0,20,30,50,25,18,43,0,0,0,0,0,0,3,0,3,176
20192020,114,WARREN,571,Warren County,245,GEO International High School,571245,114571245,210573002427,GRREC,902,09,28,30,13,14,27,0,0,0,5,8,13,12,6,18,0,0,0,0,0,0,0,0,0,58
20192020,114,WARREN,571,Warren County,245,GEO International High School,571245,114571245,210573002427,GRREC,902,10,16,22,14,10,24,0,0,0,5,4,9,3,2,5,0,0,0,0,0,0,0,0,0,38
20192020,114,WARREN,571,Warren County,245,GEO International High School,571245,114571245,210573002427,GRREC,902,11,13,12,6,5,11,0,0,0,3,5,8,3,3,6,0,0,0,0,0,0,0,0,0,25
20192020,114,WARREN,571,Warren County,245,GEO International High School,571245,114571245,210573002427,GRREC,902,12,30,25,8,10,18,0,0,0,7,13,20,7,7,14,0,0,0,0,0,0,3,0,3,55
20192020,114,WARREN,571,Warren County,250,Jackson Academy High School,571250,114571250,210573002302,GRREC,902,09,3,3,0,0,0,0,0,0,0,0,0,1,0,1,0,0,0,0,0,0,2,3,5,6
20192020,114,WARREN,571,Warren County,250,Jackson Academy High School,571250,114571250,210573002302,GRREC,902,All Students,5,4,0,1,1,0,0,0,0,0,0,1,0,1,0,0,0,0,0,0,3,4,7,9
20192020,114,WARREN,571,Warren County,250,Jackson Academy High School,571250,114571250,210573002302,GRREC,902,10,1,0,0,0,0,0,0,0,0,0,0,0,0,0,0,0,0,0,0,0,0,1,1,1
20192020,114,WARREN,571,Warren County,250,Jackson Academy High School,571250,114571250,210573002302,GRREC,902,11,1,1,0,1,1,0,0,0,0,0,0,0,0,0,0,0,0,0,0,0,1,0,1,2
20192020,114,WARREN,571,Warren County,300,Rivendell Elementary,571300,114571300,210573000828,GRREC,902,All Students,2,4,0,0,0,0,0,0,0,0,0,0,0,0,0,0,0,0,0,0,4,2,6,6
20192020,114,WARREN,571,Warren County,300,Rivendell Elementary,571300,114571300,210573000828,GRREC,902,08,2,4,0,0,0,0,0,0,0,0,0,0,0,0,0,0,0,0,0,0,4,2,6,6
20192020,114,WARREN,571,Warren County,305,Rivendell High School,571305,114571305,210573000839,GRREC,902,All Students,4,17,0,1,1,0,0,0,0,0,0,2,0,2,0,0,0,1,0,1,14,3,17,21
20192020,114,WARREN,571,Warren County,305,Rivendell High School,571305,114571305,210573000839,GRREC,902,09,0,9,0,0,0,0,0,0,0,0,0,2,0,2,0,0,0,1,0,1,6,0,6,9
20192020,114,WARREN,571,Warren County,305,Rivendell High School,571305,114571305,210573000839,GRREC,902,10,2,7,0,1,1,0,0,0,0,0,0,0,0,0,0,0,0,0,0,0,7,1,8,9
20192020,114,WARREN,571,Warren County,305,Rivendell High School,571305,114571305,210573000839,GRREC,902,11,2,1,0,0,0,0,0,0,0,0,0,0,0,0,0,0,0,0,0,0,1,2,3,3
20192020,114,WARREN,571,Warren County,455,Warren County Day Treatment,571455,114571455,210573001540,GRREC,902,All Students,4,24,3,1,4,0,0,0,1,0,1,1,0,1,0,0,0,1,0,1,18,3,21,28
20192020,114,WARREN,571,Warren County,455,Warren County Day Treatment,571455,114571455,210573001540,GRREC,902,08,0,2,0,0,0,0,0,0,0,0,0,0,0,0,0,0,0,0,0,0,2,0,2,2
20192020,114,WARREN,571,Warren County,455,Warren County Day Treatment,571455,114571455,210573001540,GRREC,902,09,2,10,1,0,1,0,0,0,1,0,1,0,0,0,0,0,0,1,0,1,7,2,9,12
20192020,114,WARREN,571,Warren County,455,Warren County Day Treatment,571455,114571455,210573001540,GRREC,902,10,1,6,1,1,2,0,0,0,0,0,0,1,0,1,0,0,0,0,0,0,4,0,4,7
20192020,114,WARREN,571,Warren County,455,Warren County Day Treatment,571455,114571455,210573001540,GRREC,902,11,0,2,0,0,0,0,0,0,0,0,0,0,0,0,0,0,0,0,0,0,2,0,2,2
20192020,114,WARREN,571,Warren County,455,Warren County Day Treatment,571455,114571455,210573001540,GRREC,902,12,1,4,1,0,1,0,0,0,0,0,0,0,0,0,0,0,0,0,0,0,3,1,4,5
20192020,115,WASHINGTON,575,Washington County,"",---District Total---,575,"","",CKEC,901,All Students,817,865,70,52,122,0,0,0,6,4,10,60,77,137,0,1,1,28,47,75,701,636,1337,1682
20192020,115,WASHINGTON,575,Washington County,"",---District Total---,575,"","",CKEC,901,PS,32,51,2,2,4,0,0,0,1,0,1,3,3,6,0,0,0,3,3,6,42,24,66,83
20192020,115,WASHINGTON,575,Washington County,"",---District Total---,575,"","",CKEC,901,KG,68,70,5,4,9,0,0,0,0,0,0,9,10,19,0,0,0,7,7,14,49,47,96,138
20192020,115,WASHINGTON,575,Washington County,"",---District Total---,575,"","",CKEC,901,01,72,66,6,6,12,0,0,0,3,1,4,3,7,10,0,0,0,2,7,9,52,51,103,138
20192020,115,WASHINGTON,575,Washington County,"",---District Total---,575,"","",CKEC,901,02,55,42,2,2,4,0,0,0,1,0,1,2,4,6,0,0,0,4,5,9,33,44,77,97
20192020,115,WASHINGTON,575,Washington County,"",---District Total---,575,"","",CKEC,901,03,41,65,1,1,2,0,0,0,0,0,0,6,6,12,0,0,0,3,0,3,55,34,89,106
20192020,115,WASHINGTON,575,Washington County,"",---District Total---,575,"","",CKEC,901,04,56,58,8,4,12,0,0,0,0,0,0,4,7,11,0,1,1,1,4,5,45,40,85,114
20192020,115,WASHINGTON,575,Washington County,"",---District Total---,575,"","",CKEC,901,05,61,75,5,2,7,0,0,0,0,0,0,7,7,14,0,0,0,3,5,8,60,47,107,136
20192020,115,WASHINGTON,575,Washington County,"",---District Total---,575,"","",CKEC,901,06,58,77,2,2,4,0,0,0,0,0,0,6,6,12,0,0,0,3,3,6,66,47,113,135
20192020,115,WASHINGTON,575,Washington County,"",---District Total---,575,"","",CKEC,901,07,55,66,2,3,5,0,0,0,0,1,1,3,4,7,0,0,0,0,2,2,61,45,106,121
20192020,115,WASHINGTON,575,Washington County,"",---District Total---,575,"","",CKEC,901,08,65,62,5,5,10,0,0,0,0,1,1,5,7,12,0,0,0,1,5,6,51,47,98,127
20192020,115,WASHINGTON,575,Washington County,"",---District Total---,575,"","",CKEC,901,09,79,55,5,10,15,0,0,0,1,1,2,0,6,6,0,0,0,1,5,6,48,57,105,134
20192020,115,WASHINGTON,575,Washington County,"",---District Total---,575,"","",CKEC,901,10,77,66,7,4,11,0,0,0,0,0,0,6,5,11,0,0,0,0,1,1,53,67,120,143
20192020,115,WASHINGTON,575,Washington County,"",---District Total---,575,"","",CKEC,901,11,64,84,9,3,12,0,0,0,1,0,1,4,2,6,0,0,0,3,2,5,67,57,124,148
20192020,115,WASHINGTON,575,Washington County,"",---District Total---,575,"","",CKEC,901,12,66,77,12,6,18,0,0,0,0,0,0,5,6,11,0,0,0,0,1,1,60,53,113,143
20192020,115,WASHINGTON,575,Washington County,"",---District Total---,575,"","",CKEC,901,14,0,2,1,0,1,0,0,0,0,0,0,0,0,0,0,0,0,0,0,0,1,0,1,2
20192020,115,WASHINGTON,575,Washington County,021,Commander Academy,575021,115575021,210576002358,CKEC,901,All Students,31,40,3,4,7,0,0,0,0,0,0,2,2,4,0,0,0,0,1,1,35,24,59,71
20192020,115,WASHINGTON,575,Washington County,021,Commander Academy,575021,115575021,210576002358,CKEC,901,08,1,2,0,0,0,0,0,0,0,0,0,0,0,0,0,0,0,0,0,0,2,1,3,3
20192020,115,WASHINGTON,575,Washington County,021,Commander Academy,575021,115575021,210576002358,CKEC,901,09,4,7,0,1,1,0,0,0,0,0,0,0,0,0,0,0,0,0,0,0,7,3,10,11
20192020,115,WASHINGTON,575,Washington County,021,Commander Academy,575021,115575021,210576002358,CKEC,901,10,7,10,1,1,2,0,0,0,0,0,0,1,0,1,0,0,0,0,0,0,8,6,14,17
20192020,115,WASHINGTON,575,Washington County,021,Commander Academy,575021,115575021,210576002358,CKEC,901,11,7,6,1,0,1,0,0,0,0,0,0,1,0,1,0,0,0,0,1,1,4,6,10,13
20192020,115,WASHINGTON,575,Washington County,021,Commander Academy,575021,115575021,210576002358,CKEC,901,12,12,15,1,2,3,0,0,0,0,0,0,0,2,2,0,0,0,0,0,0,14,8,22,27
20192020,115,WASHINGTON,575,Washington County,031,North Washington Elementary School,575031,115575031,210576001873,CKEC,901,All Students,239,270,1,0,1,0,0,0,1,1,2,7,8,15,0,0,0,6,7,13,255,223,478,509
20192020,115,WASHINGTON,575,Washington County,031,North Washington Elementary School,575031,115575031,210576001873,CKEC,901,PS,15,20,1,0,1,0,0,0,1,0,1,2,1,3,0,0,0,0,1,1,16,13,29,35
20192020,115,WASHINGTON,575,Washington County,031,North Washington Elementary School,575031,115575031,210576001873,CKEC,901,KG,29,32,0,0,0,0,0,0,0,0,0,2,1,3,0,0,0,1,0,1,29,28,57,61
20192020,115,WASHINGTON,575,Washington County,031,North Washington Elementary School,575031,115575031,210576001873,CKEC,901,01,28,30,0,0,0,0,0,0,1,1,2,0,1,1,0,0,0,0,1,1,29,25,54,58
20192020,115,WASHINGTON,575,Washington County,031,North Washington Elementary School,575031,115575031,210576001873,CKEC,901,02,22,19,0,0,0,0,0,0,0,0,0,1,0,1,0,0,0,2,2,4,16,20,36,41
20192020,115,WASHINGTON,575,Washington County,031,North Washington Elementary School,575031,115575031,210576001873,CKEC,901,03,20,29,0,0,0,0,0,0,0,0,0,1,0,1,0,0,0,0,0,0,28,20,48,49
20192020,115,WASHINGTON,575,Washington County,031,North Washington Elementary School,575031,115575031,210576001873,CKEC,901,04,23,25,0,0,0,0,0,0,0,0,0,0,1,1,0,0,0,0,0,0,25,22,47,48
20192020,115,WASHINGTON,575,Washington County,031,North Washington Elementary School,575031,115575031,210576001873,CKEC,901,05,30,33,1,0,1,0,0,0,0,0,0,1,1,2,0,0,0,1,1,2,30,28,58,63
20192020,115,WASHINGTON,575,Washington County,031,North Washington Elementary School,575031,115575031,210576001873,CKEC,901,06,26,43,0,0,0,0,0,0,0,0,0,1,1,2,0,0,0,2,0,2,40,25,65,69
20192020,115,WASHINGTON,575,Washington County,031,North Washington Elementary School,575031,115575031,210576001873,CKEC,901,07,33,35,0,0,0,0,0,0,0,0,0,1,1,2,0,0,0,0,1,1,34,31,65,68
20192020,115,WASHINGTON,575,Washington County,031,North Washington Elementary School,575031,115575031,210576001873,CKEC,901,08,28,24,0,0,0,0,0,0,0,0,0,0,2,2,0,0,0,0,2,2,24,24,48,52
20192020,115,WASHINGTON,575,Washington County,034,Washington County Middle School,575034,115575034,210576002047,CKEC,901,All Students,90,101,9,10,19,0,0,0,0,2,2,12,13,25,0,0,0,2,7,9,78,58,136,191
20192020,115,WASHINGTON,575,Washington County,034,Washington County Middle School,575034,115575034,210576002047,CKEC,901,06,32,34,2,2,4,0,0,0,0,0,0,5,5,10,0,0,0,1,3,4,26,22,48,66
20192020,115,WASHINGTON,575,Washington County,034,Washington County Middle School,575034,115575034,210576002047,CKEC,901,07,22,31,2,3,5,0,0,0,0,1,1,2,3,5,0,0,0,0,1,1,27,14,41,53
20192020,115,WASHINGTON,575,Washington County,034,Washington County Middle School,575034,115575034,210576002047,CKEC,901,08,36,36,5,5,10,0,0,0,0,1,1,5,5,10,0,0,0,1,3,4,25,22,47,72
20192020,115,WASHINGTON,575,Washington County,071,WC Tel Center,575071,115575071,210576002448,CKEC,901,All Students,0,0,0,0,0,0,0,0,0,0,0,0,0,0,0,0,0,0,0,0,0,0,0,0
20192020,115,WASHINGTON,575,Washington County,071,WC Tel Center,575071,115575071,210576002448,CKEC,901,09,0,0,0,0,0,0,0,0,0,0,0,0,0,0,0,0,0,0,0,0,0,0,0,0
20192020,115,WASHINGTON,575,Washington County,071,WC Tel Center,575071,115575071,210576002448,CKEC,901,10,0,0,0,0,0,0,0,0,0,0,0,0,0,0,0,0,0,0,0,0,0,0,0,0
20192020,115,WASHINGTON,575,Washington County,071,WC Tel Center,575071,115575071,210576002448,CKEC,901,11,0,0,0,0,0,0,0,0,0,0,0,0,0,0,0,0,0,0,0,0,0,0,0,0
20192020,115,WASHINGTON,575,Washington County,071,WC Tel Center,575071,115575071,210576002448,CKEC,901,12,0,0,0,0,0,0,0,0,0,0,0,0,0,0,0,0,0,0,0,0,0,0,0,0
20192020,115,WASHINGTON,575,Washington County,074,Washington County High School,575074,115575074,210576001358,CKEC,901,All Students,256,246,31,19,50,0,0,0,2,1,3,13,17,30,0,0,0,4,8,12,196,211,407,502
20192020,115,WASHINGTON,575,Washington County,074,Washington County High School,575074,115575074,210576001358,CKEC,901,09,75,48,5,9,14,0,0,0,1,1,2,0,6,6,0,0,0,1,5,6,41,54,95,123
20192020,115,WASHINGTON,575,Washington County,074,Washington County High School,575074,115575074,210576001358,CKEC,901,10,70,56,6,3,9,0,0,0,0,0,0,5,5,10,0,0,0,0,1,1,45,61,106,126
20192020,115,WASHINGTON,575,Washington County,074,Washington County High School,575074,115575074,210576001358,CKEC,901,11,57,78,8,3,11,0,0,0,1,0,1,3,2,5,0,0,0,3,1,4,63,51,114,135
20192020,115,WASHINGTON,575,Washington County,074,Washington County High School,575074,115575074,210576001358,CKEC,901,12,54,62,11,4,15,0,0,0,0,0,0,5,4,9,0,0,0,0,1,1,46,45,91,116
20192020,115,WASHINGTON,575,Washington County,074,Washington County High School,575074,115575074,210576001358,CKEC,901,14,0,2,1,0,1,0,0,0,0,0,0,0,0,0,0,0,0,0,0,0,1,0,1,2
20192020,115,WASHINGTON,575,Washington County,080,Washington County Elementary School,575080,115575080,210576001359,CKEC,901,All Students,201,208,26,19,45,0,0,0,3,0,3,26,37,63,0,1,1,16,24,40,137,120,257,409
20192020,115,WASHINGTON,575,Washington County,080,Washington County Elementary School,575080,115575080,210576001359,CKEC,901,PS,17,31,1,2,3,0,0,0,0,0,0,1,2,3,0,0,0,3,2,5,26,11,37,48
20192020,115,WASHINGTON,575,Washington County,080,Washington County Elementary School,575080,115575080,210576001359,CKEC,901,KG,39,38,5,4,9,0,0,0,0,0,0,7,9,16,0,0,0,6,7,13,20,19,39,77
20192020,115,WASHINGTON,575,Washington County,080,Washington County Elementary School,575080,115575080,210576001359,CKEC,901,01,44,36,6,6,12,0,0,0,2,0,2,3,6,9,0,0,0,2,6,8,23,26,49,80
20192020,115,WASHINGTON,575,Washington County,080,Washington County Elementary School,575080,115575080,210576001359,CKEC,901,02,33,23,2,2,4,0,0,0,1,0,1,1,4,5,0,0,0,2,3,5,17,24,41,56
20192020,115,WASHINGTON,575,Washington County,080,Washington County Elementary School,575080,115575080,210576001359,CKEC,901,03,21,36,1,1,2,0,0,0,0,0,0,5,6,11,0,0,0,3,0,3,27,14,41,57
20192020,115,WASHINGTON,575,Washington County,080,Washington County Elementary School,575080,115575080,210576001359,CKEC,901,04,33,33,8,4,12,0,0,0,0,0,0,4,6,10,0,1,1,1,4,5,20,18,38,66
20192020,115,WASHINGTON,575,Washington County,080,Washington County Elementary School,575080,115575080,210576001359,CKEC,901,05,31,42,4,2,6,0,0,0,0,0,0,6,6,12,0,0,0,2,4,6,30,19,49,73
20192020,116,WAYNE,581,Wayne County,"",---District Total---,581,"","",SESC,907,All Students,1488,1573,30,23,53,0,1,1,5,5,10,136,133,269,1,1,2,21,19,40,1380,1306,2686,3061
20192020,116,WAYNE,581,Wayne County,"",---District Total---,581,"","",SESC,907,PS,90,107,0,1,1,0,0,0,0,0,0,7,11,18,0,0,0,4,0,4,96,78,174,197
20192020,116,WAYNE,581,Wayne County,"",---District Total---,581,"","",SESC,907,KG,90,105,0,0,0,0,0,0,1,0,1,11,8,19,0,0,0,1,0,1,92,82,174,195
20192020,116,WAYNE,581,Wayne County,"",---District Total---,581,"","",SESC,907,01,109,122,1,1,2,0,0,0,0,0,0,5,10,15,0,0,0,1,2,3,115,96,211,231
20192020,116,WAYNE,581,Wayne County,"",---District Total---,581,"","",SESC,907,02,108,118,0,1,1,0,0,0,0,1,1,12,15,27,0,0,0,2,3,5,104,88,192,226
20192020,116,WAYNE,581,Wayne County,"",---District Total---,581,"","",SESC,907,03,111,111,0,0,0,0,0,0,0,1,1,10,11,21,0,0,0,3,5,8,98,94,192,222
20192020,116,WAYNE,581,Wayne County,"",---District Total---,581,"","",SESC,907,04,103,107,0,0,0,0,0,0,0,1,1,15,16,31,0,0,0,0,1,1,92,85,177,210
20192020,116,WAYNE,581,Wayne County,"",---District Total---,581,"","",SESC,907,05,103,127,1,1,2,0,0,0,0,1,1,17,5,22,0,0,0,6,2,8,103,94,197,230
20192020,116,WAYNE,581,Wayne County,"",---District Total---,581,"","",SESC,907,06,125,117,1,2,3,0,0,0,1,1,2,8,18,26,0,0,0,3,1,4,104,103,207,242
20192020,116,WAYNE,581,Wayne County,"",---District Total---,581,"","",SESC,907,07,118,111,3,2,5,0,0,0,2,0,2,10,13,23,0,0,0,2,1,3,94,102,196,229
20192020,116,WAYNE,581,Wayne County,"",---District Total---,581,"","",SESC,907,08,142,115,5,4,9,0,0,0,0,0,0,12,7,19,0,1,1,0,1,1,98,129,227,257
20192020,116,WAYNE,581,Wayne County,"",---District Total---,581,"","",SESC,907,09,120,124,3,2,5,0,1,1,0,0,0,10,10,20,0,0,0,0,0,0,111,107,218,244
20192020,116,WAYNE,581,Wayne County,"",---District Total---,581,"","",SESC,907,10,116,142,7,3,10,0,0,0,1,0,1,11,4,15,0,0,0,1,1,2,122,108,230,258
20192020,116,WAYNE,581,Wayne County,"",---District Total---,581,"","",SESC,907,11,130,135,4,3,7,0,0,0,0,0,0,7,8,15,0,0,0,0,1,1,124,118,242,265
20192020,116,WAYNE,581,Wayne County,"",---District Total---,581,"","",SESC,907,12,113,138,5,4,9,0,0,0,0,0,0,8,8,16,1,0,1,2,1,3,122,100,222,251
20192020,116,WAYNE,581,Wayne County,"",---District Total---,581,"","",SESC,907,14,0,1,0,0,0,0,0,0,0,0,0,0,0,0,0,0,0,0,0,0,1,0,1,1
20192020,116,WAYNE,581,Wayne County,051,Wayne County Middle School,581051,116581051,210579002020,SESC,907,All Students,376,339,9,6,15,0,0,0,3,1,4,30,36,66,0,1,1,5,3,8,292,329,621,715
20192020,116,WAYNE,581,Wayne County,051,Wayne County Middle School,581051,116581051,210579002020,SESC,907,06,125,116,1,2,3,0,0,0,1,1,2,8,18,26,0,0,0,3,1,4,103,103,206,241
20192020,116,WAYNE,581,Wayne County,051,Wayne County Middle School,581051,116581051,210579002020,SESC,907,07,117,111,3,2,5,0,0,0,2,0,2,10,13,23,0,0,0,2,1,3,94,101,195,228
20192020,116,WAYNE,581,Wayne County,051,Wayne County Middle School,581051,116581051,210579002020,SESC,907,08,134,112,5,2,7,0,0,0,0,0,0,12,5,17,0,1,1,0,1,1,95,125,220,246
20192020,116,WAYNE,581,Wayne County,060,Wayne County Learning Academy,581060,116581060,210579002403,SESC,907,All Students,19,31,2,1,3,0,0,0,0,0,0,0,2,2,0,0,0,0,1,1,29,15,44,50
20192020,116,WAYNE,581,Wayne County,060,Wayne County Learning Academy,581060,116581060,210579002403,SESC,907,06,0,1,0,0,0,0,0,0,0,0,0,0,0,0,0,0,0,0,0,0,1,0,1,1
20192020,116,WAYNE,581,Wayne County,060,Wayne County Learning Academy,581060,116581060,210579002403,SESC,907,08,2,3,0,0,0,0,0,0,0,0,0,0,1,1,0,0,0,0,0,0,3,1,4,5
20192020,116,WAYNE,581,Wayne County,060,Wayne County Learning Academy,581060,116581060,210579002403,SESC,907,09,1,0,0,0,0,0,0,0,0,0,0,0,1,1,0,0,0,0,0,0,0,0,0,1
20192020,116,WAYNE,581,Wayne County,060,Wayne County Learning Academy,581060,116581060,210579002403,SESC,907,10,1,12,2,0,2,0,0,0,0,0,0,0,0,0,0,0,0,0,1,1,10,0,10,13
20192020,116,WAYNE,581,Wayne County,060,Wayne County Learning Academy,581060,116581060,210579002403,SESC,907,11,10,5,0,1,1,0,0,0,0,0,0,0,0,0,0,0,0,0,0,0,5,9,14,15
20192020,116,WAYNE,581,Wayne County,060,Wayne County Learning Academy,581060,116581060,210579002403,SESC,907,12,5,10,0,0,0,0,0,0,0,0,0,0,0,0,0,0,0,0,0,0,10,5,15,15
20192020,116,WAYNE,581,Wayne County,170,Lake Cumberland Youth Development Center,581170,116581170,210579001361,SESC,907,All Students,0,21,11,0,11,0,0,0,0,0,0,0,0,0,0,0,0,3,0,3,7,0,7,21
20192020,116,WAYNE,581,Wayne County,170,Lake Cumberland Youth Development Center,581170,116581170,210579001361,SESC,907,09,0,2,1,0,1,0,0,0,0,0,0,0,0,0,0,0,0,0,0,0,1,0,1,2
20192020,116,WAYNE,581,Wayne County,170,Lake Cumberland Youth Development Center,581170,116581170,210579001361,SESC,907,10,0,5,3,0,3,0,0,0,0,0,0,0,0,0,0,0,0,1,0,1,1,0,1,5
20192020,116,WAYNE,581,Wayne County,170,Lake Cumberland Youth Development Center,581170,116581170,210579001361,SESC,907,11,0,2,2,0,2,0,0,0,0,0,0,0,0,0,0,0,0,0,0,0,0,0,0,2
20192020,116,WAYNE,581,Wayne County,170,Lake Cumberland Youth Development Center,581170,116581170,210579001361,SESC,907,12,0,12,5,0,5,0,0,0,0,0,0,0,0,0,0,0,0,2,0,2,5,0,5,12
20192020,116,WAYNE,581,Wayne County,180,Otter Creek Academy,581180,116581180,210579002250,SESC,907,All Students,43,0,0,5,5,0,0,0,0,0,0,0,2,2,0,0,0,0,2,2,0,34,34,43
20192020,116,WAYNE,581,Wayne County,180,Otter Creek Academy,581180,116581180,210579002250,SESC,907,07,1,0,0,0,0,0,0,0,0,0,0,0,0,0,0,0,0,0,0,0,0,1,1,1
20192020,116,WAYNE,581,Wayne County,180,Otter Creek Academy,581180,116581180,210579002250,SESC,907,08,6,0,0,2,2,0,0,0,0,0,0,0,1,1,0,0,0,0,0,0,0,3,3,6
20192020,116,WAYNE,581,Wayne County,180,Otter Creek Academy,581180,116581180,210579002250,SESC,907,09,9,0,0,1,1,0,0,0,0,0,0,0,0,0,0,0,0,0,0,0,0,8,8,9
20192020,116,WAYNE,581,Wayne County,180,Otter Creek Academy,581180,116581180,210579002250,SESC,907,10,7,0,0,1,1,0,0,0,0,0,0,0,1,1,0,0,0,0,0,0,0,5,5,7
20192020,116,WAYNE,581,Wayne County,180,Otter Creek Academy,581180,116581180,210579002250,SESC,907,11,14,0,0,0,0,0,0,0,0,0,0,0,0,0,0,0,0,0,1,1,0,13,13,14
20192020,116,WAYNE,581,Wayne County,180,Otter Creek Academy,581180,116581180,210579002250,SESC,907,12,6,0,0,1,1,0,0,0,0,0,0,0,0,0,0,0,0,0,1,1,0,4,4,6
20192020,116,WAYNE,581,Wayne County,190,Monticello Elementary School,581190,116581190,210579002346,SESC,907,All Students,317,345,1,1,2,0,0,0,0,3,3,42,32,74,0,0,0,9,8,17,293,273,566,662
20192020,116,WAYNE,581,Wayne County,190,Monticello Elementary School,581190,116581190,210579002346,SESC,907,03,111,111,0,0,0,0,0,0,0,1,1,10,11,21,0,0,0,3,5,8,98,94,192,222
20192020,116,WAYNE,581,Wayne County,190,Monticello Elementary School,581190,116581190,210579002346,SESC,907,04,103,107,0,0,0,0,0,0,0,1,1,15,16,31,0,0,0,0,1,1,92,85,177,210
20192020,116,WAYNE,581,Wayne County,190,Monticello Elementary School,581190,116581190,210579002346,SESC,907,05,103,127,1,1,2,0,0,0,0,1,1,17,5,22,0,0,0,6,2,8,103,94,197,230
20192020,116,WAYNE,581,Wayne County,200,Wayne County High School,581200,116581200,210579001224,SESC,907,All Students,426,492,6,8,14,0,1,1,1,0,1,36,28,64,1,0,1,0,0,0,448,389,837,918
20192020,116,WAYNE,581,Wayne County,200,Wayne County High School,581200,116581200,210579001224,SESC,907,09,110,122,2,1,3,0,1,1,0,0,0,10,9,19,0,0,0,0,0,0,110,99,209,232
20192020,116,WAYNE,581,Wayne County,200,Wayne County High School,581200,116581200,210579001224,SESC,907,10,108,125,2,2,4,0,0,0,1,0,1,11,3,14,0,0,0,0,0,0,111,103,214,233
20192020,116,WAYNE,581,Wayne County,200,Wayne County High School,581200,116581200,210579001224,SESC,907,11,106,128,2,2,4,0,0,0,0,0,0,7,8,15,0,0,0,0,0,0,119,96,215,234
20192020,116,WAYNE,581,Wayne County,200,Wayne County High School,581200,116581200,210579001224,SESC,907,12,102,116,0,3,3,0,0,0,0,0,0,8,8,16,1,0,1,0,0,0,107,91,198,218
20192020,116,WAYNE,581,Wayne County,200,Wayne County High School,581200,116581200,210579001224,SESC,907,14,0,1,0,0,0,0,0,0,0,0,0,0,0,0,0,0,0,0,0,0,1,0,1,1
20192020,116,WAYNE,581,Wayne County,430,Walker Early Learning Center,581430,116581430,210579001365,SESC,907,All Students,90,105,0,0,0,0,0,0,1,0,1,11,8,19,0,0,0,1,0,1,92,82,174,195
20192020,116,WAYNE,581,Wayne County,430,Walker Early Learning Center,581430,116581430,210579001365,SESC,907,PS,90,107,0,1,1,0,0,0,0,0,0,7,11,18,0,0,0,4,0,4,96,78,174,197
20192020,116,WAYNE,581,Wayne County,430,Walker Early Learning Center,581430,116581430,210579001365,SESC,907,KG,90,105,0,0,0,0,0,0,1,0,1,11,8,19,0,0,0,1,0,1,92,82,174,195
20192020,116,WAYNE,581,Wayne County,437,Bell Elementary School,581437,116581437,210579001367,SESC,907,All Students,217,240,1,2,3,0,0,0,0,1,1,17,25,42,0,0,0,3,5,8,219,184,403,457
20192020,116,WAYNE,581,Wayne County,437,Bell Elementary School,581437,116581437,210579001367,SESC,907,01,109,122,1,1,2,0,0,0,0,0,0,5,10,15,0,0,0,1,2,3,115,96,211,231
20192020,116,WAYNE,581,Wayne County,437,Bell Elementary School,581437,116581437,210579001367,SESC,907,02,108,118,0,1,1,0,0,0,0,1,1,12,15,27,0,0,0,2,3,5,104,88,192,226
20192020,117,WEBSTER,585,Webster County,"",---District Total---,585,"","",WKEC,908,All Students,1037,1050,28,29,57,4,1,5,0,3,3,178,163,341,1,2,3,33,37,70,806,802,1608,2087
20192020,117,WEBSTER,585,Webster County,"",---District Total---,585,"","",WKEC,908,PS,54,73,3,3,6,0,0,0,0,0,0,10,13,23,0,0,0,2,5,7,58,33,91,127
20192020,117,WEBSTER,585,Webster County,"",---District Total---,585,"","",WKEC,908,KG,80,87,3,1,4,1,0,1,0,0,0,17,13,30,0,0,0,5,6,11,61,60,121,167
20192020,117,WEBSTER,585,Webster County,"",---District Total---,585,"","",WKEC,908,01,75,69,1,5,6,1,0,1,0,0,0,13,10,23,0,0,0,5,3,8,49,57,106,144
20192020,117,WEBSTER,585,Webster County,"",---District Total---,585,"","",WKEC,908,02,66,66,1,5,6,0,0,0,0,0,0,19,13,32,0,1,1,2,2,4,44,45,89,132
20192020,117,WEBSTER,585,Webster County,"",---District Total---,585,"","",WKEC,908,03,81,89,0,0,0,0,0,0,0,0,0,16,17,33,0,0,0,4,2,6,69,62,131,170
20192020,117,WEBSTER,585,Webster County,"",---District Total---,585,"","",WKEC,908,04,86,67,0,1,1,0,1,1,0,0,0,9,13,22,0,0,0,1,3,4,57,68,125,153
20192020,117,WEBSTER,585,Webster County,"",---District Total---,585,"","",WKEC,908,05,87,70,3,3,6,0,0,0,0,0,0,13,19,32,0,0,0,1,2,3,53,63,116,157
20192020,117,WEBSTER,585,Webster County,"",---District Total---,585,"","",WKEC,908,06,86,91,0,1,1,0,0,0,0,1,1,14,15,29,0,0,0,1,3,4,76,66,142,177
20192020,117,WEBSTER,585,Webster County,"",---District Total---,585,"","",WKEC,908,07,87,106,2,1,3,1,0,1,0,1,1,13,15,28,0,1,1,3,2,5,87,67,154,193
20192020,117,WEBSTER,585,Webster County,"",---District Total---,585,"","",WKEC,908,08,80,87,4,4,8,0,0,0,0,0,0,11,11,22,1,0,1,3,2,5,68,63,131,167
20192020,117,WEBSTER,585,Webster County,"",---District Total---,585,"","",WKEC,908,09,87,92,2,2,4,1,0,1,0,1,1,19,11,30,0,0,0,3,4,7,67,69,136,179
20192020,117,WEBSTER,585,Webster County,"",---District Total---,585,"","",WKEC,908,10,66,74,3,2,5,0,0,0,0,0,0,14,5,19,0,0,0,1,5,6,56,54,110,140
20192020,117,WEBSTER,585,Webster County,"",---District Total---,585,"","",WKEC,908,11,78,80,5,1,6,0,0,0,0,0,0,9,13,22,0,0,0,2,2,4,64,62,126,158
20192020,117,WEBSTER,585,Webster County,"",---District Total---,585,"","",WKEC,908,12,78,69,4,3,7,0,0,0,0,0,0,11,8,19,0,0,0,2,1,3,52,66,118,147
20192020,117,WEBSTER,585,Webster County,"",---District Total---,585,"","",WKEC,908,14,0,3,0,0,0,0,0,0,0,0,0,0,0,0,0,0,0,0,0,0,3,0,3,3
20192020,117,WEBSTER,585,Webster County,020,Clay Elementary School,585020,117585020,210582001369,WKEC,908,All Students,107,78,0,0,0,0,0,0,0,0,0,1,2,3,0,0,0,0,2,2,77,103,180,185
20192020,117,WEBSTER,585,Webster County,020,Clay Elementary School,585020,117585020,210582001369,WKEC,908,PS,4,15,0,0,0,0,0,0,0,0,0,0,0,0,0,0,0,0,1,1,15,3,18,19
20192020,117,WEBSTER,585,Webster County,020,Clay Elementary School,585020,117585020,210582001369,WKEC,908,KG,13,15,0,0,0,0,0,0,0,0,0,1,0,1,0,0,0,0,0,0,14,13,27,28
20192020,117,WEBSTER,585,Webster County,020,Clay Elementary School,585020,117585020,210582001369,WKEC,908,01,14,10,0,0,0,0,0,0,0,0,0,0,0,0,0,0,0,0,1,1,10,13,23,24
20192020,117,WEBSTER,585,Webster County,020,Clay Elementary School,585020,117585020,210582001369,WKEC,908,02,16,8,0,0,0,0,0,0,0,0,0,0,0,0,0,0,0,0,0,0,8,16,24,24
20192020,117,WEBSTER,585,Webster County,020,Clay Elementary School,585020,117585020,210582001369,WKEC,908,03,15,10,0,0,0,0,0,0,0,0,0,0,1,1,0,0,0,0,1,1,10,13,23,25
20192020,117,WEBSTER,585,Webster County,020,Clay Elementary School,585020,117585020,210582001369,WKEC,908,04,14,10,0,0,0,0,0,0,0,0,0,0,1,1,0,0,0,0,0,0,10,13,23,24
20192020,117,WEBSTER,585,Webster County,020,Clay Elementary School,585020,117585020,210582001369,WKEC,908,05,18,7,0,0,0,0,0,0,0,0,0,0,0,0,0,0,0,0,0,0,7,18,25,25
20192020,117,WEBSTER,585,Webster County,020,Clay Elementary School,585020,117585020,210582001369,WKEC,908,06,17,18,0,0,0,0,0,0,0,0,0,0,0,0,0,0,0,0,0,0,18,17,35,35
20192020,117,WEBSTER,585,Webster County,050,Dixon Elementary School,585050,117585050,210582001370,WKEC,908,All Students,155,174,1,1,2,0,1,1,0,0,0,3,4,7,0,1,1,4,3,7,166,145,311,329
20192020,117,WEBSTER,585,Webster County,050,Dixon Elementary School,585050,117585050,210582001370,WKEC,908,KG,23,24,1,0,1,0,0,0,0,0,0,1,1,2,0,0,0,0,2,2,22,20,42,47
20192020,117,WEBSTER,585,Webster County,050,Dixon Elementary School,585050,117585050,210582001370,WKEC,908,01,22,22,0,1,1,0,0,0,0,0,0,0,1,1,0,0,0,1,0,1,21,20,41,44
20192020,117,WEBSTER,585,Webster County,050,Dixon Elementary School,585050,117585050,210582001370,WKEC,908,02,14,25,0,0,0,0,0,0,0,0,0,1,1,2,0,1,1,1,0,1,23,12,35,39
20192020,117,WEBSTER,585,Webster County,050,Dixon Elementary School,585050,117585050,210582001370,WKEC,908,03,22,25,0,0,0,0,0,0,0,0,0,0,0,0,0,0,0,1,0,1,24,22,46,47
20192020,117,WEBSTER,585,Webster County,050,Dixon Elementary School,585050,117585050,210582001370,WKEC,908,04,30,28,0,0,0,0,1,1,0,0,0,0,0,0,0,0,0,0,0,0,28,29,57,58
20192020,117,WEBSTER,585,Webster County,050,Dixon Elementary School,585050,117585050,210582001370,WKEC,908,05,23,19,0,0,0,0,0,0,0,0,0,0,1,1,0,0,0,0,1,1,19,21,40,42
20192020,117,WEBSTER,585,Webster County,050,Dixon Elementary School,585050,117585050,210582001370,WKEC,908,06,21,31,0,0,0,0,0,0,0,0,0,1,0,1,0,0,0,1,0,1,29,21,50,52
20192020,117,WEBSTER,585,Webster County,060,Providence Elementary School,585060,117585060,210582002188,WKEC,908,All Students,114,111,6,13,19,2,0,2,0,0,0,8,2,10,0,0,0,13,11,24,82,88,170,225
20192020,117,WEBSTER,585,Webster County,060,Providence Elementary School,585060,117585060,210582002188,WKEC,908,PS,26,30,3,1,4,0,0,0,0,0,0,2,1,3,0,0,0,2,4,6,23,20,43,56
20192020,117,WEBSTER,585,Webster County,060,Providence Elementary School,585060,117585060,210582002188,WKEC,908,KG,18,17,1,1,2,1,0,1,0,0,0,2,0,2,0,0,0,5,3,8,8,14,22,35
20192020,117,WEBSTER,585,Webster County,060,Providence Elementary School,585060,117585060,210582002188,WKEC,908,01,21,11,1,4,5,1,0,1,0,0,0,1,0,1,0,0,0,3,2,5,5,15,20,32
20192020,117,WEBSTER,585,Webster County,060,Providence Elementary School,585060,117585060,210582002188,WKEC,908,02,15,13,1,5,6,0,0,0,0,0,0,2,0,2,0,0,0,1,2,3,9,8,17,28
20192020,117,WEBSTER,585,Webster County,060,Providence Elementary School,585060,117585060,210582002188,WKEC,908,03,14,22,0,0,0,0,0,0,0,0,0,0,1,1,0,0,0,2,0,2,20,13,33,36
20192020,117,WEBSTER,585,Webster County,060,Providence Elementary School,585060,117585060,210582002188,WKEC,908,04,14,14,0,1,1,0,0,0,0,0,0,1,0,1,0,0,0,1,1,2,12,12,24,28
20192020,117,WEBSTER,585,Webster County,060,Providence Elementary School,585060,117585060,210582002188,WKEC,908,05,16,21,3,1,4,0,0,0,0,0,0,1,1,2,0,0,0,1,1,2,16,13,29,37
20192020,117,WEBSTER,585,Webster County,060,Providence Elementary School,585060,117585060,210582002188,WKEC,908,06,16,13,0,1,1,0,0,0,0,0,0,1,0,1,0,0,0,0,2,2,12,13,25,29
20192020,117,WEBSTER,585,Webster County,090,Sebree Elementary School,585090,117585090,210582001372,WKEC,908,All Students,185,176,1,2,3,0,0,0,0,1,1,89,92,181,0,0,0,2,5,7,84,85,169,361
20192020,117,WEBSTER,585,Webster County,090,Sebree Elementary School,585090,117585090,210582001372,WKEC,908,PS,24,28,0,2,2,0,0,0,0,0,0,8,12,20,0,0,0,0,0,0,20,10,30,52
20192020,117,WEBSTER,585,Webster County,090,Sebree Elementary School,585090,117585090,210582001372,WKEC,908,KG,26,31,1,0,1,0,0,0,0,0,0,13,12,25,0,0,0,0,1,1,17,13,30,57
20192020,117,WEBSTER,585,Webster County,090,Sebree Elementary School,585090,117585090,210582001372,WKEC,908,01,18,26,0,0,0,0,0,0,0,0,0,12,9,21,0,0,0,1,0,1,13,9,22,44
20192020,117,WEBSTER,585,Webster County,090,Sebree Elementary School,585090,117585090,210582001372,WKEC,908,02,21,20,0,0,0,0,0,0,0,0,0,16,12,28,0,0,0,0,0,0,4,9,13,41
20192020,117,WEBSTER,585,Webster County,090,Sebree Elementary School,585090,117585090,210582001372,WKEC,908,03,30,32,0,0,0,0,0,0,0,0,0,16,15,31,0,0,0,1,1,2,15,14,29,62
20192020,117,WEBSTER,585,Webster County,090,Sebree Elementary School,585090,117585090,210582001372,WKEC,908,04,28,15,0,0,0,0,0,0,0,0,0,8,12,20,0,0,0,0,2,2,7,14,21,43
20192020,117,WEBSTER,585,Webster County,090,Sebree Elementary School,585090,117585090,210582001372,WKEC,908,05,30,23,0,2,2,0,0,0,0,0,0,12,17,29,0,0,0,0,0,0,11,11,22,53
20192020,117,WEBSTER,585,Webster County,090,Sebree Elementary School,585090,117585090,210582001372,WKEC,908,06,32,29,0,0,0,0,0,0,0,1,1,12,15,27,0,0,0,0,1,1,17,15,32,61
20192020,117,WEBSTER,585,Webster County,125,Webster County Middle School,585125,117585125,210582002348,WKEC,908,All Students,167,193,6,5,11,1,0,1,0,1,1,24,26,50,1,1,2,6,4,10,155,130,285,360
20192020,117,WEBSTER,585,Webster County,125,Webster County Middle School,585125,117585125,210582002348,WKEC,908,07,87,106,2,1,3,1,0,1,0,1,1,13,15,28,0,1,1,3,2,5,87,67,154,193
20192020,117,WEBSTER,585,Webster County,125,Webster County Middle School,585125,117585125,210582002348,WKEC,908,08,80,87,4,4,8,0,0,0,0,0,0,11,11,22,1,0,1,3,2,5,68,63,131,167
20192020,117,WEBSTER,585,Webster County,130,Webster County High School,585130,117585130,210582001374,WKEC,908,All Students,309,318,14,8,22,1,0,1,0,1,1,53,37,90,0,0,0,8,12,20,242,251,493,627
20192020,117,WEBSTER,585,Webster County,130,Webster County High School,585130,117585130,210582001374,WKEC,908,09,87,92,2,2,4,1,0,1,0,1,1,19,11,30,0,0,0,3,4,7,67,69,136,179
20192020,117,WEBSTER,585,Webster County,130,Webster County High School,585130,117585130,210582001374,WKEC,908,10,66,74,3,2,5,0,0,0,0,0,0,14,5,19,0,0,0,1,5,6,56,54,110,140
20192020,117,WEBSTER,585,Webster County,130,Webster County High School,585130,117585130,210582001374,WKEC,908,11,78,80,5,1,6,0,0,0,0,0,0,9,13,22,0,0,0,2,2,4,64,62,126,158
20192020,117,WEBSTER,585,Webster County,130,Webster County High School,585130,117585130,210582001374,WKEC,908,12,78,69,4,3,7,0,0,0,0,0,0,11,8,19,0,0,0,2,1,3,52,66,118,147
20192020,117,WEBSTER,585,Webster County,130,Webster County High School,585130,117585130,210582001374,WKEC,908,14,0,3,0,0,0,0,0,0,0,0,0,0,0,0,0,0,0,0,0,0,3,0,3,3
20192020,047,HARDIN,586,West Point Independent,"",---District Total---,586,"","",GRREC,902,02,1,3,0,0,0,0,0,0,0,0,0,0,0,0,0,0,0,0,0,0,3,1,4,4
20192020,047,HARDIN,586,West Point Independent,"",---District Total---,586,"","",GRREC,902,All Students,61,64,0,1,1,0,1,1,1,1,2,0,0,0,0,0,0,1,1,2,62,57,119,125
20192020,047,HARDIN,586,West Point Independent,"",---District Total---,586,"","",GRREC,902,PS,10,10,2,0,2,0,0,0,0,0,0,0,0,0,0,1,1,0,1,1,8,8,16,20
20192020,047,HARDIN,586,West Point Independent,"",---District Total---,586,"","",GRREC,902,KG,10,4,0,0,0,0,0,0,0,0,0,0,0,0,0,0,0,0,0,0,4,10,14,14
20192020,047,HARDIN,586,West Point Independent,"",---District Total---,586,"","",GRREC,902,01,10,8,0,1,1,0,0,0,0,0,0,0,0,0,0,0,0,0,0,0,8,9,17,18
20192020,047,HARDIN,586,West Point Independent,"",---District Total---,586,"","",GRREC,902,03,5,7,0,0,0,0,1,1,1,0,1,0,0,0,0,0,0,0,0,0,6,4,10,12
20192020,047,HARDIN,586,West Point Independent,"",---District Total---,586,"","",GRREC,902,04,7,5,0,0,0,0,0,0,0,0,0,0,0,0,0,0,0,0,0,0,5,7,12,12
20192020,047,HARDIN,586,West Point Independent,"",---District Total---,586,"","",GRREC,902,05,7,4,0,0,0,0,0,0,0,0,0,0,0,0,0,0,0,0,0,0,4,7,11,11
20192020,047,HARDIN,586,West Point Independent,"",---District Total---,586,"","",GRREC,902,06,6,11,0,0,0,0,0,0,0,0,0,0,0,0,0,0,0,0,0,0,11,6,17,17
20192020,047,HARDIN,586,West Point Independent,"",---District Total---,586,"","",GRREC,902,07,8,14,0,0,0,0,0,0,0,1,1,0,0,0,0,0,0,1,0,1,13,7,20,22
20192020,047,HARDIN,586,West Point Independent,"",---District Total---,586,"","",GRREC,902,08,7,8,0,0,0,0,0,0,0,0,0,0,0,0,0,0,0,0,1,1,8,6,14,15
20192020,047,HARDIN,586,West Point Independent,010,West Point Elementary School,586010,047586010,210585001375,GRREC,902,All Students,61,64,0,1,1,0,1,1,1,1,2,0,0,0,0,0,0,1,1,2,62,57,119,125
20192020,047,HARDIN,586,West Point Independent,010,West Point Elementary School,586010,047586010,210585001375,GRREC,902,KG,10,4,0,0,0,0,0,0,0,0,0,0,0,0,0,0,0,0,0,0,4,10,14,14
20192020,047,HARDIN,586,West Point Independent,010,West Point Elementary School,586010,047586010,210585001375,GRREC,902,01,10,8,0,1,1,0,0,0,0,0,0,0,0,0,0,0,0,0,0,0,8,9,17,18
20192020,047,HARDIN,586,West Point Independent,010,West Point Elementary School,586010,047586010,210585001375,GRREC,902,PS,10,10,2,0,2,0,0,0,0,0,0,0,0,0,0,1,1,0,1,1,8,8,16,20
20192020,047,HARDIN,586,West Point Independent,010,West Point Elementary School,586010,047586010,210585001375,GRREC,902,02,1,3,0,0,0,0,0,0,0,0,0,0,0,0,0,0,0,0,0,0,3,1,4,4
20192020,047,HARDIN,586,West Point Independent,010,West Point Elementary School,586010,047586010,210585001375,GRREC,902,03,5,7,0,0,0,0,1,1,1,0,1,0,0,0,0,0,0,0,0,0,6,4,10,12
20192020,047,HARDIN,586,West Point Independent,010,West Point Elementary School,586010,047586010,210585001375,GRREC,902,04,7,5,0,0,0,0,0,0,0,0,0,0,0,0,0,0,0,0,0,0,5,7,12,12
20192020,047,HARDIN,586,West Point Independent,010,West Point Elementary School,586010,047586010,210585001375,GRREC,902,05,7,4,0,0,0,0,0,0,0,0,0,0,0,0,0,0,0,0,0,0,4,7,11,11
20192020,047,HARDIN,586,West Point Independent,010,West Point Elementary School,586010,047586010,210585001375,GRREC,902,06,6,11,0,0,0,0,0,0,0,0,0,0,0,0,0,0,0,0,0,0,11,6,17,17
20192020,047,HARDIN,586,West Point Independent,010,West Point Elementary School,586010,047586010,210585001375,GRREC,902,07,8,14,0,0,0,0,0,0,0,1,1,0,0,0,0,0,0,1,0,1,13,7,20,22
20192020,047,HARDIN,586,West Point Independent,010,West Point Elementary School,586010,047586010,210585001375,GRREC,902,08,7,8,0,0,0,0,0,0,0,0,0,0,0,0,0,0,0,0,1,1,8,6,14,15
20192020,118,WHITLEY,591,Whitley County,"",---District Total---,591,"","",SESC,907,All Students,1933,2032,8,11,19,0,0,0,3,1,4,29,37,66,1,0,1,25,20,45,1966,1864,3830,3965
20192020,118,WHITLEY,591,Whitley County,"",---District Total---,591,"","",SESC,907,PS,175,188,0,0,0,0,0,0,0,0,0,4,4,8,0,0,0,2,2,4,182,169,351,363
20192020,118,WHITLEY,591,Whitley County,"",---District Total---,591,"","",SESC,907,KG,156,177,1,2,3,0,0,0,0,0,0,5,2,7,0,0,0,4,2,6,167,150,317,333
20192020,118,WHITLEY,591,Whitley County,"",---District Total---,591,"","",SESC,907,01,188,201,0,1,1,0,0,0,0,0,0,2,4,6,0,0,0,4,2,6,195,181,376,389
20192020,118,WHITLEY,591,Whitley County,"",---District Total---,591,"","",SESC,907,02,156,170,1,0,1,0,0,0,0,0,0,4,0,4,0,0,0,3,3,6,162,153,315,326
20192020,118,WHITLEY,591,Whitley County,"",---District Total---,591,"","",SESC,907,03,178,163,0,4,4,0,0,0,0,0,0,1,7,8,1,0,1,4,1,5,157,166,323,341
20192020,118,WHITLEY,591,Whitley County,"",---District Total---,591,"","",SESC,907,04,162,157,2,0,2,0,0,0,1,0,1,1,3,4,0,0,0,0,2,2,153,157,310,319
20192020,118,WHITLEY,591,Whitley County,"",---District Total---,591,"","",SESC,907,05,163,179,0,2,2,0,0,0,0,1,1,4,2,6,0,0,0,2,3,5,173,155,328,342
20192020,118,WHITLEY,591,Whitley County,"",---District Total---,591,"","",SESC,907,06,146,161,2,0,2,0,0,0,0,0,0,3,5,8,0,0,0,2,0,2,154,141,295,307
20192020,118,WHITLEY,591,Whitley County,"",---District Total---,591,"","",SESC,907,07,150,160,0,1,1,0,0,0,1,0,1,2,0,2,0,0,0,1,1,2,156,148,304,310
20192020,118,WHITLEY,591,Whitley County,"",---District Total---,591,"","",SESC,907,08,125,140,0,0,0,0,0,0,0,0,0,2,3,5,0,0,0,1,1,2,137,121,258,265
20192020,118,WHITLEY,591,Whitley County,"",---District Total---,591,"","",SESC,907,09,117,139,0,0,0,0,0,0,0,0,0,0,5,5,0,0,0,1,0,1,138,112,250,256
20192020,118,WHITLEY,591,Whitley County,"",---District Total---,591,"","",SESC,907,10,130,130,0,0,0,0,0,0,1,0,1,1,1,2,0,0,0,1,2,3,127,127,254,260
20192020,118,WHITLEY,591,Whitley County,"",---District Total---,591,"","",SESC,907,11,146,123,2,1,3,0,0,0,0,0,0,2,1,3,0,0,0,2,1,3,117,143,260,269
20192020,118,WHITLEY,591,Whitley County,"",---District Total---,591,"","",SESC,907,12,115,126,0,0,0,0,0,0,0,0,0,2,4,6,0,0,0,0,2,2,124,109,233,241
20192020,118,WHITLEY,591,Whitley County,"",---District Total---,591,"","",SESC,907,14,1,6,0,0,0,0,0,0,0,0,0,0,0,0,0,0,0,0,0,0,6,1,7,7
20192020,118,WHITLEY,591,Whitley County,010,Colonel Academy,591010,118591010,210588002497,SESC,907,All Students,48,17,0,0,0,0,0,0,0,0,0,1,4,5,0,0,0,0,0,0,16,44,60,65
20192020,118,WHITLEY,591,Whitley County,010,Colonel Academy,591010,118591010,210588002497,SESC,907,09,4,3,0,0,0,0,0,0,0,0,0,0,0,0,0,0,0,0,0,0,3,4,7,7
20192020,118,WHITLEY,591,Whitley County,010,Colonel Academy,591010,118591010,210588002497,SESC,907,10,7,1,0,0,0,0,0,0,0,0,0,0,0,0,0,0,0,0,0,0,1,7,8,8
20192020,118,WHITLEY,591,Whitley County,010,Colonel Academy,591010,118591010,210588002497,SESC,907,11,19,6,0,0,0,0,0,0,0,0,0,0,1,1,0,0,0,0,0,0,6,18,24,25
20192020,118,WHITLEY,591,Whitley County,010,Colonel Academy,591010,118591010,210588002497,SESC,907,12,18,7,0,0,0,0,0,0,0,0,0,1,3,4,0,0,0,0,0,0,6,15,21,25
20192020,118,WHITLEY,591,Whitley County,060,Boston Elementary School,591060,118591060,210588001376,SESC,907,All Students,96,97,0,0,0,0,0,0,0,0,0,1,1,2,0,0,0,1,1,2,95,94,189,193
20192020,118,WHITLEY,591,Whitley County,060,Boston Elementary School,591060,118591060,210588001376,SESC,907,PS,15,9,0,0,0,0,0,0,0,0,0,0,0,0,0,0,0,0,1,1,9,14,23,24
20192020,118,WHITLEY,591,Whitley County,060,Boston Elementary School,591060,118591060,210588001376,SESC,907,KG,16,9,0,0,0,0,0,0,0,0,0,0,0,0,0,0,0,0,0,0,9,16,25,25
20192020,118,WHITLEY,591,Whitley County,060,Boston Elementary School,591060,118591060,210588001376,SESC,907,01,12,12,0,0,0,0,0,0,0,0,0,0,0,0,0,0,0,0,1,1,12,11,23,24
20192020,118,WHITLEY,591,Whitley County,060,Boston Elementary School,591060,118591060,210588001376,SESC,907,02,11,12,0,0,0,0,0,0,0,0,0,1,0,1,0,0,0,1,0,1,10,11,21,23
20192020,118,WHITLEY,591,Whitley County,060,Boston Elementary School,591060,118591060,210588001376,SESC,907,03,12,12,0,0,0,0,0,0,0,0,0,0,1,1,0,0,0,0,0,0,12,11,23,24
20192020,118,WHITLEY,591,Whitley County,060,Boston Elementary School,591060,118591060,210588001376,SESC,907,04,7,17,0,0,0,0,0,0,0,0,0,0,0,0,0,0,0,0,0,0,17,7,24,24
20192020,118,WHITLEY,591,Whitley County,060,Boston Elementary School,591060,118591060,210588001376,SESC,907,05,19,14,0,0,0,0,0,0,0,0,0,0,0,0,0,0,0,0,0,0,14,19,33,33
20192020,118,WHITLEY,591,Whitley County,060,Boston Elementary School,591060,118591060,210588001376,SESC,907,06,19,21,0,0,0,0,0,0,0,0,0,0,0,0,0,0,0,0,0,0,21,19,40,40
20192020,118,WHITLEY,591,Whitley County,061,Whitley Central Intermediate School,591061,118591061,210588002048,SESC,907,05,51,62,0,1,1,0,0,0,0,1,1,2,0,2,0,0,0,0,1,1,60,48,108,113
20192020,118,WHITLEY,591,Whitley County,061,Whitley Central Intermediate School,591061,118591061,210588002048,SESC,907,All Students,231,233,1,3,4,0,0,0,1,1,2,5,2,7,1,0,1,3,2,5,222,223,445,464
20192020,118,WHITLEY,591,Whitley County,061,Whitley Central Intermediate School,591061,118591061,210588002048,SESC,907,03,63,60,0,2,2,0,0,0,0,0,0,0,1,1,1,0,1,2,0,2,57,60,117,123
20192020,118,WHITLEY,591,Whitley County,061,Whitley Central Intermediate School,591061,118591061,210588002048,SESC,907,04,64,58,1,0,1,0,0,0,1,0,1,1,0,1,0,0,0,0,1,1,55,63,118,122
20192020,118,WHITLEY,591,Whitley County,061,Whitley Central Intermediate School,591061,118591061,210588002048,SESC,907,06,53,53,0,0,0,0,0,0,0,0,0,2,1,3,0,0,0,1,0,1,50,52,102,106
20192020,118,WHITLEY,591,Whitley County,062,Whitley County East Elementary School,591062,118591062,210588002037,SESC,907,All Students,129,128,0,0,0,0,0,0,0,0,0,0,0,0,0,0,0,4,2,6,124,127,251,257
20192020,118,WHITLEY,591,Whitley County,062,Whitley County East Elementary School,591062,118591062,210588002037,SESC,907,PS,21,17,0,0,0,0,0,0,0,0,0,0,1,1,0,0,0,0,1,1,17,19,36,38
20192020,118,WHITLEY,591,Whitley County,062,Whitley County East Elementary School,591062,118591062,210588002037,SESC,907,KG,15,25,0,0,0,0,0,0,0,0,0,0,0,0,0,0,0,1,0,1,24,15,39,40
20192020,118,WHITLEY,591,Whitley County,062,Whitley County East Elementary School,591062,118591062,210588002037,SESC,907,01,26,19,0,0,0,0,0,0,0,0,0,0,0,0,0,0,0,1,0,1,18,26,44,45
20192020,118,WHITLEY,591,Whitley County,062,Whitley County East Elementary School,591062,118591062,210588002037,SESC,907,02,20,16,0,0,0,0,0,0,0,0,0,0,0,0,0,0,0,0,2,2,16,18,34,36
20192020,118,WHITLEY,591,Whitley County,062,Whitley County East Elementary School,591062,118591062,210588002037,SESC,907,03,15,21,0,0,0,0,0,0,0,0,0,0,0,0,0,0,0,1,0,1,20,15,35,36
20192020,118,WHITLEY,591,Whitley County,062,Whitley County East Elementary School,591062,118591062,210588002037,SESC,907,04,21,17,0,0,0,0,0,0,0,0,0,0,0,0,0,0,0,0,0,0,17,21,38,38
20192020,118,WHITLEY,591,Whitley County,062,Whitley County East Elementary School,591062,118591062,210588002037,SESC,907,05,13,21,0,0,0,0,0,0,0,0,0,0,0,0,0,0,0,1,0,1,20,13,33,34
20192020,118,WHITLEY,591,Whitley County,062,Whitley County East Elementary School,591062,118591062,210588002037,SESC,907,06,19,9,0,0,0,0,0,0,0,0,0,0,0,0,0,0,0,0,0,0,9,19,28,28
20192020,118,WHITLEY,591,Whitley County,225,Whitley County Alternative School,591225,118591225,210588001262,SESC,907,All Students,17,36,0,0,0,0,0,0,0,0,0,0,0,0,0,0,0,0,0,0,36,17,53,53
20192020,118,WHITLEY,591,Whitley County,225,Whitley County Alternative School,591225,118591225,210588001262,SESC,907,07,3,2,0,0,0,0,0,0,0,0,0,0,0,0,0,0,0,0,0,0,2,3,5,5
20192020,118,WHITLEY,591,Whitley County,225,Whitley County Alternative School,591225,118591225,210588001262,SESC,907,08,1,8,0,0,0,0,0,0,0,0,0,0,0,0,0,0,0,0,0,0,8,1,9,9
20192020,118,WHITLEY,591,Whitley County,225,Whitley County Alternative School,591225,118591225,210588001262,SESC,907,09,2,4,0,0,0,0,0,0,0,0,0,0,0,0,0,0,0,0,0,0,4,2,6,6
20192020,118,WHITLEY,591,Whitley County,225,Whitley County Alternative School,591225,118591225,210588001262,SESC,907,10,4,5,0,0,0,0,0,0,0,0,0,0,0,0,0,0,0,0,0,0,5,4,9,9
20192020,118,WHITLEY,591,Whitley County,225,Whitley County Alternative School,591225,118591225,210588001262,SESC,907,11,3,7,0,0,0,0,0,0,0,0,0,0,0,0,0,0,0,0,0,0,7,3,10,10
20192020,118,WHITLEY,591,Whitley County,225,Whitley County Alternative School,591225,118591225,210588001262,SESC,907,12,4,10,0,0,0,0,0,0,0,0,0,0,0,0,0,0,0,0,0,0,10,4,14,14
20192020,118,WHITLEY,591,Whitley County,290,Oak Grove Elementary School,591290,118591290,210588001381,SESC,907,All Students,262,284,0,2,2,0,0,0,0,0,0,4,4,8,0,0,0,2,2,4,278,254,532,546
20192020,118,WHITLEY,591,Whitley County,290,Oak Grove Elementary School,591290,118591290,210588001381,SESC,907,PS,50,52,0,0,0,0,0,0,0,0,0,2,0,2,0,0,0,0,0,0,50,50,100,102
20192020,118,WHITLEY,591,Whitley County,290,Oak Grove Elementary School,591290,118591290,210588001381,SESC,907,KG,50,44,0,1,1,0,0,0,0,0,0,1,1,2,0,0,0,0,0,0,43,48,91,94
20192020,118,WHITLEY,591,Whitley County,290,Oak Grove Elementary School,591290,118591290,210588001381,SESC,907,01,36,61,0,0,0,0,0,0,0,0,0,2,0,2,0,0,0,0,0,0,59,36,95,97
20192020,118,WHITLEY,591,Whitley County,290,Oak Grove Elementary School,591290,118591290,210588001381,SESC,907,02,42,36,0,0,0,0,0,0,0,0,0,0,0,0,0,0,0,1,1,2,35,41,76,78
20192020,118,WHITLEY,591,Whitley County,290,Oak Grove Elementary School,591290,118591290,210588001381,SESC,907,03,44,34,0,1,1,0,0,0,0,0,0,0,1,1,0,0,0,0,1,1,34,41,75,78
20192020,118,WHITLEY,591,Whitley County,290,Oak Grove Elementary School,591290,118591290,210588001381,SESC,907,04,36,33,0,0,0,0,0,0,0,0,0,0,1,1,0,0,0,0,0,0,33,35,68,69
20192020,118,WHITLEY,591,Whitley County,290,Oak Grove Elementary School,591290,118591290,210588001381,SESC,907,05,32,43,0,0,0,0,0,0,0,0,0,1,0,1,0,0,0,1,0,1,41,32,73,75
20192020,118,WHITLEY,591,Whitley County,290,Oak Grove Elementary School,591290,118591290,210588001381,SESC,907,06,22,33,0,0,0,0,0,0,0,0,0,0,1,1,0,0,0,0,0,0,33,21,54,55
20192020,118,WHITLEY,591,Whitley County,320,Pleasant View Elementary School,591320,118591320,210588001383,SESC,907,All Students,120,117,1,0,1,0,0,0,0,0,0,2,5,7,0,0,0,1,1,2,113,114,227,237
20192020,118,WHITLEY,591,Whitley County,320,Pleasant View Elementary School,591320,118591320,210588001383,SESC,907,PS,19,17,0,0,0,0,0,0,0,0,0,0,0,0,0,0,0,0,0,0,17,19,36,36
20192020,118,WHITLEY,591,Whitley County,320,Pleasant View Elementary School,591320,118591320,210588001383,SESC,907,KG,8,18,0,0,0,0,0,0,0,0,0,1,0,1,0,0,0,0,0,0,17,8,25,26
20192020,118,WHITLEY,591,Whitley County,320,Pleasant View Elementary School,591320,118591320,210588001383,SESC,907,01,14,15,0,0,0,0,0,0,0,0,0,0,1,1,0,0,0,0,0,0,15,13,28,29
20192020,118,WHITLEY,591,Whitley County,320,Pleasant View Elementary School,591320,118591320,210588001383,SESC,907,02,20,17,0,0,0,0,0,0,0,0,0,1,0,1,0,0,0,0,0,0,16,20,36,37
20192020,118,WHITLEY,591,Whitley County,320,Pleasant View Elementary School,591320,118591320,210588001383,SESC,907,03,23,11,0,0,0,0,0,0,0,0,0,0,3,3,0,0,0,0,0,0,11,20,31,34
20192020,118,WHITLEY,591,Whitley County,320,Pleasant View Elementary School,591320,118591320,210588001383,SESC,907,04,20,16,0,0,0,0,0,0,0,0,0,0,1,1,0,0,0,0,1,1,16,18,34,36
20192020,118,WHITLEY,591,Whitley County,320,Pleasant View Elementary School,591320,118591320,210588001383,SESC,907,05,21,22,0,0,0,0,0,0,0,0,0,0,0,0,0,0,0,0,0,0,22,21,43,43
20192020,118,WHITLEY,591,Whitley County,320,Pleasant View Elementary School,591320,118591320,210588001383,SESC,907,06,14,18,1,0,1,0,0,0,0,0,0,0,0,0,0,0,0,1,0,1,16,14,30,32
20192020,118,WHITLEY,591,Whitley County,350,Whitley County North Elementary School,591350,118591350,210588000546,SESC,907,All Students,161,150,4,3,7,0,0,0,0,0,0,4,10,14,0,0,0,4,4,8,138,144,282,311
20192020,118,WHITLEY,591,Whitley County,350,Whitley County North Elementary School,591350,118591350,210588000546,SESC,907,PS,20,26,0,0,0,0,0,0,0,0,0,0,1,1,0,0,0,0,0,0,26,19,45,46
20192020,118,WHITLEY,591,Whitley County,350,Whitley County North Elementary School,591350,118591350,210588000546,SESC,907,KG,19,17,1,0,1,0,0,0,0,0,0,0,0,0,0,0,0,3,1,4,13,18,31,36
20192020,118,WHITLEY,591,Whitley County,350,Whitley County North Elementary School,591350,118591350,210588000546,SESC,907,01,36,29,0,1,1,0,0,0,0,0,0,0,3,3,0,0,0,0,1,1,29,31,60,65
20192020,118,WHITLEY,591,Whitley County,350,Whitley County North Elementary School,591350,118591350,210588000546,SESC,907,02,25,19,1,0,1,0,0,0,0,0,0,1,0,1,0,0,0,0,0,0,17,25,42,44
20192020,118,WHITLEY,591,Whitley County,350,Whitley County North Elementary School,591350,118591350,210588000546,SESC,907,03,21,25,0,1,1,0,0,0,0,0,0,1,1,2,0,0,0,1,0,1,23,19,42,46
20192020,118,WHITLEY,591,Whitley County,350,Whitley County North Elementary School,591350,118591350,210588000546,SESC,907,04,14,16,1,0,1,0,0,0,0,0,0,0,1,1,0,0,0,0,0,0,15,13,28,30
20192020,118,WHITLEY,591,Whitley County,350,Whitley County North Elementary School,591350,118591350,210588000546,SESC,907,06,19,27,1,0,1,0,0,0,0,0,0,1,3,4,0,0,0,0,0,0,25,16,41,46
20192020,118,WHITLEY,591,Whitley County,350,Whitley County North Elementary School,591350,118591350,210588000546,SESC,907,05,27,17,0,1,1,0,0,0,0,0,0,1,2,3,0,0,0,0,2,2,16,22,38,44
20192020,118,WHITLEY,591,Whitley County,365,Whitley County Central Primary School,591365,118591365,210588001621,SESC,907,PS,50,67,0,0,0,0,0,0,0,0,0,2,2,4,0,0,0,2,0,2,63,48,111,117
20192020,118,WHITLEY,591,Whitley County,365,Whitley County Central Primary School,591365,118591365,210588001621,SESC,907,All Students,150,199,0,1,1,0,0,0,0,0,0,4,1,5,0,0,0,4,1,5,191,147,338,349
20192020,118,WHITLEY,591,Whitley County,365,Whitley County Central Primary School,591365,118591365,210588001621,SESC,907,KG,48,64,0,1,1,0,0,0,0,0,0,3,1,4,0,0,0,0,1,1,61,45,106,112
20192020,118,WHITLEY,591,Whitley County,365,Whitley County Central Primary School,591365,118591365,210588001621,SESC,907,01,64,65,0,0,0,0,0,0,0,0,0,0,0,0,0,0,0,3,0,3,62,64,126,129
20192020,118,WHITLEY,591,Whitley County,365,Whitley County Central Primary School,591365,118591365,210588001621,SESC,907,02,38,70,0,0,0,0,0,0,0,0,0,1,0,1,0,0,0,1,0,1,68,38,106,108
20192020,118,WHITLEY,591,Whitley County,430,Whitley County High School,591430,118591430,210588001386,SESC,907,14,1,6,0,0,0,0,0,0,0,0,0,0,0,0,0,0,0,0,0,0,6,1,7,7
20192020,118,WHITLEY,591,Whitley County,430,Whitley County High School,591430,118591430,210588001386,SESC,907,All Students,448,481,2,1,3,0,0,0,1,0,1,4,7,11,0,0,0,4,5,9,470,435,905,929
20192020,118,WHITLEY,591,Whitley County,430,Whitley County High School,591430,118591430,210588001386,SESC,907,09,111,132,0,0,0,0,0,0,0,0,0,0,5,5,0,0,0,1,0,1,131,106,237,243
20192020,118,WHITLEY,591,Whitley County,430,Whitley County High School,591430,118591430,210588001386,SESC,907,10,119,124,0,0,0,0,0,0,1,0,1,1,1,2,0,0,0,1,2,3,121,116,237,243
20192020,118,WHITLEY,591,Whitley County,430,Whitley County High School,591430,118591430,210588001386,SESC,907,11,124,110,2,1,3,0,0,0,0,0,0,2,0,2,0,0,0,2,1,3,104,122,226,234
20192020,118,WHITLEY,591,Whitley County,430,Whitley County High School,591430,118591430,210588001386,SESC,907,12,93,109,0,0,0,0,0,0,0,0,0,1,1,2,0,0,0,0,2,2,108,90,198,202
20192020,118,WHITLEY,591,Whitley County,435,Whitley County Middle School,591435,118591435,210588001387,SESC,907,07,147,158,0,1,1,0,0,0,1,0,1,2,0,2,0,0,0,1,1,2,154,145,299,305
20192020,118,WHITLEY,591,Whitley County,435,Whitley County Middle School,591435,118591435,210588001387,SESC,907,All Students,271,290,0,1,1,0,0,0,1,0,1,4,3,7,0,0,0,2,2,4,283,265,548,561
20192020,118,WHITLEY,591,Whitley County,435,Whitley County Middle School,591435,118591435,210588001387,SESC,907,08,124,132,0,0,0,0,0,0,0,0,0,2,3,5,0,0,0,1,1,2,129,120,249,256
20192020,118,WHITLEY,592,Williamsburg Independent,"",---District Total---,592,"","",SESC,907,All Students,366,440,14,3,17,0,0,0,1,2,3,6,5,11,0,1,1,4,6,10,415,349,764,806
20192020,118,WHITLEY,592,Williamsburg Independent,"",---District Total---,592,"","",SESC,907,PS,28,28,0,0,0,0,0,0,0,0,0,0,0,0,0,0,0,0,1,1,28,27,55,56
20192020,118,WHITLEY,592,Williamsburg Independent,"",---District Total---,592,"","",SESC,907,KG,23,35,0,0,0,0,0,0,0,0,0,0,0,0,0,0,0,1,0,1,34,23,57,58
20192020,118,WHITLEY,592,Williamsburg Independent,"",---District Total---,592,"","",SESC,907,01,28,37,1,0,1,0,0,0,0,0,0,0,0,0,0,0,0,0,1,1,36,27,63,65
20192020,118,WHITLEY,592,Williamsburg Independent,"",---District Total---,592,"","",SESC,907,02,14,25,1,0,1,0,0,0,0,0,0,1,0,1,0,0,0,0,0,0,23,14,37,39
20192020,118,WHITLEY,592,Williamsburg Independent,"",---District Total---,592,"","",SESC,907,03,24,26,0,1,1,0,0,0,0,1,1,0,0,0,0,0,0,0,0,0,26,22,48,50
20192020,118,WHITLEY,592,Williamsburg Independent,"",---District Total---,592,"","",SESC,907,04,31,31,0,0,0,0,0,0,0,0,0,0,1,1,0,0,0,0,2,2,31,28,59,62
20192020,118,WHITLEY,592,Williamsburg Independent,"",---District Total---,592,"","",SESC,907,05,37,31,0,0,0,0,0,0,0,0,0,2,1,3,0,0,0,1,2,3,28,34,62,68
20192020,118,WHITLEY,592,Williamsburg Independent,"",---District Total---,592,"","",SESC,907,06,30,41,0,0,0,0,0,0,1,0,1,0,2,2,0,0,0,0,0,0,40,28,68,71
20192020,118,WHITLEY,592,Williamsburg Independent,"",---District Total---,592,"","",SESC,907,07,27,35,0,1,1,0,0,0,0,0,0,0,0,0,0,0,0,0,0,0,35,26,61,62
20192020,118,WHITLEY,592,Williamsburg Independent,"",---District Total---,592,"","",SESC,907,08,31,36,2,0,2,0,0,0,0,0,0,1,0,1,0,0,0,0,0,0,33,31,64,67
20192020,118,WHITLEY,592,Williamsburg Independent,"",---District Total---,592,"","",SESC,907,09,36,43,4,0,4,0,0,0,0,0,0,1,0,1,0,1,1,1,1,2,37,34,71,79
20192020,118,WHITLEY,592,Williamsburg Independent,"",---District Total---,592,"","",SESC,907,10,27,34,1,0,1,0,0,0,0,1,1,0,0,0,0,0,0,1,0,1,32,26,58,61
20192020,118,WHITLEY,592,Williamsburg Independent,"",---District Total---,592,"","",SESC,907,11,33,29,3,1,4,0,0,0,0,0,0,1,0,1,0,0,0,0,0,0,25,32,57,62
20192020,118,WHITLEY,592,Williamsburg Independent,"",---District Total---,592,"","",SESC,907,12,25,36,2,0,2,0,0,0,0,0,0,0,1,1,0,0,0,0,0,0,34,24,58,61
20192020,118,WHITLEY,592,Williamsburg Independent,"",---District Total---,592,"","",SESC,907,14,0,1,0,0,0,0,0,0,0,0,0,0,0,0,0,0,0,0,0,0,1,0,1,1
20192020,118,WHITLEY,592,Williamsburg Independent,012,Williamsburg City School,592012,118592012,210591001939,SESC,907,12,25,36,2,0,2,0,0,0,0,0,0,0,1,1,0,0,0,0,0,0,34,24,58,61
20192020,118,WHITLEY,592,Williamsburg Independent,012,Williamsburg City School,592012,118592012,210591001939,SESC,907,14,0,1,0,0,0,0,0,0,0,0,0,0,0,0,0,0,0,0,0,0,1,0,1,1
20192020,118,WHITLEY,592,Williamsburg Independent,012,Williamsburg City School,592012,118592012,210591001939,SESC,907,All Students,366,440,14,3,17,0,0,0,1,2,3,6,5,11,0,1,1,4,6,10,415,349,764,806
20192020,118,WHITLEY,592,Williamsburg Independent,012,Williamsburg City School,592012,118592012,210591001939,SESC,907,PS,28,28,0,0,0,0,0,0,0,0,0,0,0,0,0,0,0,0,1,1,28,27,55,56
20192020,118,WHITLEY,592,Williamsburg Independent,012,Williamsburg City School,592012,118592012,210591001939,SESC,907,KG,23,35,0,0,0,0,0,0,0,0,0,0,0,0,0,0,0,1,0,1,34,23,57,58
20192020,118,WHITLEY,592,Williamsburg Independent,012,Williamsburg City School,592012,118592012,210591001939,SESC,907,01,28,37,1,0,1,0,0,0,0,0,0,0,0,0,0,0,0,0,1,1,36,27,63,65
20192020,118,WHITLEY,592,Williamsburg Independent,012,Williamsburg City School,592012,118592012,210591001939,SESC,907,02,14,25,1,0,1,0,0,0,0,0,0,1,0,1,0,0,0,0,0,0,23,14,37,39
20192020,118,WHITLEY,592,Williamsburg Independent,012,Williamsburg City School,592012,118592012,210591001939,SESC,907,03,24,26,0,1,1,0,0,0,0,1,1,0,0,0,0,0,0,0,0,0,26,22,48,50
20192020,118,WHITLEY,592,Williamsburg Independent,012,Williamsburg City School,592012,118592012,210591001939,SESC,907,04,31,31,0,0,0,0,0,0,0,0,0,0,1,1,0,0,0,0,2,2,31,28,59,62
20192020,118,WHITLEY,592,Williamsburg Independent,012,Williamsburg City School,592012,118592012,210591001939,SESC,907,05,37,31,0,0,0,0,0,0,0,0,0,2,1,3,0,0,0,1,2,3,28,34,62,68
20192020,118,WHITLEY,592,Williamsburg Independent,012,Williamsburg City School,592012,118592012,210591001939,SESC,907,06,30,41,0,0,0,0,0,0,1,0,1,0,2,2,0,0,0,0,0,0,40,28,68,71
20192020,118,WHITLEY,592,Williamsburg Independent,012,Williamsburg City School,592012,118592012,210591001939,SESC,907,07,27,35,0,1,1,0,0,0,0,0,0,0,0,0,0,0,0,0,0,0,35,26,61,62
20192020,118,WHITLEY,592,Williamsburg Independent,012,Williamsburg City School,592012,118592012,210591001939,SESC,907,08,31,36,2,0,2,0,0,0,0,0,0,1,0,1,0,0,0,0,0,0,33,31,64,67
20192020,118,WHITLEY,592,Williamsburg Independent,012,Williamsburg City School,592012,118592012,210591001939,SESC,907,09,36,43,4,0,4,0,0,0,0,0,0,1,0,1,0,1,1,1,1,2,37,34,71,79
20192020,118,WHITLEY,592,Williamsburg Independent,012,Williamsburg City School,592012,118592012,210591001939,SESC,907,10,27,34,1,0,1,0,0,0,0,1,1,0,0,0,0,0,0,1,0,1,32,26,58,61
20192020,118,WHITLEY,592,Williamsburg Independent,012,Williamsburg City School,592012,118592012,210591001939,SESC,907,11,33,29,3,1,4,0,0,0,0,0,0,1,0,1,0,0,0,0,0,0,25,32,57,62
20192020,041,GRANT,593,Williamstown Independent,"",---District Total---,593,"","",NKCES,905,12,28,30,0,0,0,0,0,0,1,0,1,0,0,0,0,0,0,0,0,0,29,28,57,58
20192020,041,GRANT,593,Williamstown Independent,"",---District Total---,593,"","",NKCES,905,All Students,424,405,3,1,4,0,1,1,4,4,8,24,22,46,0,0,0,10,8,18,364,388,752,829
20192020,041,GRANT,593,Williamstown Independent,"",---District Total---,593,"","",NKCES,905,PS,59,57,0,0,0,0,0,0,0,0,0,1,4,5,0,0,0,2,2,4,54,53,107,116
20192020,041,GRANT,593,Williamstown Independent,"",---District Total---,593,"","",NKCES,905,KG,40,23,0,0,0,0,0,0,0,0,0,4,4,8,0,0,0,0,1,1,19,35,54,63
20192020,041,GRANT,593,Williamstown Independent,"",---District Total---,593,"","",NKCES,905,01,24,39,0,0,0,0,0,0,0,0,0,1,0,1,0,0,0,0,2,2,38,22,60,63
20192020,041,GRANT,593,Williamstown Independent,"",---District Total---,593,"","",NKCES,905,02,35,35,0,0,0,0,0,0,2,0,2,1,1,2,0,0,0,0,1,1,32,33,65,70
20192020,041,GRANT,593,Williamstown Independent,"",---District Total---,593,"","",NKCES,905,03,25,27,0,0,0,0,0,0,0,0,0,1,1,2,0,0,0,0,0,0,26,24,50,52
20192020,041,GRANT,593,Williamstown Independent,"",---District Total---,593,"","",NKCES,905,04,25,35,1,0,1,0,0,0,0,1,1,2,1,3,0,0,0,1,0,1,31,23,54,60
20192020,041,GRANT,593,Williamstown Independent,"",---District Total---,593,"","",NKCES,905,05,27,34,0,0,0,0,0,0,0,0,0,2,1,3,0,0,0,1,0,1,31,26,57,61
20192020,041,GRANT,593,Williamstown Independent,"",---District Total---,593,"","",NKCES,905,06,34,34,0,0,0,0,0,0,0,0,0,1,4,5,0,0,0,3,1,4,30,29,59,68
20192020,041,GRANT,593,Williamstown Independent,"",---District Total---,593,"","",NKCES,905,07,38,25,0,0,0,0,0,0,1,1,2,4,4,8,0,0,0,0,0,0,20,33,53,63
20192020,041,GRANT,593,Williamstown Independent,"",---District Total---,593,"","",NKCES,905,08,34,40,2,1,3,0,0,0,0,0,0,3,4,7,0,0,0,2,1,3,33,28,61,74
20192020,041,GRANT,593,Williamstown Independent,"",---District Total---,593,"","",NKCES,905,09,43,29,0,0,0,0,0,0,0,1,1,4,1,5,0,0,0,1,1,2,24,40,64,72
20192020,041,GRANT,593,Williamstown Independent,"",---District Total---,593,"","",NKCES,905,10,33,22,0,0,0,0,1,1,0,1,1,0,0,0,0,0,0,0,1,1,22,30,52,55
20192020,041,GRANT,593,Williamstown Independent,"",---District Total---,593,"","",NKCES,905,11,38,32,0,0,0,0,0,0,0,0,0,1,1,2,0,0,0,2,0,2,29,37,66,70
20192020,041,GRANT,593,Williamstown Independent,010,Williamstown Elementary,593010,041593010,210594001392,NKCES,905,All Students,176,193,1,0,1,0,0,0,2,1,3,11,8,19,0,0,0,2,4,6,177,163,340,369
20192020,041,GRANT,593,Williamstown Independent,010,Williamstown Elementary,593010,041593010,210594001392,NKCES,905,KG,40,23,0,0,0,0,0,0,0,0,0,4,4,8,0,0,0,0,1,1,19,35,54,63
20192020,041,GRANT,593,Williamstown Independent,010,Williamstown Elementary,593010,041593010,210594001392,NKCES,905,01,24,39,0,0,0,0,0,0,0,0,0,1,0,1,0,0,0,0,2,2,38,22,60,63
20192020,041,GRANT,593,Williamstown Independent,010,Williamstown Elementary,593010,041593010,210594001392,NKCES,905,02,35,35,0,0,0,0,0,0,2,0,2,1,1,2,0,0,0,0,1,1,32,33,65,70
20192020,041,GRANT,593,Williamstown Independent,010,Williamstown Elementary,593010,041593010,210594001392,NKCES,905,03,25,27,0,0,0,0,0,0,0,0,0,1,1,2,0,0,0,0,0,0,26,24,50,52
20192020,041,GRANT,593,Williamstown Independent,010,Williamstown Elementary,593010,041593010,210594001392,NKCES,905,04,25,35,1,0,1,0,0,0,0,1,1,2,1,3,0,0,0,1,0,1,31,23,54,60
20192020,041,GRANT,593,Williamstown Independent,010,Williamstown Elementary,593010,041593010,210594001392,NKCES,905,05,27,34,0,0,0,0,0,0,0,0,0,2,1,3,0,0,0,1,0,1,31,26,57,61
20192020,041,GRANT,593,Williamstown Independent,020,Williamstown Jr. High,593020,041593020,210594001393,NKCES,905,All Students,106,99,2,1,3,0,0,0,1,1,2,8,12,20,0,0,0,5,2,7,83,90,173,205
20192020,041,GRANT,593,Williamstown Independent,020,Williamstown Jr. High,593020,041593020,210594001393,NKCES,905,06,34,34,0,0,0,0,0,0,0,0,0,1,4,5,0,0,0,3,1,4,30,29,59,68
20192020,041,GRANT,593,Williamstown Independent,020,Williamstown Jr. High,593020,041593020,210594001393,NKCES,905,07,38,25,0,0,0,0,0,0,1,1,2,4,4,8,0,0,0,0,0,0,20,33,53,63
20192020,041,GRANT,593,Williamstown Independent,020,Williamstown Jr. High,593020,041593020,210594001393,NKCES,905,08,34,40,2,1,3,0,0,0,0,0,0,3,4,7,0,0,0,2,1,3,33,28,61,74
20192020,041,GRANT,593,Williamstown Independent,030,Williamstown Sr. High,593030,041593030,210594002308,NKCES,905,All Students,142,113,0,0,0,0,1,1,1,2,3,5,2,7,0,0,0,3,2,5,104,135,239,255
20192020,041,GRANT,593,Williamstown Independent,030,Williamstown Sr. High,593030,041593030,210594002308,NKCES,905,09,43,29,0,0,0,0,0,0,0,1,1,4,1,5,0,0,0,1,1,2,24,40,64,72
20192020,041,GRANT,593,Williamstown Independent,030,Williamstown Sr. High,593030,041593030,210594002308,NKCES,905,10,33,22,0,0,0,0,1,1,0,1,1,0,0,0,0,0,0,0,1,1,22,30,52,55
20192020,041,GRANT,593,Williamstown Independent,030,Williamstown Sr. High,593030,041593030,210594002308,NKCES,905,11,38,32,0,0,0,0,0,0,0,0,0,1,1,2,0,0,0,2,0,2,29,37,66,70
20192020,041,GRANT,593,Williamstown Independent,030,Williamstown Sr. High,593030,041593030,210594002308,NKCES,905,12,28,30,0,0,0,0,0,0,1,0,1,0,0,0,0,0,0,0,0,0,29,28,57,58
20192020,041,GRANT,593,Williamstown Independent,040,Williamstown Head Start Preschool,593040,041593040,210594002260,NKCES,905,All Students,0,0,0,0,0,0,0,0,0,0,0,0,0,0,0,0,0,0,0,0,0,0,0,0
20192020,041,GRANT,593,Williamstown Independent,040,Williamstown Head Start Preschool,593040,041593040,210594002260,NKCES,905,PS,59,57,0,0,0,0,0,0,0,0,0,1,4,5,0,0,0,2,2,4,54,53,107,116
20192020,119,WOLFE,595,Wolfe County,"",---District Total---,595,"","",KVEC,904,All Students,572,633,10,1,11,0,0,0,2,2,4,7,5,12,1,0,1,2,2,4,611,562,1173,1205
20192020,119,WOLFE,595,Wolfe County,"",---District Total---,595,"","",KVEC,904,KG,43,45,0,0,0,0,0,0,0,0,0,0,0,0,0,0,0,0,1,1,45,42,87,88
20192020,119,WOLFE,595,Wolfe County,"",---District Total---,595,"","",KVEC,904,01,44,47,0,0,0,0,0,0,0,0,0,0,0,0,1,0,1,0,0,0,46,44,90,91
20192020,119,WOLFE,595,Wolfe County,"",---District Total---,595,"","",KVEC,904,02,30,43,0,1,1,0,0,0,0,0,0,1,0,1,0,0,0,0,0,0,42,29,71,73
20192020,119,WOLFE,595,Wolfe County,"",---District Total---,595,"","",KVEC,904,03,44,40,0,0,0,0,0,0,1,0,1,0,0,0,0,0,0,0,0,0,39,44,83,84
20192020,119,WOLFE,595,Wolfe County,"",---District Total---,595,"","",KVEC,904,04,46,39,2,0,2,0,0,0,0,0,0,1,0,1,0,0,0,0,0,0,36,46,82,85
20192020,119,WOLFE,595,Wolfe County,"",---District Total---,595,"","",KVEC,904,05,38,39,0,0,0,0,0,0,0,1,1,0,1,1,0,0,0,0,0,0,39,36,75,77
20192020,119,WOLFE,595,Wolfe County,"",---District Total---,595,"","",KVEC,904,06,39,50,0,0,0,0,0,0,0,0,0,1,1,2,0,0,0,0,0,0,49,38,87,89
20192020,119,WOLFE,595,Wolfe County,"",---District Total---,595,"","",KVEC,904,07,46,64,0,0,0,0,0,0,0,0,0,0,0,0,0,0,0,0,0,0,64,46,110,110
20192020,119,WOLFE,595,Wolfe County,"",---District Total---,595,"","",KVEC,904,08,50,38,0,0,0,0,0,0,0,0,0,0,1,1,0,0,0,0,0,0,38,49,87,88
20192020,119,WOLFE,595,Wolfe County,"",---District Total---,595,"","",KVEC,904,09,48,57,1,0,1,0,0,0,0,0,0,0,1,1,0,0,0,1,0,1,55,47,102,105
20192020,119,WOLFE,595,Wolfe County,"",---District Total---,595,"","",KVEC,904,10,47,53,1,0,1,0,0,0,0,0,0,1,1,2,0,0,0,0,1,1,51,45,96,100
20192020,119,WOLFE,595,Wolfe County,"",---District Total---,595,"","",KVEC,904,12,46,60,1,0,1,0,0,0,1,0,1,2,0,2,0,0,0,0,0,0,56,46,102,106
20192020,119,WOLFE,595,Wolfe County,"",---District Total---,595,"","",KVEC,904,11,51,50,3,0,3,0,0,0,0,1,1,1,0,1,0,0,0,1,0,1,45,50,95,101
20192020,119,WOLFE,595,Wolfe County,"",---District Total---,595,"","",KVEC,904,14,0,8,2,0,2,0,0,0,0,0,0,0,0,0,0,0,0,0,0,0,6,0,6,8
20192020,119,WOLFE,595,Wolfe County,140,Dessie Scott School,595140,119595140,210597002380,KVEC,904,07,0,2,0,0,0,0,0,0,0,0,0,0,0,0,0,0,0,0,0,0,2,0,2,2
20192020,119,WOLFE,595,Wolfe County,140,Dessie Scott School,595140,119595140,210597002380,KVEC,904,All Students,0,31,5,0,5,0,0,0,0,0,0,0,0,0,0,0,0,0,0,0,26,0,26,31
20192020,119,WOLFE,595,Wolfe County,140,Dessie Scott School,595140,119595140,210597002380,KVEC,904,08,0,3,0,0,0,0,0,0,0,0,0,0,0,0,0,0,0,0,0,0,3,0,3,3
20192020,119,WOLFE,595,Wolfe County,140,Dessie Scott School,595140,119595140,210597002380,KVEC,904,09,0,5,0,0,0,0,0,0,0,0,0,0,0,0,0,0,0,0,0,0,5,0,5,5
20192020,119,WOLFE,595,Wolfe County,140,Dessie Scott School,595140,119595140,210597002380,KVEC,904,10,0,4,0,0,0,0,0,0,0,0,0,0,0,0,0,0,0,0,0,0,4,0,4,4
20192020,119,WOLFE,595,Wolfe County,140,Dessie Scott School,595140,119595140,210597002380,KVEC,904,11,0,6,2,0,2,0,0,0,0,0,0,0,0,0,0,0,0,0,0,0,4,0,4,6
20192020,119,WOLFE,595,Wolfe County,140,Dessie Scott School,595140,119595140,210597002380,KVEC,904,12,0,4,1,0,1,0,0,0,0,0,0,0,0,0,0,0,0,0,0,0,3,0,3,4
20192020,119,WOLFE,595,Wolfe County,140,Dessie Scott School,595140,119595140,210597002380,KVEC,904,14,0,7,2,0,2,0,0,0,0,0,0,0,0,0,0,0,0,0,0,0,5,0,5,7
20192020,119,WOLFE,595,Wolfe County,205,Red River Valley Elementary School,595205,119595205,210597001394,KVEC,904,All Students,44,73,0,0,0,0,0,0,0,0,0,2,1,3,0,0,0,0,0,0,71,43,114,117
20192020,119,WOLFE,595,Wolfe County,205,Red River Valley Elementary School,595205,119595205,210597001394,KVEC,904,KG,4,9,0,0,0,0,0,0,0,0,0,0,0,0,0,0,0,0,0,0,9,4,13,13
20192020,119,WOLFE,595,Wolfe County,205,Red River Valley Elementary School,595205,119595205,210597001394,KVEC,904,01,11,8,0,0,0,0,0,0,0,0,0,0,0,0,0,0,0,0,0,0,8,11,19,19
20192020,119,WOLFE,595,Wolfe County,205,Red River Valley Elementary School,595205,119595205,210597001394,KVEC,904,02,5,13,0,0,0,0,0,0,0,0,0,1,0,1,0,0,0,0,0,0,12,5,17,18
20192020,119,WOLFE,595,Wolfe County,205,Red River Valley Elementary School,595205,119595205,210597001394,KVEC,904,03,5,11,0,0,0,0,0,0,0,0,0,0,0,0,0,0,0,0,0,0,11,5,16,16
20192020,119,WOLFE,595,Wolfe County,205,Red River Valley Elementary School,595205,119595205,210597001394,KVEC,904,04,7,6,0,0,0,0,0,0,0,0,0,0,0,0,0,0,0,0,0,0,6,7,13,13
20192020,119,WOLFE,595,Wolfe County,205,Red River Valley Elementary School,595205,119595205,210597001394,KVEC,904,05,5,13,0,0,0,0,0,0,0,0,0,0,1,1,0,0,0,0,0,0,13,4,17,18
20192020,119,WOLFE,595,Wolfe County,205,Red River Valley Elementary School,595205,119595205,210597001394,KVEC,904,06,7,13,0,0,0,0,0,0,0,0,0,1,0,1,0,0,0,0,0,0,12,7,19,20
20192020,119,WOLFE,595,Wolfe County,220,Rogers Elementary School,595220,119595220,210597001395,KVEC,904,All Students,77,46,0,0,0,0,0,0,0,0,0,1,0,1,0,0,0,0,0,0,45,77,122,123
20192020,119,WOLFE,595,Wolfe County,220,Rogers Elementary School,595220,119595220,210597001395,KVEC,904,KG,10,3,0,0,0,0,0,0,0,0,0,0,0,0,0,0,0,0,0,0,3,10,13,13
20192020,119,WOLFE,595,Wolfe County,220,Rogers Elementary School,595220,119595220,210597001395,KVEC,904,01,6,7,0,0,0,0,0,0,0,0,0,0,0,0,0,0,0,0,0,0,7,6,13,13
20192020,119,WOLFE,595,Wolfe County,220,Rogers Elementary School,595220,119595220,210597001395,KVEC,904,02,6,9,0,0,0,0,0,0,0,0,0,0,0,0,0,0,0,0,0,0,9,6,15,15
20192020,119,WOLFE,595,Wolfe County,220,Rogers Elementary School,595220,119595220,210597001395,KVEC,904,03,14,5,0,0,0,0,0,0,0,0,0,0,0,0,0,0,0,0,0,0,5,14,19,19
20192020,119,WOLFE,595,Wolfe County,220,Rogers Elementary School,595220,119595220,210597001395,KVEC,904,04,13,9,0,0,0,0,0,0,0,0,0,1,0,1,0,0,0,0,0,0,8,13,21,22
20192020,119,WOLFE,595,Wolfe County,220,Rogers Elementary School,595220,119595220,210597001395,KVEC,904,05,12,6,0,0,0,0,0,0,0,0,0,0,0,0,0,0,0,0,0,0,6,12,18,18
20192020,119,WOLFE,595,Wolfe County,220,Rogers Elementary School,595220,119595220,210597001395,KVEC,904,06,16,7,0,0,0,0,0,0,0,0,0,0,0,0,0,0,0,0,0,0,7,16,23,23
20192020,119,WOLFE,595,Wolfe County,310,Campton Elementary School,595310,119595310,210597001396,KVEC,904,All Students,163,184,2,1,3,0,0,0,1,1,2,0,1,1,1,0,1,0,1,1,180,159,339,347
20192020,119,WOLFE,595,Wolfe County,310,Campton Elementary School,595310,119595310,210597001396,KVEC,904,KG,29,33,0,0,0,0,0,0,0,0,0,0,0,0,0,0,0,0,1,1,33,28,61,62
20192020,119,WOLFE,595,Wolfe County,310,Campton Elementary School,595310,119595310,210597001396,KVEC,904,01,27,32,0,0,0,0,0,0,0,0,0,0,0,0,1,0,1,0,0,0,31,27,58,59
20192020,119,WOLFE,595,Wolfe County,310,Campton Elementary School,595310,119595310,210597001396,KVEC,904,02,19,21,0,1,1,0,0,0,0,0,0,0,0,0,0,0,0,0,0,0,21,18,39,40
20192020,119,WOLFE,595,Wolfe County,310,Campton Elementary School,595310,119595310,210597001396,KVEC,904,03,25,24,0,0,0,0,0,0,1,0,1,0,0,0,0,0,0,0,0,0,23,25,48,49
20192020,119,WOLFE,595,Wolfe County,310,Campton Elementary School,595310,119595310,210597001396,KVEC,904,04,26,24,2,0,2,0,0,0,0,0,0,0,0,0,0,0,0,0,0,0,22,26,48,50
20192020,119,WOLFE,595,Wolfe County,310,Campton Elementary School,595310,119595310,210597001396,KVEC,904,05,21,20,0,0,0,0,0,0,0,1,1,0,0,0,0,0,0,0,0,0,20,20,40,41
20192020,119,WOLFE,595,Wolfe County,310,Campton Elementary School,595310,119595310,210597001396,KVEC,904,06,16,30,0,0,0,0,0,0,0,0,0,0,1,1,0,0,0,0,0,0,30,15,45,46
20192020,119,WOLFE,595,Wolfe County,312,Success Academy,595312,119595312,210597002369,KVEC,904,All Students,8,22,1,0,1,0,0,0,0,0,0,1,0,1,0,0,0,0,0,0,20,8,28,30
20192020,119,WOLFE,595,Wolfe County,312,Success Academy,595312,119595312,210597002369,KVEC,904,09,3,1,0,0,0,0,0,0,0,0,0,0,0,0,0,0,0,0,0,0,1,3,4,4
20192020,119,WOLFE,595,Wolfe County,312,Success Academy,595312,119595312,210597002369,KVEC,904,10,0,6,1,0,1,0,0,0,0,0,0,0,0,0,0,0,0,0,0,0,5,0,5,6
20192020,119,WOLFE,595,Wolfe County,312,Success Academy,595312,119595312,210597002369,KVEC,904,11,3,2,0,0,0,0,0,0,0,0,0,0,0,0,0,0,0,0,0,0,2,3,5,5
20192020,119,WOLFE,595,Wolfe County,312,Success Academy,595312,119595312,210597002369,KVEC,904,12,2,13,0,0,0,0,0,0,0,0,0,1,0,1,0,0,0,0,0,0,12,2,14,15
20192020,119,WOLFE,595,Wolfe County,315,Wolfe County Middle School,595315,119595315,210597001693,KVEC,904,All Students,96,97,0,0,0,0,0,0,0,0,0,0,1,1,0,0,0,0,0,0,97,95,192,193
20192020,119,WOLFE,595,Wolfe County,315,Wolfe County Middle School,595315,119595315,210597001693,KVEC,904,07,46,62,0,0,0,0,0,0,0,0,0,0,0,0,0,0,0,0,0,0,62,46,108,108
20192020,119,WOLFE,595,Wolfe County,315,Wolfe County Middle School,595315,119595315,210597001693,KVEC,904,08,50,35,0,0,0,0,0,0,0,0,0,0,1,1,0,0,0,0,0,0,35,49,84,85
20192020,119,WOLFE,595,Wolfe County,320,Wolfe County High School,595320,119595320,210597001397,KVEC,904,All Students,184,180,2,0,2,0,0,0,1,1,2,3,2,5,0,0,0,2,1,3,172,180,352,364
20192020,119,WOLFE,595,Wolfe County,320,Wolfe County High School,595320,119595320,210597001397,KVEC,904,09,45,51,1,0,1,0,0,0,0,0,0,0,1,1,0,0,0,1,0,1,49,44,93,96
20192020,119,WOLFE,595,Wolfe County,320,Wolfe County High School,595320,119595320,210597001397,KVEC,904,10,47,43,0,0,0,0,0,0,0,0,0,1,1,2,0,0,0,0,1,1,42,45,87,90
20192020,119,WOLFE,595,Wolfe County,320,Wolfe County High School,595320,119595320,210597001397,KVEC,904,11,48,42,1,0,1,0,0,0,0,1,1,1,0,1,0,0,0,1,0,1,39,47,86,90
20192020,119,WOLFE,595,Wolfe County,320,Wolfe County High School,595320,119595320,210597001397,KVEC,904,12,44,43,0,0,0,0,0,0,1,0,1,1,0,1,0,0,0,0,0,0,41,44,85,87
20192020,119,WOLFE,595,Wolfe County,320,Wolfe County High School,595320,119595320,210597001397,KVEC,904,14,0,1,0,0,0,0,0,0,0,0,0,0,0,0,0,0,0,0,0,0,1,0,1,1
20192020,120,WOODFORD,601,Woodford County,"",---District Total---,601,"","",CKEC,901,All Students,2033,1986,80,75,155,1,1,2,10,34,44,327,328,655,1,1,2,102,109,211,1465,1485,2950,4019
20192020,120,WOODFORD,601,Woodford County,"",---District Total---,601,"","",CKEC,901,PS,75,97,3,2,5,0,0,0,0,0,0,25,24,49,0,0,0,5,2,7,64,47,111,172
20192020,120,WOODFORD,601,Woodford County,"",---District Total---,601,"","",CKEC,901,KG,144,153,7,5,12,0,0,0,0,0,0,27,24,51,0,1,1,7,7,14,112,107,219,297
20192020,120,WOODFORD,601,Woodford County,"",---District Total---,601,"","",CKEC,901,01,151,139,7,7,14,0,0,0,1,1,2,24,28,52,0,0,0,8,10,18,99,105,204,290
20192020,120,WOODFORD,601,Woodford County,"",---District Total---,601,"","",CKEC,901,02,129,133,6,3,9,1,0,1,0,1,1,27,20,47,0,0,0,7,9,16,92,96,188,262
20192020,120,WOODFORD,601,Woodford County,"",---District Total---,601,"","",CKEC,901,03,146,140,7,8,15,0,0,0,1,1,2,19,24,43,0,0,0,14,11,25,99,102,201,286
20192020,120,WOODFORD,601,Woodford County,"",---District Total---,601,"","",CKEC,901,04,138,139,4,3,7,0,0,0,2,3,5,20,20,40,0,0,0,4,11,15,109,101,210,277
20192020,120,WOODFORD,601,Woodford County,"",---District Total---,601,"","",CKEC,901,05,162,148,9,4,13,0,0,0,0,3,3,26,26,52,1,0,1,12,5,17,100,124,224,310
20192020,120,WOODFORD,601,Woodford County,"",---District Total---,601,"","",CKEC,901,06,170,157,8,7,15,0,0,0,1,1,2,31,27,58,0,0,0,9,9,18,108,126,234,327
20192020,120,WOODFORD,601,Woodford County,"",---District Total---,601,"","",CKEC,901,07,187,161,4,10,14,0,0,0,0,3,3,32,28,60,0,0,0,3,4,7,122,142,264,348
20192020,120,WOODFORD,601,Woodford County,"",---District Total---,601,"","",CKEC,901,08,138,163,3,3,6,0,0,0,1,1,2,26,22,48,0,0,0,10,8,18,123,104,227,301
20192020,120,WOODFORD,601,Woodford County,"",---District Total---,601,"","",CKEC,901,09,182,162,5,4,9,0,0,0,0,3,3,23,32,55,0,0,0,8,8,16,126,135,261,344
20192020,120,WOODFORD,601,Woodford County,"",---District Total---,601,"","",CKEC,901,10,174,152,4,7,11,0,1,1,1,7,8,18,29,47,0,0,0,5,13,18,124,117,241,326
20192020,120,WOODFORD,601,Woodford County,"",---District Total---,601,"","",CKEC,901,11,169,173,6,8,14,0,0,0,2,6,8,30,25,55,0,0,0,7,9,16,128,121,249,342
20192020,120,WOODFORD,601,Woodford County,"",---District Total---,601,"","",CKEC,901,12,142,166,10,6,16,0,0,0,1,4,5,24,23,47,0,0,0,8,5,13,123,104,227,308
20192020,120,WOODFORD,601,Woodford County,"",---District Total---,601,"","",CKEC,901,14,1,0,0,0,0,0,0,0,0,0,0,0,0,0,0,0,0,0,0,0,0,1,1,1
20192020,120,WOODFORD,601,Woodford County,013,Safe Harbor Academy,601013,120601013,210600001840,CKEC,901,All Students,32,40,1,3,4,0,0,0,0,0,0,5,4,9,0,0,0,3,0,3,31,25,56,72
20192020,120,WOODFORD,601,Woodford County,013,Safe Harbor Academy,601013,120601013,210600001840,CKEC,901,06,1,0,0,0,0,0,0,0,0,0,0,0,0,0,0,0,0,0,0,0,0,1,1,1
20192020,120,WOODFORD,601,Woodford County,013,Safe Harbor Academy,601013,120601013,210600001840,CKEC,901,07,0,1,0,0,0,0,0,0,0,0,0,0,0,0,0,0,0,0,0,0,1,0,1,1
20192020,120,WOODFORD,601,Woodford County,013,Safe Harbor Academy,601013,120601013,210600001840,CKEC,901,08,0,1,0,0,0,0,0,0,0,0,0,1,0,1,0,0,0,0,0,0,0,0,0,1
20192020,120,WOODFORD,601,Woodford County,013,Safe Harbor Academy,601013,120601013,210600001840,CKEC,901,09,4,9,0,0,0,0,0,0,0,0,0,1,1,2,0,0,0,1,0,1,7,3,10,13
20192020,120,WOODFORD,601,Woodford County,013,Safe Harbor Academy,601013,120601013,210600001840,CKEC,901,10,3,7,0,1,1,0,0,0,0,0,0,0,1,1,0,0,0,1,0,1,6,1,7,10
20192020,120,WOODFORD,601,Woodford County,013,Safe Harbor Academy,601013,120601013,210600001840,CKEC,901,11,9,10,0,1,1,0,0,0,0,0,0,2,0,2,0,0,0,1,0,1,7,8,15,19
20192020,120,WOODFORD,601,Woodford County,013,Safe Harbor Academy,601013,120601013,210600001840,CKEC,901,12,15,12,1,1,2,0,0,0,0,0,0,1,2,3,0,0,0,0,0,0,10,12,22,27
20192020,120,WOODFORD,601,Woodford County,050,Southside Elementary School,601050,120601050,210600000284,CKEC,901,All Students,285,278,4,5,9,0,0,0,1,4,5,23,28,51,1,1,2,20,6,26,229,241,470,563
20192020,120,WOODFORD,601,Woodford County,050,Southside Elementary School,601050,120601050,210600000284,CKEC,901,PS,18,19,0,0,0,0,0,0,0,0,0,6,9,15,0,0,0,0,0,0,13,9,22,37
20192020,120,WOODFORD,601,Woodford County,050,Southside Elementary School,601050,120601050,210600000284,CKEC,901,KG,46,46,2,1,3,0,0,0,0,0,0,3,5,8,0,1,1,2,1,3,39,38,77,92
20192020,120,WOODFORD,601,Woodford County,050,Southside Elementary School,601050,120601050,210600000284,CKEC,901,01,46,41,0,1,1,0,0,0,0,0,0,4,3,7,0,0,0,4,0,4,33,42,75,87
20192020,120,WOODFORD,601,Woodford County,050,Southside Elementary School,601050,120601050,210600000284,CKEC,901,02,43,47,0,0,0,0,0,0,0,0,0,5,4,9,0,0,0,2,2,4,40,37,77,90
20192020,120,WOODFORD,601,Woodford County,050,Southside Elementary School,601050,120601050,210600000284,CKEC,901,03,45,45,1,2,3,0,0,0,0,1,1,3,4,7,0,0,0,6,0,6,35,38,73,90
20192020,120,WOODFORD,601,Woodford County,050,Southside Elementary School,601050,120601050,210600000284,CKEC,901,04,49,51,0,0,0,0,0,0,1,3,4,2,4,6,0,0,0,1,3,4,47,39,86,100
20192020,120,WOODFORD,601,Woodford County,050,Southside Elementary School,601050,120601050,210600000284,CKEC,901,05,56,48,1,1,2,0,0,0,0,0,0,6,8,14,1,0,1,5,0,5,35,47,82,104
20192020,120,WOODFORD,601,Woodford County,075,Simmons Elementary School,601075,120601075,210600001403,CKEC,901,All Students,184,199,26,15,41,1,0,1,0,3,3,63,59,122,0,0,0,13,17,30,96,90,186,383
20192020,120,WOODFORD,601,Woodford County,075,Simmons Elementary School,601075,120601075,210600001403,CKEC,901,PS,25,32,3,1,4,0,0,0,0,0,0,5,5,10,0,0,0,4,1,5,20,18,38,57
20192020,120,WOODFORD,601,Woodford County,075,Simmons Elementary School,601075,120601075,210600001403,CKEC,901,KG,31,36,4,4,8,0,0,0,0,0,0,12,8,20,0,0,0,2,3,5,18,16,34,67
20192020,120,WOODFORD,601,Woodford County,075,Simmons Elementary School,601075,120601075,210600001403,CKEC,901,01,32,30,4,2,6,0,0,0,0,1,1,10,15,25,0,0,0,2,3,5,14,11,25,62
20192020,120,WOODFORD,601,Woodford County,075,Simmons Elementary School,601075,120601075,210600001403,CKEC,901,02,18,30,5,1,6,1,0,1,0,0,0,12,7,19,0,0,0,3,1,4,9,9,18,48
20192020,120,WOODFORD,601,Woodford County,075,Simmons Elementary School,601075,120601075,210600001403,CKEC,901,03,27,30,6,4,10,0,0,0,0,0,0,8,8,16,0,0,0,2,3,5,14,12,26,57
20192020,120,WOODFORD,601,Woodford County,075,Simmons Elementary School,601075,120601075,210600001403,CKEC,901,04,37,32,3,3,6,0,0,0,0,0,0,9,9,18,0,0,0,1,6,7,19,19,38,69
20192020,120,WOODFORD,601,Woodford County,075,Simmons Elementary School,601075,120601075,210600001403,CKEC,901,05,39,41,4,1,5,0,0,0,0,2,2,12,12,24,0,0,0,3,1,4,22,23,45,80
20192020,120,WOODFORD,601,Woodford County,084,Woodford County High School,601084,120601084,210600001404,CKEC,901,All Students,637,615,24,22,46,0,1,1,4,20,24,91,105,196,0,0,0,25,35,60,471,454,925,1252
20192020,120,WOODFORD,601,Woodford County,084,Woodford County High School,601084,120601084,210600001404,CKEC,901,09,178,153,5,4,9,0,0,0,0,3,3,22,31,53,0,0,0,7,8,15,119,132,251,331
20192020,120,WOODFORD,601,Woodford County,084,Woodford County High School,601084,120601084,210600001404,CKEC,901,10,171,145,4,6,10,0,1,1,1,7,8,18,28,46,0,0,0,4,13,17,118,116,234,316
20192020,120,WOODFORD,601,Woodford County,084,Woodford County High School,601084,120601084,210600001404,CKEC,901,11,160,163,6,7,13,0,0,0,2,6,8,28,25,53,0,0,0,6,9,15,121,113,234,323
20192020,120,WOODFORD,601,Woodford County,084,Woodford County High School,601084,120601084,210600001404,CKEC,901,12,127,154,9,5,14,0,0,0,1,4,5,23,21,44,0,0,0,8,5,13,113,92,205,281
20192020,120,WOODFORD,601,Woodford County,084,Woodford County High School,601084,120601084,210600001404,CKEC,901,14,1,0,0,0,0,0,0,0,0,0,0,0,0,0,0,0,0,0,0,0,0,1,1,1
20192020,120,WOODFORD,601,Woodford County,085,Woodford County Middle School,601085,120601085,210600001405,CKEC,901,All Students,494,479,15,20,35,0,0,0,2,5,7,88,77,165,0,0,0,22,21,43,352,371,723,973
20192020,120,WOODFORD,601,Woodford County,085,Woodford County Middle School,601085,120601085,210600001405,CKEC,901,06,169,157,8,7,15,0,0,0,1,1,2,31,27,58,0,0,0,9,9,18,108,125,233,326
20192020,120,WOODFORD,601,Woodford County,085,Woodford County Middle School,601085,120601085,210600001405,CKEC,901,07,187,160,4,10,14,0,0,0,0,3,3,32,28,60,0,0,0,3,4,7,121,142,263,347
20192020,120,WOODFORD,601,Woodford County,085,Woodford County Middle School,601085,120601085,210600001405,CKEC,901,08,138,162,3,3,6,0,0,0,1,1,2,25,22,47,0,0,0,10,8,18,123,104,227,300
20192020,120,WOODFORD,601,Woodford County,090,Huntertown Elementary School,601090,120601090,210600001468,CKEC,901,All Students,224,222,10,7,17,0,0,0,3,2,5,25,27,52,0,0,0,10,15,25,174,173,347,446
20192020,120,WOODFORD,601,Woodford County,090,Huntertown Elementary School,601090,120601090,210600001468,CKEC,901,PS,15,25,0,0,0,0,0,0,0,0,0,7,6,13,0,0,0,0,0,0,18,9,27,40
20192020,120,WOODFORD,601,Woodford County,090,Huntertown Elementary School,601090,120601090,210600001468,CKEC,901,KG,42,48,1,0,1,0,0,0,0,0,0,7,5,12,0,0,0,2,3,5,38,34,72,90
20192020,120,WOODFORD,601,Woodford County,090,Huntertown Elementary School,601090,120601090,210600001468,CKEC,901,01,37,37,3,2,5,0,0,0,1,0,1,4,5,9,0,0,0,1,2,3,28,28,56,74
20192020,120,WOODFORD,601,Woodford County,090,Huntertown Elementary School,601090,120601090,210600001468,CKEC,901,02,42,35,1,1,2,0,0,0,0,1,1,4,4,8,0,0,0,1,2,3,29,34,63,77
20192020,120,WOODFORD,601,Woodford County,090,Huntertown Elementary School,601090,120601090,210600001468,CKEC,901,03,36,34,0,2,2,0,0,0,1,0,1,1,4,5,0,0,0,2,4,6,30,26,56,70
20192020,120,WOODFORD,601,Woodford County,090,Huntertown Elementary School,601090,120601090,210600001468,CKEC,901,04,28,34,1,0,1,0,0,0,1,0,1,5,4,9,0,0,0,2,2,4,25,22,47,62
20192020,120,WOODFORD,601,Woodford County,090,Huntertown Elementary School,601090,120601090,210600001468,CKEC,901,05,39,34,4,2,6,0,0,0,0,1,1,4,5,9,0,0,0,2,2,4,24,29,53,73
20192020,120,WOODFORD,601,Woodford County,120,Northside Elementary School,601120,120601120,210600000320,CKEC,901,All Students,177,153,0,3,3,0,0,0,0,0,0,32,28,60,0,0,0,9,15,24,112,131,243,330
20192020,120,WOODFORD,601,Woodford County,120,Northside Elementary School,601120,120601120,210600000320,CKEC,901,PS,17,21,0,1,1,0,0,0,0,0,0,7,4,11,0,0,0,1,1,2,13,11,24,38
20192020,120,WOODFORD,601,Woodford County,120,Northside Elementary School,601120,120601120,210600000320,CKEC,901,KG,25,23,0,0,0,0,0,0,0,0,0,5,6,11,0,0,0,1,0,1,17,19,36,48
20192020,120,WOODFORD,601,Woodford County,120,Northside Elementary School,601120,120601120,210600000320,CKEC,901,01,36,31,0,2,2,0,0,0,0,0,0,6,5,11,0,0,0,1,5,6,24,24,48,67
20192020,120,WOODFORD,601,Woodford County,120,Northside Elementary School,601120,120601120,210600000320,CKEC,901,02,26,21,0,1,1,0,0,0,0,0,0,6,5,11,0,0,0,1,4,5,14,16,30,47
20192020,120,WOODFORD,601,Woodford County,120,Northside Elementary School,601120,120601120,210600000320,CKEC,901,03,38,31,0,0,0,0,0,0,0,0,0,7,8,15,0,0,0,4,4,8,20,26,46,69
20192020,120,WOODFORD,601,Woodford County,120,Northside Elementary School,601120,120601120,210600000320,CKEC,901,04,24,22,0,0,0,0,0,0,0,0,0,4,3,7,0,0,0,0,0,0,18,21,39,46
20192020,120,WOODFORD,601,Woodford County,120,Northside Elementary School,601120,120601120,210600000320,CKEC,901,05,28,25,0,0,0,0,0,0,0,0,0,4,1,5,0,0,0,2,2,4,19,25,44,53
20192020,056,JEFFERSON,602,Kentucky School for the Blind District,"",---District Total---,602,"","","",909,All Students,23,43,3,2,5,0,0,0,4,2,6,5,1,6,0,1,1,1,0,1,30,17,47,66
20192020,056,JEFFERSON,602,Kentucky School for the Blind District,"",---District Total---,602,"","","",909,01,1,0,0,0,0,0,0,0,0,0,0,0,0,0,0,1,1,0,0,0,0,0,0,1
20192020,056,JEFFERSON,602,Kentucky School for the Blind District,"",---District Total---,602,"","","",909,02,0,5,0,0,0,0,0,0,1,0,1,0,0,0,0,0,0,0,0,0,4,0,4,5
20192020,056,JEFFERSON,602,Kentucky School for the Blind District,"",---District Total---,602,"","","",909,03,2,1,0,0,0,0,0,0,1,0,1,0,0,0,0,0,0,0,0,0,0,2,2,3
20192020,056,JEFFERSON,602,Kentucky School for the Blind District,"",---District Total---,602,"","","",909,04,0,1,0,0,0,0,0,0,0,0,0,0,0,0,0,0,0,0,0,0,1,0,1,1
20192020,056,JEFFERSON,602,Kentucky School for the Blind District,"",---District Total---,602,"","","",909,05,2,3,0,0,0,0,0,0,1,0,1,0,1,1,0,0,0,0,0,0,2,1,3,5
20192020,056,JEFFERSON,602,Kentucky School for the Blind District,"",---District Total---,602,"","","",909,06,4,4,0,0,0,0,0,0,1,0,1,1,0,1,0,0,0,0,0,0,2,4,6,8
20192020,056,JEFFERSON,602,Kentucky School for the Blind District,"",---District Total---,602,"","","",909,07,1,4,0,0,0,0,0,0,0,0,0,0,0,0,0,0,0,0,0,0,4,1,5,5
20192020,056,JEFFERSON,602,Kentucky School for the Blind District,"",---District Total---,602,"","","",909,08,2,5,0,1,1,0,0,0,0,1,1,1,0,1,0,0,0,1,0,1,3,0,3,7
20192020,056,JEFFERSON,602,Kentucky School for the Blind District,"",---District Total---,602,"","","",909,09,4,6,3,0,3,0,0,0,0,1,1,1,0,1,0,0,0,0,0,0,2,3,5,10
20192020,056,JEFFERSON,602,Kentucky School for the Blind District,"",---District Total---,602,"","","",909,10,1,3,0,0,0,0,0,0,0,0,0,0,0,0,0,0,0,0,0,0,3,1,4,4
20192020,056,JEFFERSON,602,Kentucky School for the Blind District,"",---District Total---,602,"","","",909,11,2,4,0,0,0,0,0,0,0,0,0,1,0,1,0,0,0,0,0,0,3,2,5,6
20192020,056,JEFFERSON,602,Kentucky School for the Blind District,"",---District Total---,602,"","","",909,12,3,6,0,1,1,0,0,0,0,0,0,1,0,1,0,0,0,0,0,0,5,2,7,9
20192020,056,JEFFERSON,602,Kentucky School for the Blind District,"",---District Total---,602,"","","",909,14,1,1,0,0,0,0,0,0,0,0,0,0,0,0,0,0,0,0,0,0,1,1,2,2
20192020,056,JEFFERSON,602,Kentucky School for the Blind,176,Kentucky School for the Blind,602176,056602176,210009401779,"",909,All Students,23,43,3,2,5,0,0,0,4,2,6,5,1,6,0,1,1,1,0,1,30,17,47,66
20192020,056,JEFFERSON,602,Kentucky School for the Blind,176,Kentucky School for the Blind,602176,056602176,210009401779,"",909,01,1,0,0,0,0,0,0,0,0,0,0,0,0,0,0,1,1,0,0,0,0,0,0,1
20192020,056,JEFFERSON,602,Kentucky School for the Blind,176,Kentucky School for the Blind,602176,056602176,210009401779,"",909,02,0,5,0,0,0,0,0,0,1,0,1,0,0,0,0,0,0,0,0,0,4,0,4,5
20192020,056,JEFFERSON,602,Kentucky School for the Blind,176,Kentucky School for the Blind,602176,056602176,210009401779,"",909,03,2,1,0,0,0,0,0,0,1,0,1,0,0,0,0,0,0,0,0,0,0,2,2,3
20192020,056,JEFFERSON,602,Kentucky School for the Blind,176,Kentucky School for the Blind,602176,056602176,210009401779,"",909,04,0,1,0,0,0,0,0,0,0,0,0,0,0,0,0,0,0,0,0,0,1,0,1,1
20192020,056,JEFFERSON,602,Kentucky School for the Blind,176,Kentucky School for the Blind,602176,056602176,210009401779,"",909,05,2,3,0,0,0,0,0,0,1,0,1,0,1,1,0,0,0,0,0,0,2,1,3,5
20192020,056,JEFFERSON,602,Kentucky School for the Blind,176,Kentucky School for the Blind,602176,056602176,210009401779,"",909,06,4,4,0,0,0,0,0,0,1,0,1,1,0,1,0,0,0,0,0,0,2,4,6,8
20192020,056,JEFFERSON,602,Kentucky School for the Blind,176,Kentucky School for the Blind,602176,056602176,210009401779,"",909,07,1,4,0,0,0,0,0,0,0,0,0,0,0,0,0,0,0,0,0,0,4,1,5,5
20192020,056,JEFFERSON,602,Kentucky School for the Blind,176,Kentucky School for the Blind,602176,056602176,210009401779,"",909,08,2,5,0,1,1,0,0,0,0,1,1,1,0,1,0,0,0,1,0,1,3,0,3,7
20192020,056,JEFFERSON,602,Kentucky School for the Blind,176,Kentucky School for the Blind,602176,056602176,210009401779,"",909,09,4,6,3,0,3,0,0,0,0,1,1,1,0,1,0,0,0,0,0,0,2,3,5,10
20192020,056,JEFFERSON,602,Kentucky School for the Blind,176,Kentucky School for the Blind,602176,056602176,210009401779,"",909,10,1,3,0,0,0,0,0,0,0,0,0,0,0,0,0,0,0,0,0,0,3,1,4,4
20192020,056,JEFFERSON,602,Kentucky School for the Blind,176,Kentucky School for the Blind,602176,056602176,210009401779,"",909,11,2,4,0,0,0,0,0,0,0,0,0,1,0,1,0,0,0,0,0,0,3,2,5,6
20192020,056,JEFFERSON,602,Kentucky School for the Blind,176,Kentucky School for the Blind,602176,056602176,210009401779,"",909,12,3,6,0,1,1,0,0,0,0,0,0,1,0,1,0,0,0,0,0,0,5,2,7,9
20192020,056,JEFFERSON,602,Kentucky School for the Blind,176,Kentucky School for the Blind,602176,056602176,210009401779,"",909,14,1,1,0,0,0,0,0,0,0,0,0,0,0,0,0,0,0,0,0,0,1,1,2,2
20192020,011,BOYLE,603,Kentucky School for the Deaf District,"",---District Total---,603,"","",CKEC,901,All Students,40,58,2,3,5,1,0,1,3,2,5,3,1,4,0,0,0,2,1,3,47,33,80,98
20192020,011,BOYLE,603,Kentucky School for the Deaf District,"",---District Total---,603,"","",CKEC,901,PS,1,4,0,0,0,0,0,0,0,0,0,0,0,0,0,0,0,1,0,1,3,1,4,5
20192020,011,BOYLE,603,Kentucky School for the Deaf District,"",---District Total---,603,"","",CKEC,901,KG,1,2,0,0,0,0,0,0,0,0,0,0,0,0,0,0,0,1,0,1,1,1,2,3
20192020,011,BOYLE,603,Kentucky School for the Deaf District,"",---District Total---,603,"","",CKEC,901,01,2,3,0,0,0,0,0,0,0,0,0,0,0,0,0,0,0,0,0,0,3,2,5,5
20192020,011,BOYLE,603,Kentucky School for the Deaf District,"",---District Total---,603,"","",CKEC,901,02,4,1,0,0,0,0,0,0,0,0,0,0,0,0,0,0,0,0,0,0,1,4,5,5
20192020,011,BOYLE,603,Kentucky School for the Deaf District,"",---District Total---,603,"","",CKEC,901,03,1,2,0,0,0,0,0,0,0,0,0,0,0,0,0,0,0,0,0,0,2,1,3,3
20192020,011,BOYLE,603,Kentucky School for the Deaf District,"",---District Total---,603,"","",CKEC,901,04,0,5,1,0,1,0,0,0,0,0,0,1,0,1,0,0,0,0,0,0,3,0,3,5
20192020,011,BOYLE,603,Kentucky School for the Deaf District,"",---District Total---,603,"","",CKEC,901,05,2,4,0,0,0,0,0,0,1,0,1,0,0,0,0,0,0,0,0,0,3,2,5,6
20192020,011,BOYLE,603,Kentucky School for the Deaf District,"",---District Total---,603,"","",CKEC,901,06,2,2,0,1,1,0,0,0,0,0,0,1,0,1,0,0,0,0,0,0,1,1,2,4
20192020,011,BOYLE,603,Kentucky School for the Deaf District,"",---District Total---,603,"","",CKEC,901,07,4,4,0,0,0,0,0,0,0,0,0,1,0,1,0,0,0,0,0,0,3,4,7,8
20192020,011,BOYLE,603,Kentucky School for the Deaf District,"",---District Total---,603,"","",CKEC,901,08,1,5,0,1,1,1,0,1,1,0,1,0,0,0,0,0,0,0,0,0,3,0,3,6
20192020,011,BOYLE,603,Kentucky School for the Deaf District,"",---District Total---,603,"","",CKEC,901,09,1,3,1,0,1,0,0,0,0,0,0,0,0,0,0,0,0,0,0,0,2,1,3,4
20192020,011,BOYLE,603,Kentucky School for the Deaf District,"",---District Total---,603,"","",CKEC,901,10,2,6,0,0,0,0,0,0,0,0,0,0,0,0,0,0,0,0,0,0,6,2,8,8
20192020,011,BOYLE,603,Kentucky School for the Deaf District,"",---District Total---,603,"","",CKEC,901,11,11,9,0,0,0,0,0,0,0,1,1,0,1,1,0,0,0,0,1,1,9,8,17,20
20192020,011,BOYLE,603,Kentucky School for the Deaf District,"",---District Total---,603,"","",CKEC,901,12,9,12,0,1,1,0,0,0,1,1,2,0,0,0,0,0,0,1,0,1,10,7,17,21
20192020,011,BOYLE,603,Kentucky School for the Deaf,390,Kentucky School for the Deaf,603390,011603390,210009501715,CKEC,901,All Students,40,58,2,3,5,1,0,1,3,2,5,3,1,4,0,0,0,2,1,3,47,33,80,98
20192020,011,BOYLE,603,Kentucky School for the Deaf,390,Kentucky School for the Deaf,603390,011603390,210009501715,CKEC,901,PS,1,4,0,0,0,0,0,0,0,0,0,0,0,0,0,0,0,1,0,1,3,1,4,5
20192020,011,BOYLE,603,Kentucky School for the Deaf,390,Kentucky School for the Deaf,603390,011603390,210009501715,CKEC,901,KG,1,2,0,0,0,0,0,0,0,0,0,0,0,0,0,0,0,1,0,1,1,1,2,3
20192020,011,BOYLE,603,Kentucky School for the Deaf,390,Kentucky School for the Deaf,603390,011603390,210009501715,CKEC,901,01,2,3,0,0,0,0,0,0,0,0,0,0,0,0,0,0,0,0,0,0,3,2,5,5
20192020,011,BOYLE,603,Kentucky School for the Deaf,390,Kentucky School for the Deaf,603390,011603390,210009501715,CKEC,901,02,4,1,0,0,0,0,0,0,0,0,0,0,0,0,0,0,0,0,0,0,1,4,5,5
20192020,011,BOYLE,603,Kentucky School for the Deaf,390,Kentucky School for the Deaf,603390,011603390,210009501715,CKEC,901,03,1,2,0,0,0,0,0,0,0,0,0,0,0,0,0,0,0,0,0,0,2,1,3,3
20192020,011,BOYLE,603,Kentucky School for the Deaf,390,Kentucky School for the Deaf,603390,011603390,210009501715,CKEC,901,04,0,5,1,0,1,0,0,0,0,0,0,1,0,1,0,0,0,0,0,0,3,0,3,5
20192020,011,BOYLE,603,Kentucky School for the Deaf,390,Kentucky School for the Deaf,603390,011603390,210009501715,CKEC,901,05,2,4,0,0,0,0,0,0,1,0,1,0,0,0,0,0,0,0,0,0,3,2,5,6
20192020,011,BOYLE,603,Kentucky School for the Deaf,390,Kentucky School for the Deaf,603390,011603390,210009501715,CKEC,901,06,2,2,0,1,1,0,0,0,0,0,0,1,0,1,0,0,0,0,0,0,1,1,2,4
20192020,011,BOYLE,603,Kentucky School for the Deaf,390,Kentucky School for the Deaf,603390,011603390,210009501715,CKEC,901,07,4,4,0,0,0,0,0,0,0,0,0,1,0,1,0,0,0,0,0,0,3,4,7,8
20192020,011,BOYLE,603,Kentucky School for the Deaf,390,Kentucky School for the Deaf,603390,011603390,210009501715,CKEC,901,08,1,5,0,1,1,1,0,1,1,0,1,0,0,0,0,0,0,0,0,0,3,0,3,6
20192020,011,BOYLE,603,Kentucky School for the Deaf,390,Kentucky School for the Deaf,603390,011603390,210009501715,CKEC,901,09,1,3,1,0,1,0,0,0,0,0,0,0,0,0,0,0,0,0,0,0,2,1,3,4
20192020,011,BOYLE,603,Kentucky School for the Deaf,390,Kentucky School for the Deaf,603390,011603390,210009501715,CKEC,901,10,2,6,0,0,0,0,0,0,0,0,0,0,0,0,0,0,0,0,0,0,6,2,8,8
20192020,011,BOYLE,603,Kentucky School for the Deaf,390,Kentucky School for the Deaf,603390,011603390,210009501715,CKEC,901,11,11,9,0,0,0,0,0,0,0,1,1,0,1,1,0,0,0,0,1,1,9,8,17,20
20192020,011,BOYLE,603,Kentucky School for the Deaf,390,Kentucky School for the Deaf,603390,011603390,210009501715,CKEC,901,12,9,12,0,1,1,0,0,0,1,1,2,0,0,0,0,0,0,1,0,1,10,7,17,21
20192020,"","",999,State,"",---State Total---,999,"","","","",All Students,314433,333554,35149,33650,68799,387,424,811,6070,6165,12235,25526,23675,49201,438,455,893,14243,14078,28321,251739,235986,487725,647987
20192020,"","",999,State,"",---State Total---,999,"","","","",PS,13353,16600,1777,1534,3311,25,12,37,308,271,579,1306,1088,2394,10,6,16,847,747,1594,12327,9695,22021,29952
20192020,"","",999,State,"",---State Total---,999,"","","","",KG,24154,25768,2530,2482,5012,35,31,66,473,477,950,2044,1886,3930,44,35,79,1378,1301,2679,19264,17942,37206,49922
20192020,"","",999,State,"",---State Total---,999,"","","","",01,24660,26419,2623,2505,5128,30,35,65,567,495,1062,2053,1943,3996,34,36,70,1389,1302,2691,19723,18344,38067,51079
20192020,"","",999,State,"",---State Total---,999,"","","","",02,21713,23501,2294,2146,4440,34,21,55,489,475,964,1824,1654,3478,34,28,62,1158,1183,2341,17666,16206,33872,45214
20192020,"","",999,State,"",---State Total---,999,"","","","",03,23632,25134,2657,2532,5189,24,39,63,484,468,952,2054,1930,3984,41,38,79,1230,1183,2413,18644,17442,36086,48766
20192020,"","",999,State,"",---State Total---,999,"","","","",04,23652,25500,2705,2572,5277,26,23,49,467,453,920,2015,1940,3955,26,41,67,1233,1216,2449,19028,17407,36435,49152
20192020,"","",999,State,"",---State Total---,999,"","","","",05,25120,26284,2833,2729,5562,26,34,60,422,457,879,2167,1928,4095,24,39,63,1262,1246,2508,19550,18687,38237,51404
20192020,"","",999,State,"",---State Total---,999,"","","","",06,25416,26612,2852,2773,5625,28,33,61,445,439,884,2133,2124,4257,44,33,77,1189,1166,2355,19921,18848,38769,52028
20192020,"","",999,State,"",---State Total---,999,"","","","",12,22683,23807,2632,2466,5098,28,29,57,409,480,889,1534,1390,2924,23,31,54,645,684,1329,18536,17603,36139,46490
20192020,"","",999,State,"",---State Total---,999,"","","","",14,185,384,81,31,112,1,0,1,8,4,12,9,11,20,0,0,0,10,0,10,275,139,414,569
20192020,"","",999,State,"",---State Total---,999,"","","","",07,25607,26677,2918,2759,5677,35,29,64,445,443,888,2059,2014,4073,39,36,75,1175,1184,2359,20006,19142,39148,52284
20192020,"","",999,State,"",---State Total---,999,"","","","",08,24522,26355,2727,2597,5324,36,42,78,451,467,918,2012,1863,3875,21,40,61,1012,1087,2099,20096,18426,38522,50877
20192020,"","",999,State,"",---State Total---,999,"","","","",10,24425,25573,2705,2714,5419,28,43,71,490,493,983,1807,1648,3455,34,36,70,789,817,1606,19720,18674,38394,49998
20192020,"","",999,State,"",---State Total---,999,"","","","",09,25586,27729,3147,2897,6044,36,30,66,479,483,962,2271,1900,4171,43,33,76,1053,961,2014,20700,19282,39982,53315
20192020,"","",999,State,"",---State Total---,999,"","","","",11,23078,23811,2445,2447,4892,20,35,55,441,531,972,1544,1444,2988,31,29,60,720,748,1468,18610,17844,36454,46889
